//MAP CONVERTED BY dmm2tgm.py THIS HEADER COMMENT PREVENTS RECONVERSION, DO NOT REMOVE
"a" = (
/obj/item/reagent_container/food/drinks/cans/souto/vanilla{
	pixel_y = 2;
	pixel_x = 7
	},
/obj/item/reagent_container/food/drinks/cans/space_up{
	pixel_y = 9;
	pixel_x = -4
	},
/obj/item/reagent_container/food/drinks/cans/space_up{
	pixel_y = 1;
	pixel_x = -3
	},
/turf/template_noop,
/area/template_noop)
"f" = (
/obj/item/facepaint/brown{
	pixel_x = -9;
	pixel_y = 9
	},
/obj/item/reagent_container/food/snacks/chips{
	pixel_y = 7;
	pixel_x = 7
	},
/turf/template_noop,
/area/template_noop)
"j" = (
/obj/item/reagent_container/food/snacks/candy{
	pixel_y = 4
	},
/obj/item/reagent_container/food/snacks/candy{
	pixel_y = 8
	},
/obj/item/reagent_container/food/snacks/candy{
	pixel_y = 8;
	pixel_x = -8
	},
/turf/template_noop,
/area/template_noop)
"m" = (
/obj/item/storage/donut_box{
	pixel_y = 10
	},
/turf/template_noop,
/area/template_noop)
"o" = (
/obj/item/reagent_container/food/drinks/cans/starkist{
	pixel_y = -6;
	pixel_x = 14
	},
/obj/item/storage/box/cups{
	pixel_x = -5;
	pixel_y = 8
	},
/obj/item/tool/lighter/random{
	pixel_x = -2;
	pixel_y = -6
	},
/obj/item/reagent_container/food/condiment/sugar{
	pixel_x = 5;
	pixel_y = 3
	},
/turf/template_noop,
/area/template_noop)
"u" = (
/obj/item/pizzabox/mushroom{
	pixel_y = 13
	},
/turf/template_noop,
/area/template_noop)
"y" = (
/obj/item/tool/kitchen/tray{
	pixel_y = 9
	},
/obj/item/reagent_container/food/snacks/packaged_burrito{
	pixel_y = 8;
	pixel_x = 4
	},
/obj/item/reagent_container/food/drinks/dry_ramen{
	pixel_y = 8;
	pixel_x = -8
	},
/obj/item/reagent_container/food/snacks/wrapped/barcardine{
	pixel_y = -11
	},
/turf/template_noop,
/area/template_noop)
"z" = (
/obj/item/tool/kitchen/tray{
	pixel_y = 9
	},
/obj/item/reagent_container/food/snacks/packaged_burger{
	pixel_y = 7;
	pixel_x = -4
	},
/obj/item/reagent_container/food/drinks/dry_ramen{
	pixel_y = 8;
	pixel_x = 8
	},
/turf/template_noop,
/area/template_noop)
"B" = (
/turf/template_noop,
/area/template_noop)
"C" = (
/obj/item/reagent_container/food/drinks/dry_ramen{
	pixel_y = 12;
	pixel_x = -8
	},
/obj/item/reagent_container/food/drinks/dry_ramen{
	pixel_y = 11;
	pixel_x = 4
	},
/obj/item/reagent_container/food/drinks/dry_ramen{
	pixel_y = -1;
	pixel_x = -11
	},
/obj/item/reagent_container/food/drinks/dry_ramen{
	pixel_y = 4;
	pixel_x = 2
	},
/obj/item/reagent_container/food/snacks/kepler_crisps/flamehot{
	pixel_x = -3
	},
/turf/template_noop,
/area/template_noop)
"O" = (
/obj/item/reagent_container/food/snacks/packaged_hdogs{
	pixel_y = -2;
	pixel_x = -1
	},
/obj/item/reagent_container/food/snacks/cheesyfries{
	pixel_y = 10
	},
/turf/template_noop,
/area/template_noop)
"S" = (
/obj/item/tool/kitchen/tray{
	pixel_y = 9
	},
/obj/item/reagent_container/food/snacks/donut{
	pixel_y = 10
	},
/obj/item/reagent_container/food/condiment/saltshaker{
	pixel_x = -7;
	pixel_y = -9
	},
/obj/item/reagent_container/food/condiment/peppermill{
	pixel_y = -9
	},
/turf/template_noop,
/area/template_noop)
"V" = (
/obj/item/reagent_container/food/snacks/wrapped/booniebars{
	pixel_y = 8
	},
/obj/item/reagent_container/food/snacks/wrapped/chunk,
/turf/template_noop,
/area/template_noop)

(1,1,1) = {"
B
B
B
B
o
V
"}
(2,1,1) = {"
B
B
B
B
a
j
"}
(3,1,1) = {"
y
z
B
B
B
B
"}
(4,1,1) = {"
O
f
B
B
B
B
"}
(5,1,1) = {"
B
B
B
B
S
u
"}
(6,1,1) = {"
B
B
B
B
C
m
"}
