//MAP CONVERTED BY dmm2tgm.py THIS HEADER COMMENT PREVENTS RECONVERSION, DO NOT REMOVE
"ac" = (
/turf/open/desert/dirt,
/area/desert_dam/exterior/valley/valley_medical)
"af" = (
/obj/structure/platform{
	dir = 1
	},
/obj/structure/platform{
	dir = 4
	},
/obj/effect/blocker/toxic_water/Group_1,
/turf/open/gm/river/desert/shallow,
/area/desert_dam/exterior/river/riverside_south)
"an" = (
/obj/structure/platform{
	dir = 4
	},
/obj/effect/blocker/toxic_water/Group_1,
/turf/open/gm/river/desert/shallow,
/area/desert_dam/exterior/river/riverside_south)
"aq" = (
/turf/open/asphalt/cement_sunbleached,
/area/desert_dam/exterior/valley/valley_medical)
"aB" = (
/obj/effect/blocker/toxic_water/Group_1,
/turf/open/gm/river/desert/shallow,
/area/desert_dam/exterior/river/riverside_south)
"aI" = (
/obj/effect/blocker/toxic_water/Group_1,
/turf/open/gm/river/desert/shallow_corner,
/area/desert_dam/exterior/river/riverside_south)
"aJ" = (
/turf/closed/wall/rock/orange,
/area/desert_dam/exterior/rock)
"aK" = (
/obj/effect/blocker/toxic_water/Group_1,
/turf/open/gm/river/desert/deep,
/area/desert_dam/exterior/river/riverside_south)
"aM" = (
/obj/effect/blocker/toxic_water/Group_1,
/obj/structure/platform_decoration,
/turf/open/gm/river/desert/deep,
/area/desert_dam/exterior/river/riverside_south)
"aN" = (
/obj/effect/blocker/toxic_water/Group_1,
/obj/structure/platform,
/turf/open/gm/river/desert/deep,
/area/desert_dam/exterior/river/riverside_south)
"aP" = (
/obj/effect/blocker/toxic_water/Group_1,
/obj/structure/platform,
/turf/open/gm/river/desert/shallow,
/area/desert_dam/exterior/river/riverside_south)
"aQ" = (
/obj/structure/platform{
	dir = 4
	},
/obj/structure/platform,
/turf/open/gm/river/desert/shallow,
/area/desert_dam/exterior/river/riverside_south)
"aR" = (
/obj/effect/blocker/toxic_water/Group_1,
/obj/structure/platform{
	dir = 4
	},
/turf/open/gm/river/desert/deep,
/area/desert_dam/exterior/river/riverside_south)
"aS" = (
/obj/effect/blocker/toxic_water/Group_1,
/turf/open/gm/river/desert/deep/covered,
/area/desert_dam/exterior/river/riverside_south)
"aT" = (
/obj/effect/blocker/toxic_water/Group_1,
/turf/open/gm/river/desert/shallow_corner/covered,
/area/desert_dam/exterior/river/riverside_south)
"ba" = (
/obj/effect/blocker/toxic_water/Group_1,
/obj/structure/platform{
	dir = 1
	},
/obj/structure/platform{
	dir = 8
	},
/turf/open/gm/river/desert/deep,
/area/desert_dam/exterior/river/riverside_south)
"bb" = (
/obj/effect/blocker/toxic_water/Group_1,
/obj/structure/platform{
	dir = 1
	},
/turf/open/gm/river/desert/shallow_corner,
/area/desert_dam/exterior/river/riverside_south)
"bd" = (
/obj/effect/blocker/toxic_water/Group_1,
/obj/structure/platform{
	dir = 1
	},
/turf/open/gm/river/desert/shallow,
/area/desert_dam/exterior/river/riverside_south)
"be" = (
/obj/effect/blocker/toxic_water/Group_1,
/obj/structure/platform{
	dir = 8
	},
/turf/open/gm/river/desert/deep,
/area/desert_dam/exterior/river/riverside_south)
"bi" = (
/obj/effect/blocker/toxic_water/Group_1,
/turf/open/gm/river/desert/shallow_edge/covered,
/area/desert_dam/exterior/river/riverside_south)
"bk" = (
/obj/effect/blocker/toxic_water/Group_1,
/obj/structure/platform{
	dir = 4
	},
/turf/open/gm/river/desert/shallow,
/area/desert_dam/exterior/river/riverside_south)
"bl" = (
/turf/open/asphalt/cement_sunbleached,
/area/desert_dam/exterior/river/riverside_south)
"bn" = (
/obj/effect/blocker/toxic_water/Group_1,
/turf/open/gm/river/desert/shallow_edge,
/area/desert_dam/exterior/river/riverside_south)
"bp" = (
/obj/effect/blocker/toxic_water/Group_1,
/obj/structure/platform{
	dir = 4
	},
/turf/open/desert/desert_shore/shore_corner2,
/area/desert_dam/exterior/river/riverside_south)
"bq" = (
/obj/effect/blocker/toxic_water/Group_1,
/obj/structure/platform{
	dir = 8
	},
/turf/open/gm/river/desert/shallow,
/area/desert_dam/exterior/river/riverside_south)
"bs" = (
/obj/structure/platform,
/obj/effect/blocker/toxic_water/Group_1,
/obj/structure/platform{
	dir = 4
	},
/turf/open/desert/desert_shore/shore_edge1,
/area/desert_dam/exterior/river/riverside_south)
"bt" = (
/obj/structure/platform,
/obj/effect/blocker/toxic_water/Group_1,
/obj/structure/platform{
	dir = 8
	},
/turf/open/gm/river/desert/shallow,
/area/desert_dam/exterior/river/riverside_south)
"bu" = (
/obj/structure/platform,
/obj/effect/blocker/toxic_water/Group_1,
/turf/open/gm/river/desert/shallow,
/area/desert_dam/exterior/river/riverside_south)
"bA" = (
/obj/structure/platform{
	dir = 8
	},
/obj/effect/blocker/toxic_water/Group_1,
/turf/open/desert/desert_shore/desert_shore1,
/area/desert_dam/exterior/river/riverside_south)
"bB" = (
/obj/effect/blocker/toxic_water/Group_1,
/turf/open/desert/desert_shore/shore_corner2,
/area/desert_dam/exterior/river/riverside_south)
"cH" = (
/turf/open/desert/dirt/dirt2,
/area/desert_dam/exterior/valley/valley_medical)
"cQ" = (
/obj/effect/decal/sand_overlay/sand1{
	dir = 1
	},
/turf/open/asphalt/cement_sunbleached,
/area/desert_dam/exterior/valley/valley_medical)
"dS" = (
/obj/structure/largecrate/random/barrel/white,
/turf/open/asphalt/tile,
/area/desert_dam/exterior/valley/valley_cargo)
"fF" = (
/turf/open/asphalt/cement_sunbleached/cement_sunbleached12,
/area/desert_dam/exterior/valley/valley_medical)
"fQ" = (
/obj/structure/stairs,
/obj/structure/platform{
	dir = 8
	},
/turf/open/asphalt/tile,
/area/desert_dam/exterior/valley/valley_medical)
"fS" = (
/obj/effect/decal/sand_overlay/sand1/corner1{
	dir = 1
	},
/turf/open/asphalt/cement_sunbleached,
/area/desert_dam/exterior/valley/valley_medical)
"fY" = (
/obj/effect/blocker/toxic_water/Group_1,
/turf/open/desert/desert_shore/shore_edge1/east,
/area/desert_dam/exterior/river/riverside_south)
"gN" = (
/obj/structure/largecrate/random/barrel/blue,
/turf/open/asphalt/tile,
/area/desert_dam/exterior/valley/valley_cargo)
"in" = (
/obj/effect/blocker/toxic_water/Group_1,
/turf/open/gm/river/desert/shallow_edge/northeast,
/area/desert_dam/exterior/river/riverside_south)
"jA" = (
/obj/effect/blocker/toxic_water/Group_1,
/obj/structure/platform{
	dir = 8
	},
/turf/open/gm/river/desert/shallow_edge/southwest,
/area/desert_dam/exterior/river/riverside_south)
"kE" = (
/obj/effect/decal/sand_overlay/sand1{
	dir = 1
	},
/turf/open/asphalt/cement_sunbleached/cement_sunbleached2,
/area/desert_dam/exterior/valley/valley_medical)
"kZ" = (
/obj/effect/blocker/toxic_water/Group_1,
/turf/open/gm/river/desert/shallow_edge/east,
/area/desert_dam/exterior/river/riverside_south)
"lN" = (
/obj/effect/decal/sand_overlay/sand1{
	dir = 8
	},
/obj/effect/decal/sand_overlay/sand1{
	dir = 1
	},
/turf/open/asphalt/cement_sunbleached/cement_sunbleached9,
/area/desert_dam/exterior/valley/valley_medical)
"lQ" = (
/obj/effect/blocker/toxic_water/Group_1,
/turf/open/desert/desert_shore/shore_corner2/west,
/area/desert_dam/exterior/river/riverside_south)
"lV" = (
/obj/structure/platform_decoration{
	dir = 8
	},
/obj/effect/blocker/toxic_water/Group_1,
/turf/open/gm/river/desert/shallow,
/area/desert_dam/exterior/river/riverside_south)
"pg" = (
/obj/structure/platform{
	dir = 1
	},
/obj/effect/blocker/toxic_water/Group_1,
/turf/open/desert/desert_shore/shore_corner2/west,
/area/desert_dam/exterior/river/riverside_south)
"qm" = (
/obj/effect/decal/sand_overlay/sand1{
	dir = 4
	},
/turf/open/asphalt/cement_sunbleached,
/area/desert_dam/exterior/valley/valley_medical)
"qn" = (
/turf/open/asphalt/cement_sunbleached/cement_sunbleached4,
/area/desert_dam/exterior/river/riverside_south)
"rc" = (
/obj/effect/blocker/toxic_water/Group_1,
/turf/open/desert/desert_shore/desert_shore1/east,
/area/desert_dam/exterior/river/riverside_south)
"tw" = (
/turf/open/asphalt/tile,
/area/desert_dam/exterior/valley/valley_cargo)
"ty" = (
/obj/effect/decal/sand_overlay/sand1{
	dir = 1
	},
/turf/open/asphalt/cement_sunbleached/cement_sunbleached4,
/area/desert_dam/exterior/valley/valley_medical)
"vr" = (
/obj/effect/blocker/toxic_water/Group_1,
/obj/structure/platform{
	dir = 8
	},
/turf/open/gm/river/desert/shallow_corner/west,
/area/desert_dam/exterior/river/riverside_south)
"xR" = (
/turf/open/asphalt/cement_sunbleached/cement_sunbleached3,
/area/desert_dam/exterior/valley/valley_medical)
"yy" = (
/obj/effect/blocker/toxic_water/Group_1,
/obj/structure/platform,
/turf/open/gm/river/desert/shallow_edge/east,
/area/desert_dam/exterior/river/riverside_south)
"yG" = (
/obj/effect/blocker/toxic_water/Group_1,
/turf/open/gm/river/desert/shallow_edge/southwest,
/area/desert_dam/exterior/river/riverside_south)
"yW" = (
/obj/effect/decal/sand_overlay/sand1{
	dir = 8
	},
/turf/open/asphalt/tile,
/area/desert_dam/exterior/valley/valley_medical)
"zc" = (
/obj/structure/platform_decoration{
	dir = 8
	},
/turf/open/desert/dirt/dirt2,
/area/desert_dam/exterior/valley/valley_medical)
"zn" = (
/obj/effect/blocker/toxic_water/Group_1,
/obj/structure/platform{
	dir = 1
	},
/turf/open/gm/river/desert/shallow_edge/northeast,
/area/desert_dam/exterior/river/riverside_south)
"zE" = (
/obj/effect/blocker/toxic_water/Group_1,
/turf/open/gm/river/desert/shallow_edge/covered/northeast,
/area/desert_dam/exterior/river/riverside_south)
"AY" = (
/turf/open/asphalt/cement_sunbleached/cement_sunbleached4,
/area/desert_dam/exterior/valley/valley_medical)
"BF" = (
/obj/effect/decal/sand_overlay/sand1/corner1{
	dir = 4
	},
/turf/open/asphalt/tile,
/area/desert_dam/exterior/valley/valley_medical)
"DT" = (
/obj/structure/platform{
	dir = 1
	},
/obj/structure/platform{
	dir = 4
	},
/turf/open/desert/dirt/dirt2,
/area/desert_dam/exterior/valley/valley_medical)
"EC" = (
/obj/effect/blocker/toxic_water/Group_1,
/turf/open/gm/river/desert/shallow_corner/west,
/area/desert_dam/exterior/river/riverside_south)
"FL" = (
/obj/effect/blocker/toxic_water/Group_1,
/turf/open/gm/river/desert/shallow_edge/covered/east,
/area/desert_dam/exterior/river/riverside_south)
"Gr" = (
/obj/effect/decal/sand_overlay/sand1{
	dir = 8
	},
/turf/open/asphalt/cement_sunbleached/cement_sunbleached15,
/area/desert_dam/exterior/valley/valley_medical)
"Hs" = (
/obj/structure/platform{
	dir = 1
	},
/obj/effect/blocker/toxic_water/Group_1,
/turf/open/desert/desert_shore/shore_edge1/east,
/area/desert_dam/exterior/river/riverside_south)
"Hw" = (
/obj/effect/decal/sand_overlay/sand1{
	dir = 8
	},
/turf/open/asphalt/cement_sunbleached,
/area/desert_dam/exterior/valley/valley_medical)
"IB" = (
/obj/structure/platform{
	dir = 4
	},
/turf/open/desert/dirt/dirt2,
/area/desert_dam/exterior/valley/valley_medical)
"LG" = (
/turf/open/asphalt/cement_sunbleached/cement_sunbleached12,
/area/desert_dam/exterior/river/riverside_south)
"NA" = (
/obj/effect/blocker/toxic_water/Group_1,
/obj/structure/platform{
	dir = 4
	},
/turf/open/gm/river/desert/shallow_edge/southwest,
/area/desert_dam/exterior/river/riverside_south)
"NQ" = (
/turf/open/asphalt/cement_sunbleached/cement_sunbleached14,
/area/desert_dam/exterior/valley/valley_medical)
"Oo" = (
/obj/effect/blocker/toxic_water/Group_1,
/obj/structure/platform{
	dir = 4
	},
/turf/open/gm/river/desert/shallow_corner/west,
/area/desert_dam/exterior/river/riverside_south)
"OT" = (
/obj/structure/platform_decoration{
	dir = 4
	},
/turf/open/desert/dirt/dirt2,
/area/desert_dam/exterior/valley/valley_medical)
"Su" = (
/obj/effect/decal/sand_overlay/sand1{
	dir = 8
	},
/turf/open/asphalt/cement_sunbleached/cement_sunbleached1,
/area/desert_dam/exterior/valley/valley_medical)
"SX" = (
/obj/effect/blocker/toxic_water/Group_1,
/turf/open/gm/river/desert/shallow_edge/north,
/area/desert_dam/exterior/river/riverside_south)
"Tv" = (
/obj/effect/decal/sand_overlay/sand1/corner1{
	dir = 4
	},
/turf/open/asphalt/cement_sunbleached,
/area/desert_dam/exterior/valley/valley_medical)
"UO" = (
/obj/structure/platform_decoration{
	dir = 1
	},
/obj/effect/blocker/toxic_water/Group_1,
/turf/open/gm/river/desert/shallow,
/area/desert_dam/exterior/river/riverside_south)
"Vh" = (
/obj/structure/stairs,
/obj/structure/platform{
	dir = 4
	},
/turf/open/asphalt/tile,
/area/desert_dam/exterior/valley/valley_medical)
"Ym" = (
/turf/open/asphalt/tile,
/area/desert_dam/exterior/valley/valley_medical)

(1,1,1) = {"
Ym
af
an
an
lV
aB
in
aI
aK
aK
aM
aR
aR
aR
aR
aR
Oo
NA
bk
bp
bs
tw
"}
(2,1,1) = {"
yW
BF
Ym
Ym
pg
aB
aB
in
kZ
aI
aN
aS
aS
aS
aS
aS
aS
bi
bl
bl
bl
tw
"}
(3,1,1) = {"
ac
kE
NQ
Ym
Hs
rc
lQ
aB
aB
in
yy
aS
aS
aS
aS
aS
aS
bi
bl
bl
bl
tw
"}
(4,1,1) = {"
ac
cQ
fF
fQ
OT
cH
fY
rc
aJ
aB
aP
aT
aS
ba
be
be
be
vr
jA
bq
bt
tw
"}
(5,1,1) = {"
ac
cQ
fF
Vh
zc
cH
cH
aJ
aJ
aJ
aP
zE
FL
bb
aK
aK
aK
aK
bn
aB
bu
gN
"}
(6,1,1) = {"
qm
fS
fF
Ym
DT
IB
IB
aJ
aJ
aJ
aQ
qn
LG
zn
aI
aK
aK
aK
EC
yG
bu
dS
"}
(7,1,1) = {"
Hw
Tv
fF
Ym
Ym
Ym
Ym
Ym
Ym
Ym
Ym
AY
fF
bd
SX
aK
aK
aK
aK
bn
bu
gN
"}
(8,1,1) = {"
Ym
ty
aq
xR
xR
xR
xR
xR
xR
xR
xR
aq
fF
bd
SX
aK
aK
aK
aK
bn
UO
bA
"}
(9,1,1) = {"
yW
lN
Su
Su
Su
Su
Su
Su
Su
Su
Su
Su
Gr
bd
in
aI
aK
aK
aK
EC
yG
bB
"}
(10,1,1) = {"
ac
ac
ac
ac
ac
ac
ac
ac
ac
ac
ac
ac
ac
bd
aB
SX
aK
aK
aK
aK
bn
aB
"}
