//MAP CONVERTED BY dmm2tgm.py THIS HEADER COMMENT PREVENTS RECONVERSION, DO NOT REMOVE
"a" = (
/turf/closed/wall/shiva/prefabricated/reinforced/hull,
/area/shiva/exterior/lz2_fortress)
"c" = (
/turf/open/floor/shiva{
	dir = 1
	},
/area/shiva/exterior/lz2_fortress)
"r" = (
/obj/structure/largecrate/random/mini/ammo,
/turf/open/floor/shiva{
	dir = 1
	},
/area/shiva/exterior/lz2_fortress)
"s" = (
/turf/open/auto_turf/snow/layer4,
/area/shiva/exterior/cp_lz2)
"C" = (
/obj/item/clothing/shoes/snow,
/obj/structure/surface/rack,
/obj/item/clothing/shoes/snow,
/obj/item/clothing/suit/storage/snow_suit,
/obj/item/clothing/suit/storage/snow_suit,
/obj/item/tank/emergency_oxygen/engi,
/obj/effect/decal/strata_decals/grime/grime3{
	dir = 8
	},
/obj/item/clothing/mask/rebreather,
/obj/item/tank/emergency_oxygen/engi,
/obj/item/clothing/mask/rebreather,
/turf/open/floor/shiva{
	dir = 4;
	icon_state = "multi_tiles"
	},
/area/shiva/exterior/lz2_fortress)
"E" = (
/turf/open/auto_turf/snow/layer3,
/area/shiva/exterior/cp_lz2)
"K" = (
/turf/closed/wall/shiva/prefabricated/pink,
/area/shiva/exterior/lz2_fortress)
"S" = (
/turf/open/auto_turf/snow/layer2,
/area/shiva/exterior/cp_lz2)
"U" = (
/turf/open/floor/shiva{
	icon_state = "radiator_tile"
	},
/area/shiva/exterior/lz2_fortress)
"V" = (
/obj/structure/flora/bush/snow{
	icon_state = "snowgrassall_1"
	},
/turf/open/auto_turf/snow/layer3,
/area/shiva/exterior/cp_lz2)

(1,1,1) = {"
c
c
c
c
c
c
r
K
K
s
s
"}
(2,1,1) = {"
C
C
U
U
C
C
K
K
K
V
s
"}
(3,1,1) = {"
a
a
a
a
a
a
a
a
a
a
a
"}
(4,1,1) = {"
a
a
a
a
a
a
a
a
a
a
a
"}
(5,1,1) = {"
S
S
a
a
s
s
E
a
a
s
s
"}
(6,1,1) = {"
S
S
a
a
E
E
s
a
a
s
E
"}
