//MAP CONVERTED BY dmm2tgm.py THIS HEADER COMMENT PREVENTS RECONVERSION, DO NOT REMOVE
"aa" = (
/turf/open/asphalt{
	icon_state = "tile"
	},
/area/desert_dam/exterior/valley/valley_medical)
"ab" = (
/obj/effect/blocker/toxic_water/Group_2,
/turf/open/gm/river/desert/shallow_edge{
	icon_state = "shallow_edge";
	dir = 5
	},
/area/desert_dam/exterior/river/riverside_east)
"ac" = (
/obj/effect/blocker/toxic_water/Group_2,
/obj/structure/platform{
	dir = 8
	},
/turf/open/gm/river/desert/shallow_edge{
	icon_state = "shallow_edge";
	dir = 1
	},
/area/desert_dam/exterior/river/riverside_east)
"ad" = (
/obj/effect/blocker/toxic_water/Group_2,
/turf/open/gm/river/desert/shallow_corner{
	icon_state = "shallow_c";
	dir = 8
	},
/area/desert_dam/exterior/river/riverside_east)
"af" = (
/obj/effect/blocker/toxic_water/Group_2,
/turf/open/desert/desert_shore/desert_shore1{
	icon_state = "shore1";
	dir = 1
	},
/area/desert_dam/exterior/river/riverside_east)
"ag" = (
/turf/open/asphalt/cement_sunbleached{
	icon_state = "cement_sunbleached1"
	},
/area/desert_dam/exterior/valley/valley_bridge)
"ah" = (
/obj/effect/decal/sand_overlay/sand1{
	dir = 1;
	icon = 'icons/turf/overlays.dmi';
	icon_state = "sand1_s"
	},
/turf/open/asphalt{
	icon_state = "tile"
	},
/area/desert_dam/exterior/valley/valley_bridge)
"ai" = (
/obj/structure/platform{
	dir = 1
	},
/obj/effect/blocker/toxic_water/Group_2,
/turf/open/desert/dirt{
	icon_state = "dirt2"
	},
/area/desert_dam/exterior/river/riverside_east)
"aj" = (
/obj/effect/decal/sand_overlay/sand1/corner1,
/turf/open/asphalt{
	icon_state = "tile"
	},
/area/desert_dam/exterior/valley/valley_medical)
"ak" = (
/obj/effect/decal/sand_overlay/sand1{
	dir = 8;
	icon = 'icons/turf/overlays.dmi';
	icon_state = "sand1_s"
	},
/turf/open/asphalt/cement_sunbleached{
	icon_state = "cement_sunbleached9"
	},
/area/desert_dam/exterior/valley/valley_medical)
"al" = (
/obj/effect/decal/sand_overlay/sand1/corner1{
	dir = 4;
	icon = 'icons/turf/overlays.dmi';
	icon_state = "sand1_c"
	},
/turf/open/asphalt{
	icon_state = "tile"
	},
/area/desert_dam/exterior/valley/valley_bridge)
"an" = (
/obj/structure/platform_decoration{
	dir = 8;
	icon_state = "platform_deco"
	},
/turf/open/desert/dirt{
	icon_state = "dirt2"
	},
/area/desert_dam/exterior/river/riverside_east)
"ap" = (
/obj/effect/blocker/toxic_water/Group_2,
/turf/open/gm/river/desert/deep/covered,
/area/desert_dam/exterior/river/riverside_east)
"aq" = (
/turf/open/asphalt/cement_sunbleached,
/area/desert_dam/exterior/valley/valley_medical)
"ar" = (
/obj/effect/decal/sand_overlay/sand1{
	dir = 8;
	icon = 'icons/turf/overlays.dmi';
	icon_state = "sand1_s"
	},
/turf/open/asphalt/cement_sunbleached{
	icon_state = "cement_sunbleached1"
	},
/area/desert_dam/exterior/valley/valley_medical)
"as" = (
/obj/structure/stairs{
	dir = 8
	},
/obj/structure/platform,
/turf/open/asphalt/cement_sunbleached{
	icon_state = "cement_sunbleached14"
	},
/area/desert_dam/exterior/valley/valley_medical)
"at" = (
/obj/effect/blocker/toxic_water/Group_2,
/turf/open/gm/river/desert/shallow_corner,
/area/desert_dam/exterior/river/riverside_east)
"au" = (
/turf/open/asphalt/cement_sunbleached{
	icon_state = "cement_sunbleached3"
	},
/area/desert_dam/exterior/valley/valley_medical)
"av" = (
/obj/structure/platform{
	dir = 1
	},
/obj/effect/blocker/toxic_water/Group_2,
/turf/open/desert/desert_shore/shore_corner2{
	icon_state = "shore_corner2";
	dir = 8
	},
/area/desert_dam/exterior/river/riverside_east)
"ax" = (
/obj/effect/blocker/toxic_water/Group_2,
/turf/open/desert/desert_shore/shore_corner2{
	icon_state = "shore_corner2";
	dir = 8
	},
/area/desert_dam/exterior/river/riverside_east)
"ay" = (
/turf/open/asphalt/cement_sunbleached{
	icon_state = "cement_sunbleached1"
	},
/area/desert_dam/exterior/valley/valley_medical)
"az" = (
/obj/structure/platform{
	dir = 1
	},
/obj/effect/blocker/toxic_water/Group_2,
/obj/structure/platform{
	dir = 8
	},
/turf/open/gm/river/desert/shallow,
/area/desert_dam/exterior/river/riverside_east)
"aA" = (
/turf/open/asphalt/cement_sunbleached{
	icon_state = "cement_sunbleached15"
	},
/area/desert_dam/exterior/valley/valley_bridge)
"aD" = (
/obj/structure/platform,
/obj/effect/blocker/toxic_water/Group_2,
/obj/effect/blocker/toxic_water/Group_2,
/turf/open/gm/river/desert/shallow_edge,
/area/desert_dam/exterior/river/riverside_east)
"aE" = (
/obj/structure/platform{
	dir = 1
	},
/obj/effect/blocker/toxic_water/Group_2,
/turf/open/desert/desert_shore/shore_edge1{
	icon_state = "shore_edge1";
	dir = 4
	},
/area/desert_dam/exterior/river/riverside_east)
"aF" = (
/obj/structure/platform_decoration{
	icon_state = "platform_deco";
	dir = 4
	},
/obj/effect/blocker/toxic_water/Group_2,
/turf/open/gm/river/desert/shallow_edge{
	icon_state = "shallow_edge";
	dir = 8
	},
/area/desert_dam/exterior/river/riverside_east)
"aG" = (
/obj/structure/platform_decoration,
/turf/open/desert/dirt{
	icon_state = "dirt2"
	},
/area/desert_dam/exterior/river/riverside_east)
"aH" = (
/obj/structure/platform,
/obj/effect/blocker/toxic_water/Group_2,
/turf/open/gm/river/desert/shallow_edge,
/area/desert_dam/exterior/river/riverside_east)
"aI" = (
/obj/structure/platform{
	dir = 1
	},
/obj/structure/platform{
	dir = 8
	},
/obj/effect/blocker/toxic_water/Group_2,
/turf/open/desert/desert_shore/shore_corner2{
	icon_state = "shore_corner2";
	dir = 1
	},
/area/desert_dam/exterior/river/riverside_east)
"aJ" = (
/turf/closed/wall/rock/orange,
/area/desert_dam/exterior/rock)
"aK" = (
/obj/structure/platform_decoration,
/obj/effect/blocker/toxic_water/Group_2,
/turf/open/gm/river/desert/shallow_edge,
/area/desert_dam/exterior/river/riverside_east)
"aM" = (
/obj/structure/platform{
	dir = 1
	},
/obj/effect/blocker/toxic_water/Group_2,
/turf/open/desert/desert_shore/shore_corner2{
	icon_state = "shore_corner2";
	dir = 1
	},
/area/desert_dam/exterior/river/riverside_east)
"aN" = (
/obj/structure/platform_decoration{
	icon_state = "platform_deco";
	dir = 4
	},
/obj/effect/blocker/toxic_water/Group_2,
/turf/open/gm/river/desert/shallow_edge{
	icon_state = "shallow_edge";
	dir = 9
	},
/area/desert_dam/exterior/river/riverside_east)
"aO" = (
/turf/open/desert/dirt,
/area/desert_dam/exterior/valley/valley_bridge)
"aP" = (
/obj/structure/platform{
	dir = 1
	},
/obj/effect/blocker/toxic_water/Group_2,
/obj/structure/platform{
	dir = 4
	},
/turf/open/gm/river/desert/deep,
/area/desert_dam/exterior/river/riverside_east)
"aQ" = (
/obj/structure/platform{
	dir = 4
	},
/obj/effect/blocker/toxic_water/Group_2,
/turf/open/gm/river/desert/deep,
/area/desert_dam/exterior/river/riverside_east)
"aR" = (
/obj/effect/blocker/toxic_water/Group_2,
/turf/open/gm/river/desert/shallow_edge{
	icon_state = "shallow_edge";
	dir = 1
	},
/area/desert_dam/exterior/river/riverside_east)
"aS" = (
/obj/effect/blocker/toxic_water/Group_2,
/turf/open/gm/river/desert/shallow_corner{
	icon_state = "shallow_c";
	dir = 1
	},
/area/desert_dam/exterior/river/riverside_east)
"aT" = (
/obj/effect/blocker/toxic_water/Group_2,
/obj/structure/platform,
/obj/structure/platform{
	dir = 8
	},
/turf/open/gm/river/desert/shallow_edge,
/area/desert_dam/exterior/river/riverside_east)
"aU" = (
/obj/effect/blocker/toxic_water/Group_2,
/turf/open/gm/river/desert/shallow_edge/covered,
/area/desert_dam/exterior/river/riverside_east)
"aV" = (
/obj/structure/platform_decoration{
	dir = 8;
	icon_state = "platform_deco"
	},
/obj/effect/blocker/toxic_water/Group_2,
/turf/open/gm/river/desert/deep,
/area/desert_dam/exterior/river/riverside_east)
"aW" = (
/turf/open/asphalt/cement_sunbleached{
	icon_state = "cement_sunbleached4"
	},
/area/desert_dam/exterior/valley/valley_medical)
"aX" = (
/obj/effect/decal/sand_overlay/sand1/corner1{
	dir = 1;
	icon = 'icons/turf/overlays.dmi';
	icon_state = "sand1_c"
	},
/turf/open/asphalt{
	icon_state = "tile"
	},
/area/desert_dam/exterior/valley/valley_bridge)
"aY" = (
/turf/open/asphalt/cement_sunbleached{
	icon_state = "cement_sunbleached14"
	},
/area/desert_dam/exterior/valley/valley_bridge)
"aZ" = (
/obj/effect/blocker/toxic_water/Group_2,
/turf/open/gm/river/desert/shallow_corner/covered,
/area/desert_dam/exterior/river/riverside_east)
"ba" = (
/obj/structure/platform,
/obj/effect/blocker/toxic_water/Group_2,
/obj/structure/platform{
	dir = 4
	},
/turf/open/gm/river/desert/shallow_edge,
/area/desert_dam/exterior/river/riverside_east)
"bc" = (
/obj/effect/blocker/toxic_water/Group_2,
/turf/open/gm/river/desert/deep,
/area/desert_dam/exterior/river/riverside_east)
"bd" = (
/obj/effect/blocker/toxic_water/Group_2,
/obj/structure/platform{
	dir = 8
	},
/turf/open/gm/river/desert/deep,
/area/desert_dam/exterior/river/riverside_east)
"be" = (
/obj/structure/platform{
	dir = 4
	},
/obj/effect/blocker/toxic_water/Group_2,
/turf/open/gm/river/desert/shallow_corner,
/area/desert_dam/exterior/river/riverside_east)
"bf" = (
/obj/effect/blocker/toxic_water/Group_2,
/obj/structure/platform{
	dir = 4
	},
/turf/open/gm/river/desert/deep,
/area/desert_dam/exterior/river/riverside_east)
"bg" = (
/obj/effect/blocker/toxic_water/Group_2,
/turf/open/gm/river/desert/shallow_edge{
	icon_state = "shallow_edge";
	dir = 10
	},
/area/desert_dam/exterior/river/riverside_east)
"bh" = (
/obj/effect/blocker/toxic_water/Group_2,
/turf/open/desert/desert_shore/shore_corner2,
/area/desert_dam/exterior/river/riverside_east)
"bi" = (
/obj/effect/blocker/toxic_water/Group_2,
/obj/effect/blocker/toxic_water/Group_2,
/turf/open/gm/river/desert/shallow,
/area/desert_dam/exterior/river/riverside_east)
"bj" = (
/obj/effect/blocker/toxic_water/Group_2,
/turf/open/gm/river/desert/shallow_edge,
/area/desert_dam/exterior/river/riverside_east)
"bk" = (
/obj/effect/blocker/toxic_water/Group_2,
/turf/open/desert/desert_shore/shore_edge1,
/area/desert_dam/exterior/river/riverside_east)
"bl" = (
/obj/effect/blocker/toxic_water/Group_2,
/turf/open/desert/desert_shore/desert_shore1,
/area/desert_dam/exterior/river/riverside_east)
"bm" = (
/turf/open/asphalt{
	icon_state = "tile"
	},
/area/desert_dam/exterior/valley/valley_bridge)
"bn" = (
/obj/structure/stairs{
	dir = 8
	},
/obj/structure/platform{
	dir = 1
	},
/turf/open/asphalt/cement_sunbleached{
	icon_state = "cement_sunbleached2"
	},
/area/desert_dam/exterior/valley/valley_medical)
"bo" = (
/obj/structure/platform{
	dir = 4
	},
/obj/effect/blocker/toxic_water/Group_2,
/turf/open/desert/desert_shore/desert_shore1,
/area/desert_dam/exterior/river/riverside_east)
"bp" = (
/turf/open/asphalt/cement_sunbleached{
	icon_state = "cement_sunbleached3"
	},
/area/desert_dam/exterior/valley/valley_bridge)
"bq" = (
/turf/open/desert/dirt{
	icon_state = "dirt2"
	},
/area/desert_dam/exterior/river/riverside_east)
"br" = (
/obj/structure/platform,
/turf/open/asphalt/cement_sunbleached,
/area/desert_dam/exterior/valley/valley_medical)
"bs" = (
/obj/structure/platform,
/turf/open/desert/dirt{
	icon_state = "dirt2"
	},
/area/desert_dam/exterior/river/riverside_east)
"bu" = (
/obj/structure/platform_decoration{
	icon_state = "platform_deco";
	dir = 1
	},
/turf/open/desert/dirt{
	icon_state = "dirt2"
	},
/area/desert_dam/exterior/river/riverside_east)
"bw" = (
/obj/effect/decal/sand_overlay/sand1{
	dir = 8;
	icon = 'icons/turf/overlays.dmi';
	icon_state = "sand1_s"
	},
/turf/open/asphalt{
	icon_state = "tile"
	},
/area/desert_dam/exterior/valley/valley_bridge)
"by" = (
/obj/structure/stairs{
	dir = 1
	},
/obj/structure/platform{
	dir = 8
	},
/turf/open/asphalt/cement_sunbleached{
	icon_state = "cement_sunbleached3"
	},
/area/desert_dam/exterior/valley/valley_medical)
"bz" = (
/obj/structure/stairs{
	dir = 1
	},
/obj/structure/platform{
	dir = 4
	},
/turf/open/asphalt/cement_sunbleached{
	icon_state = "cement_sunbleached1"
	},
/area/desert_dam/exterior/valley/valley_medical)
"bA" = (
/obj/effect/blocker/toxic_water/Group_2,
/turf/open/gm/river/desert/shallow_edge/covered{
	dir = 4
	},
/area/desert_dam/exterior/river/riverside_east)

(1,1,1) = {"
bm
aM
aR
bc
bc
bc
ad
bg
bh
bk
bq
bs
aa
"}
(2,1,1) = {"
aI
aN
aS
bc
bc
bc
bc
bj
bi
bl
bq
bs
aa
"}
(3,1,1) = {"
aF
aS
bc
bc
bc
bc
bc
ad
bg
bl
bq
bs
aa
"}
(4,1,1) = {"
bc
bc
bc
bc
bc
bc
bc
bc
bj
bl
bq
bs
aa
"}
(5,1,1) = {"
bc
bc
bc
bc
bc
bc
bc
bc
bj
bl
bq
bu
by
"}
(6,1,1) = {"
be
aQ
aV
bc
bc
bc
bc
bc
aK
bo
an
aG
bz
"}
(7,1,1) = {"
bm
bm
aP
bf
bf
bf
bf
bf
ba
aa
bn
as
aa
"}
(8,1,1) = {"
bp
aY
ap
ap
ap
ap
ap
ap
aU
au
aq
br
aa
"}
(9,1,1) = {"
ag
aA
bA
aZ
ap
ap
ap
ap
aU
ay
aq
br
aa
"}
(10,1,1) = {"
bw
al
az
ac
bd
bd
bd
bd
aT
aa
aW
br
aa
"}
(11,1,1) = {"
aO
ah
av
ab
at
bc
bc
bc
aH
aa
aW
aq
au
"}
(12,1,1) = {"
aJ
aX
aE
ax
aR
bc
bc
bc
aD
aa
aW
aq
aq
"}
(13,1,1) = {"
aJ
bm
ai
af
aR
bc
bc
bc
aH
aa
aW
aq
aq
"}
(14,1,1) = {"
aJ
bm
ai
af
aR
bc
bc
bc
aH
aj
ak
ar
ar
"}
