//MAP CONVERTED BY dmm2tgm.py THIS HEADER COMMENT PREVENTS RECONVERSION, DO NOT REMOVE
"ad" = (
/obj/effect/blocker/toxic_water/Group_2,
/turf/open/gm/river/desert/deep,
/area/desert_dam/exterior/river/riverside_east)
"ae" = (
/obj/structure/platform{
	dir = 4
	},
/obj/effect/blocker/toxic_water/Group_2,
/turf/open/gm/river/desert/shallow_corner,
/area/desert_dam/exterior/river/riverside_east)
"ai" = (
/turf/open/desert/dirt,
/area/desert_dam/exterior/valley/valley_bridge)
"aj" = (
/turf/closed/wall/rock/orange,
/area/desert_dam/exterior/rock)
"an" = (
/obj/structure/platform{
	dir = 4
	},
/obj/effect/blocker/toxic_water/Group_2,
/turf/open/gm/river/desert/deep,
/area/desert_dam/exterior/river/riverside_east)
"av" = (
/obj/structure/platform{
	dir = 1
	},
/obj/effect/blocker/toxic_water/Group_2,
/obj/structure/platform{
	dir = 4
	},
/turf/open/gm/river/desert/deep,
/area/desert_dam/exterior/river/riverside_east)
"aw" = (
/obj/effect/blocker/toxic_water/Group_2,
/turf/open/gm/river/desert/deep/covered,
/area/desert_dam/exterior/river/riverside_east)
"ay" = (
/obj/structure/platform{
	dir = 1
	},
/obj/effect/blocker/toxic_water/Group_2,
/obj/structure/platform{
	dir = 8
	},
/turf/open/gm/river/desert/shallow,
/area/desert_dam/exterior/river/riverside_east)
"aC" = (
/obj/effect/blocker/toxic_water/Group_2,
/obj/structure/platform{
	dir = 4
	},
/turf/open/gm/river/desert/deep,
/area/desert_dam/exterior/river/riverside_east)
"aD" = (
/obj/effect/blocker/toxic_water/Group_2,
/turf/open/gm/river/desert/shallow_corner/covered,
/area/desert_dam/exterior/river/riverside_east)
"aI" = (
/obj/effect/blocker/toxic_water/Group_2,
/obj/structure/platform{
	dir = 8
	},
/turf/open/gm/river/desert/deep,
/area/desert_dam/exterior/river/riverside_east)
"aJ" = (
/obj/effect/blocker/toxic_water/Group_2,
/turf/open/gm/river/desert/shallow_corner,
/area/desert_dam/exterior/river/riverside_east)
"aM" = (
/obj/effect/blocker/toxic_water/Group_2,
/turf/open/gm/river/desert/shallow_edge,
/area/desert_dam/exterior/river/riverside_east)
"aN" = (
/obj/effect/blocker/toxic_water/Group_2,
/turf/open/desert/desert_shore/shore_corner2,
/area/desert_dam/exterior/river/riverside_east)
"aO" = (
/obj/effect/blocker/toxic_water/Group_2,
/obj/effect/blocker/toxic_water/Group_2,
/turf/open/gm/river/desert/shallow,
/area/desert_dam/exterior/river/riverside_east)
"aP" = (
/obj/structure/platform_decoration,
/obj/effect/blocker/toxic_water/Group_2,
/turf/open/gm/river/desert/shallow_edge,
/area/desert_dam/exterior/river/riverside_east)
"aQ" = (
/obj/structure/platform,
/obj/effect/blocker/toxic_water/Group_2,
/obj/structure/platform{
	dir = 4
	},
/turf/open/gm/river/desert/shallow_edge,
/area/desert_dam/exterior/river/riverside_east)
"aR" = (
/obj/effect/blocker/toxic_water/Group_2,
/turf/open/gm/river/desert/shallow_edge/covered,
/area/desert_dam/exterior/river/riverside_east)
"aS" = (
/obj/effect/blocker/toxic_water/Group_2,
/obj/structure/platform,
/obj/structure/platform{
	dir = 8
	},
/turf/open/gm/river/desert/shallow_edge,
/area/desert_dam/exterior/river/riverside_east)
"aT" = (
/obj/structure/platform,
/obj/effect/blocker/toxic_water/Group_2,
/turf/open/gm/river/desert/shallow_edge,
/area/desert_dam/exterior/river/riverside_east)
"aU" = (
/obj/structure/platform,
/obj/effect/blocker/toxic_water/Group_2,
/obj/effect/blocker/toxic_water/Group_2,
/turf/open/gm/river/desert/shallow_edge,
/area/desert_dam/exterior/river/riverside_east)
"aV" = (
/obj/effect/blocker/toxic_water/Group_2,
/turf/open/desert/desert_shore/shore_edge1,
/area/desert_dam/exterior/river/riverside_east)
"aW" = (
/obj/effect/blocker/toxic_water/Group_2,
/turf/open/desert/desert_shore/desert_shore1,
/area/desert_dam/exterior/river/riverside_east)
"aX" = (
/obj/structure/platform{
	dir = 4
	},
/obj/effect/blocker/toxic_water/Group_2,
/turf/open/desert/desert_shore/desert_shore1,
/area/desert_dam/exterior/river/riverside_east)
"bf" = (
/turf/open/asphalt/cement_sunbleached,
/area/desert_dam/exterior/valley/valley_medical)
"bm" = (
/obj/structure/platform,
/turf/open/asphalt/cement_sunbleached,
/area/desert_dam/exterior/valley/valley_medical)
"jl" = (
/turf/open/asphalt/cement_sunbleached/cement_sunbleached15,
/area/desert_dam/exterior/valley/valley_bridge)
"lx" = (
/obj/effect/blocker/toxic_water/Group_2,
/turf/open/gm/river/desert/shallow_corner/north,
/area/desert_dam/exterior/river/riverside_east)
"mC" = (
/obj/effect/decal/sand_overlay/sand1/corner1{
	dir = 1
	},
/turf/open/asphalt/tile,
/area/desert_dam/exterior/valley/valley_bridge)
"nC" = (
/obj/structure/platform{
	dir = 1
	},
/obj/effect/blocker/toxic_water/Group_2,
/turf/open/desert/dirt/dirt2,
/area/desert_dam/exterior/river/riverside_east)
"oh" = (
/obj/effect/blocker/toxic_water/Group_2,
/turf/open/gm/river/desert/shallow_edge/covered/east,
/area/desert_dam/exterior/river/riverside_east)
"sW" = (
/obj/effect/decal/sand_overlay/sand1{
	dir = 8
	},
/turf/open/asphalt/cement_sunbleached/cement_sunbleached9,
/area/desert_dam/exterior/valley/valley_medical)
"tk" = (
/obj/effect/blocker/toxic_water/Group_2,
/turf/open/desert/desert_shore/shore_corner2/west,
/area/desert_dam/exterior/river/riverside_east)
"uu" = (
/obj/effect/decal/sand_overlay/sand1/corner1,
/turf/open/asphalt/tile,
/area/desert_dam/exterior/valley/valley_medical)
"wh" = (
/obj/structure/platform_decoration,
/turf/open/desert/dirt/dirt2,
/area/desert_dam/exterior/river/riverside_east)
"wZ" = (
/obj/structure/stairs{
	dir = 8
	},
/obj/structure/platform{
	dir = 1
	},
/turf/open/asphalt/cement_sunbleached/cement_sunbleached2,
/area/desert_dam/exterior/valley/valley_medical)
"xf" = (
/turf/open/asphalt/cement_sunbleached/cement_sunbleached3,
/area/desert_dam/exterior/valley/valley_bridge)
"xU" = (
/obj/effect/blocker/toxic_water/Group_2,
/obj/structure/platform{
	dir = 8
	},
/turf/open/gm/river/desert/shallow_edge/north,
/area/desert_dam/exterior/river/riverside_east)
"zv" = (
/turf/open/asphalt/cement_sunbleached/cement_sunbleached14,
/area/desert_dam/exterior/valley/valley_bridge)
"EQ" = (
/turf/open/asphalt/cement_sunbleached/cement_sunbleached1,
/area/desert_dam/exterior/valley/valley_medical)
"FF" = (
/turf/open/asphalt/cement_sunbleached/cement_sunbleached4,
/area/desert_dam/exterior/valley/valley_medical)
"GJ" = (
/obj/structure/platform,
/turf/open/desert/dirt/dirt2,
/area/desert_dam/exterior/river/riverside_east)
"GY" = (
/obj/effect/decal/sand_overlay/sand1/corner1{
	dir = 4
	},
/turf/open/asphalt/tile,
/area/desert_dam/exterior/valley/valley_bridge)
"HC" = (
/obj/effect/decal/sand_overlay/sand1{
	dir = 1
	},
/turf/open/asphalt/tile,
/area/desert_dam/exterior/valley/valley_bridge)
"HJ" = (
/obj/structure/stairs{
	dir = 1
	},
/obj/structure/platform{
	dir = 4
	},
/turf/open/asphalt/cement_sunbleached/cement_sunbleached1,
/area/desert_dam/exterior/valley/valley_medical)
"Iw" = (
/obj/effect/blocker/toxic_water/Group_2,
/turf/open/gm/river/desert/shallow_edge/north,
/area/desert_dam/exterior/river/riverside_east)
"Ko" = (
/obj/effect/decal/sand_overlay/sand1{
	dir = 8
	},
/turf/open/asphalt/cement_sunbleached/cement_sunbleached1,
/area/desert_dam/exterior/valley/valley_medical)
"Kz" = (
/obj/effect/blocker/toxic_water/Group_2,
/turf/open/gm/river/desert/shallow_corner/west,
/area/desert_dam/exterior/river/riverside_east)
"KC" = (
/obj/structure/platform_decoration{
	dir = 1
	},
/turf/open/desert/dirt/dirt2,
/area/desert_dam/exterior/river/riverside_east)
"KG" = (
/obj/structure/platform{
	dir = 1
	},
/obj/effect/blocker/toxic_water/Group_2,
/turf/open/desert/desert_shore/shore_corner2/west,
/area/desert_dam/exterior/river/riverside_east)
"LQ" = (
/turf/open/asphalt/cement_sunbleached/cement_sunbleached1,
/area/desert_dam/exterior/valley/valley_bridge)
"Mv" = (
/obj/structure/platform_decoration{
	dir = 8
	},
/obj/effect/blocker/toxic_water/Group_2,
/turf/open/gm/river/desert/deep,
/area/desert_dam/exterior/river/riverside_east)
"MU" = (
/turf/open/desert/dirt/dirt2,
/area/desert_dam/exterior/river/riverside_east)
"NM" = (
/obj/effect/decal/sand_overlay/sand1{
	dir = 8
	},
/turf/open/asphalt/tile,
/area/desert_dam/exterior/valley/valley_bridge)
"OH" = (
/turf/open/asphalt/tile,
/area/desert_dam/exterior/valley/valley_medical)
"OV" = (
/obj/structure/platform_decoration{
	dir = 4
	},
/obj/effect/blocker/toxic_water/Group_2,
/turf/open/gm/river/desert/shallow_edge/northwest,
/area/desert_dam/exterior/river/riverside_east)
"Pb" = (
/turf/open/asphalt/cement_sunbleached/cement_sunbleached3,
/area/desert_dam/exterior/valley/valley_medical)
"PN" = (
/obj/effect/blocker/toxic_water/Group_2,
/turf/open/gm/river/desert/shallow_edge/southwest,
/area/desert_dam/exterior/river/riverside_east)
"Qx" = (
/obj/structure/platform_decoration{
	dir = 4
	},
/obj/effect/blocker/toxic_water/Group_2,
/turf/open/gm/river/desert/shallow_edge/west,
/area/desert_dam/exterior/river/riverside_east)
"Rp" = (
/obj/structure/stairs{
	dir = 8
	},
/obj/structure/platform,
/turf/open/asphalt/cement_sunbleached/cement_sunbleached14,
/area/desert_dam/exterior/valley/valley_medical)
"SS" = (
/obj/structure/stairs{
	dir = 1
	},
/obj/structure/platform{
	dir = 8
	},
/turf/open/asphalt/cement_sunbleached/cement_sunbleached3,
/area/desert_dam/exterior/valley/valley_medical)
"Tn" = (
/obj/effect/blocker/toxic_water/Group_2,
/turf/open/desert/desert_shore/desert_shore1/north,
/area/desert_dam/exterior/river/riverside_east)
"Tx" = (
/obj/structure/platform_decoration{
	dir = 8
	},
/turf/open/desert/dirt/dirt2,
/area/desert_dam/exterior/river/riverside_east)
"TI" = (
/obj/structure/platform{
	dir = 1
	},
/obj/effect/blocker/toxic_water/Group_2,
/turf/open/desert/desert_shore/shore_edge1/east,
/area/desert_dam/exterior/river/riverside_east)
"TN" = (
/turf/open/asphalt/tile,
/area/desert_dam/exterior/valley/valley_bridge)
"TT" = (
/obj/structure/platform{
	dir = 1
	},
/obj/structure/platform{
	dir = 8
	},
/obj/effect/blocker/toxic_water/Group_2,
/turf/open/desert/desert_shore/shore_corner2/north,
/area/desert_dam/exterior/river/riverside_east)
"TY" = (
/obj/effect/blocker/toxic_water/Group_2,
/turf/open/gm/river/desert/shallow_edge/northeast,
/area/desert_dam/exterior/river/riverside_east)
"Ze" = (
/obj/structure/platform{
	dir = 1
	},
/obj/effect/blocker/toxic_water/Group_2,
/turf/open/desert/desert_shore/shore_corner2/north,
/area/desert_dam/exterior/river/riverside_east)

(1,1,1) = {"
TN
Ze
Iw
ad
ad
ad
Kz
PN
aN
aV
MU
GJ
OH
"}
(2,1,1) = {"
TT
OV
lx
ad
ad
ad
ad
aM
aO
aW
MU
GJ
OH
"}
(3,1,1) = {"
Qx
lx
ad
ad
ad
ad
ad
Kz
PN
aW
MU
GJ
OH
"}
(4,1,1) = {"
ad
ad
ad
ad
ad
ad
ad
ad
aM
aW
MU
GJ
OH
"}
(5,1,1) = {"
ad
ad
ad
ad
ad
ad
ad
ad
aM
aW
MU
KC
SS
"}
(6,1,1) = {"
ae
an
Mv
ad
ad
ad
ad
ad
aP
aX
Tx
wh
HJ
"}
(7,1,1) = {"
TN
TN
av
aC
aC
aC
aC
aC
aQ
OH
wZ
Rp
OH
"}
(8,1,1) = {"
xf
zv
aw
aw
aw
aw
aw
aw
aR
Pb
bf
bm
OH
"}
(9,1,1) = {"
LQ
jl
oh
aD
aw
aw
aw
aw
aR
EQ
bf
bm
OH
"}
(10,1,1) = {"
NM
GY
ay
xU
aI
aI
aI
aI
aS
OH
FF
bm
OH
"}
(11,1,1) = {"
ai
HC
KG
TY
aJ
ad
ad
ad
aT
OH
FF
bf
Pb
"}
(12,1,1) = {"
aj
mC
TI
tk
Iw
ad
ad
ad
aU
OH
FF
bf
bf
"}
(13,1,1) = {"
aj
TN
nC
Tn
Iw
ad
ad
ad
aT
OH
FF
bf
bf
"}
(14,1,1) = {"
aj
TN
nC
Tn
Iw
ad
ad
ad
aT
uu
sW
Ko
Ko
"}
