//MAP CONVERTED BY dmm2tgm.py THIS HEADER COMMENT PREVENTS RECONVERSION, DO NOT REMOVE
"af" = (
/turf/closed/shuttle/midway/transparent{
	icon_state = "34"
	},
/area/shuttle/midway)
"bm" = (
/obj/structure/shuttle/part/dropship1/transparent/engine_right_exhaust{
	name = "\improper Midway"
	},
/turf/template_noop,
/area/shuttle/midway)
"bs" = (
/turf/open/shuttle/dropship{
	icon_state = "rasputin6"
	},
/area/shuttle/midway)
"dr" = (
/obj/structure/machinery/door_control{
	id = "dropship_midway";
	name = "Dropship Lockdown";
	normaldoorcontrol = 3;
	pixel_y = -19;
	req_one_access_txt = "3;22"
	},
/turf/open/shuttle/dropship{
	icon_state = "rasputin15"
	},
/area/shuttle/midway)
"dB" = (
/obj/structure/shuttle/part/dropship1/left_inner_wing_connector{
	name = "\improper Midway"
	},
/turf/template_noop,
/area/shuttle/midway)
"dD" = (
/turf/closed/shuttle/midway/transparent{
	icon_state = "22"
	},
/area/shuttle/midway)
"dE" = (
/turf/closed/shuttle/midway{
	icon_state = "42"
	},
/area/shuttle/midway)
"eu" = (
/obj/structure/shuttle/part/dropship1/transparent/left_outer_bottom_wing{
	name = "\improper Midway"
	},
/turf/template_noop,
/area/shuttle/midway)
"go" = (
/obj/structure/phone_base/rotary{
	name = "Midway Telephone";
	phone_category = "Dropship";
	phone_id = "Midway";
	pixel_x = 11;
	pixel_y = 16
	},
/obj/structure/blocker/invisible_wall,
/obj/structure/machinery/computer/dropship_weapons/midway,
/turf/open/shuttle/dropship{
	icon_state = "rasputin15"
	},
/area/shuttle/midway)
"gw" = (
/obj/structure/shuttle/part/dropship2/transparent/engine_right_cap{
	name = "\improper Midway"
	},
/turf/template_noop,
/area/shuttle/midway)
"hl" = (
/turf/closed/shuttle/midway{
	icon_state = "24"
	},
/area/shuttle/midway)
"hL" = (
/obj/structure/machinery/light{
	dir = 8;
	pixel_x = -14
	},
/turf/open/shuttle/dropship{
	icon_state = "rasputin2"
	},
/area/shuttle/midway)
"hO" = (
/turf/closed/shuttle/midway/transparent{
	icon_state = "86"
	},
/area/shuttle/midway)
"if" = (
/turf/closed/shuttle/midway/transparent{
	icon_state = "27"
	},
/area/shuttle/midway)
"im" = (
/obj/structure/shuttle/part/dropship1/transparent/nose_top_left{
	name = "\improper Midway"
	},
/turf/template_noop,
/area/shuttle/midway)
"iv" = (
/obj/structure/machinery/cm_vending/sorted/medical/wall_med{
	pixel_x = -30
	},
/turf/open/shuttle/dropship{
	icon_state = "rasputin15"
	},
/area/shuttle/midway)
"je" = (
/obj/structure/machinery/camera/autoname/golden_arrow/midway{
	dir = 4;
	pixel_x = -23
	},
/turf/open/shuttle/dropship{
	icon_state = "rasputin3"
	},
/area/shuttle/midway)
"jy" = (
/obj/effect/attach_point/crew_weapon/midway{
	attach_id = 8
	},
/obj/structure/machinery/light{
	dir = 8;
	pixel_x = -14
	},
/turf/open/shuttle/dropship{
	icon_state = "rasputin15"
	},
/area/shuttle/midway)
"jW" = (
/turf/open/shuttle/dropship{
	icon_state = "rasputin3"
	},
/area/shuttle/midway)
"kC" = (
/obj/structure/platform{
	dir = 1
	},
/obj/effect/decal/warning_stripes{
	icon_state = "N";
	pixel_y = 1
	},
/turf/open/shuttle/dropship{
	icon_state = "floor8"
	},
/area/shuttle/midway)
"ls" = (
/turf/closed/shuttle/midway/transparent{
	icon_state = "35"
	},
/area/shuttle/midway)
"lC" = (
/turf/closed/shuttle/midway{
	icon_state = "104"
	},
/area/shuttle/midway)
"mh" = (
/obj/structure/shuttle/part/dropship1/right_inner_wing_connector{
	name = "\improper Midway"
	},
/turf/template_noop,
/area/shuttle/midway)
"mE" = (
/obj/structure/shuttle/part/dropship1/transparent/left_inner_bottom_wing{
	name = "\improper Midway"
	},
/turf/template_noop,
/area/shuttle/midway)
"mG" = (
/obj/structure/shuttle/part/dropship1/transparent/upper_left_wing{
	name = "\improper Midway"
	},
/turf/template_noop,
/area/shuttle/midway)
"mL" = (
/obj/structure/platform_decoration{
	dir = 4
	},
/obj/effect/decal/warning_stripes{
	icon_state = "N";
	pixel_y = 1
	},
/turf/open/shuttle/dropship{
	icon_state = "rasputin7"
	},
/area/shuttle/midway)
"mR" = (
/obj/structure/shuttle/part/dropship1/nose_front_left{
	name = "\improper Midway"
	},
/turf/template_noop,
/area/shuttle/midway)
"nH" = (
/obj/structure/shuttle/part/dropship1/transparent/nose_center{
	name = "\improper Midway"
	},
/turf/template_noop,
/area/shuttle/midway)
"od" = (
/obj/structure/shuttle/part/dropship1/transparent/middle_left_wing{
	name = "\improper Midway"
	},
/turf/template_noop,
/area/shuttle/midway)
"ok" = (
/obj/structure/shuttle/part/dropship1/transparent/nose_center{
	name = "\improper Midway";
	icon_state = "105"
	},
/obj/effect/attach_point/electronics/midway{
	attach_id = 5
	},
/turf/template_noop,
/area/shuttle/midway)
"ro" = (
/turf/closed/shuttle/midway/transparent{
	icon_state = "80"
	},
/area/shuttle/midway)
"rq" = (
/turf/closed/shuttle/midway{
	icon_state = "77"
	},
/area/shuttle/midway)
"rr" = (
/turf/closed/shuttle/midway{
	icon_state = "103"
	},
/area/shuttle/midway)
"rF" = (
/obj/structure/shuttle/part/dropship1/lower_right_wall{
	name = "\improper Midway"
	},
/turf/template_noop,
/area/shuttle/midway)
"rR" = (
/turf/closed/shuttle/midway/transparent{
	icon_state = "32"
	},
/area/shuttle/midway)
"sl" = (
/turf/closed/shuttle/midway{
	icon_state = "31"
	},
/area/shuttle/midway)
"tf" = (
/obj/structure/bed/chair/dropship/pilot{
	dir = 1
	},
/turf/open/shuttle/dropship{
	icon_state = "rasputin15"
	},
/area/shuttle/midway)
"ti" = (
/obj/structure/extinguisher_cabinet/lifeboat{
	pixel_x = 12
	},
/turf/closed/shuttle/midway/transparent{
	icon_state = "78"
	},
/area/shuttle/midway)
"tG" = (
/obj/structure/machinery/cm_vending/sorted/medical/wall_med{
	pixel_x = 30
	},
/turf/open/shuttle/dropship{
	icon_state = "rasputin3"
	},
/area/shuttle/midway)
"tP" = (
/obj/structure/shuttle/part/dropship1/transparent/right_outer_bottom_wing{
	name = "\improper Midway"
	},
/turf/template_noop,
/area/shuttle/midway)
"ul" = (
/obj/structure/shuttle/part/dropship2/transparent/engine_left_cap{
	name = "\improper Midway"
	},
/turf/template_noop,
/area/shuttle/midway)
"ux" = (
/obj/structure/bed/chair/vehicle{
	pixel_x = -8
	},
/obj/structure/bed/chair/vehicle{
	pixel_x = 8
	},
/turf/open/shuttle/dropship{
	icon_state = "rasputin14"
	},
/area/shuttle/midway)
"vJ" = (
/turf/closed/shuttle/midway{
	icon_state = "92"
	},
/area/shuttle/midway)
"vN" = (
/obj/structure/shuttle/part/dropship1/transparent/middle_right_wing{
	name = "\improper Midway"
	},
/turf/template_noop,
/area/shuttle/midway)
"wB" = (
/turf/closed/shuttle/midway{
	icon_state = "83"
	},
/area/shuttle/midway)
"xp" = (
/turf/closed/shuttle/midway{
	icon_state = "62"
	},
/area/shuttle/midway)
"xy" = (
/obj/effect/attach_point/crew_weapon/midway{
	attach_id = 9
	},
/obj/structure/machinery/light{
	dir = 4;
	pixel_x = 14
	},
/turf/open/shuttle/dropship{
	icon_state = "rasputin15"
	},
/area/shuttle/midway)
"ym" = (
/turf/closed/shuttle/midway{
	icon_state = "69"
	},
/area/shuttle/midway)
"yB" = (
/turf/closed/shuttle/midway{
	icon_state = "54"
	},
/area/shuttle/midway)
"yN" = (
/obj/structure/shuttle/part/dropship1/right_outer_wing_connector{
	name = "\improper Midway"
	},
/turf/template_noop,
/area/shuttle/midway)
"yO" = (
/turf/closed/shuttle/midway{
	icon_state = "94"
	},
/area/shuttle/midway)
"zm" = (
/turf/closed/shuttle/midway/transparent{
	icon_state = "23"
	},
/area/shuttle/midway)
"Aw" = (
/turf/closed/shuttle/midway/transparent{
	icon_state = "97"
	},
/area/shuttle/midway)
"Bn" = (
/turf/closed/shuttle/midway{
	icon_state = "30"
	},
/area/shuttle/midway)
"BI" = (
/turf/closed/shuttle/midway{
	icon_state = "47"
	},
/area/shuttle/midway)
"BS" = (
/turf/closed/shuttle/midway/transparent{
	icon_state = "38"
	},
/area/shuttle/midway)
"BU" = (
/obj/structure/shuttle/part/dropship1/transparent/engine_left_exhaust{
	name = "\improper Midway"
	},
/turf/template_noop,
/area/shuttle/midway)
"Cc" = (
/obj/structure/machinery/camera/autoname/golden_arrow/midway{
	dir = 8;
	pixel_x = 23
	},
/turf/open/shuttle/dropship{
	icon_state = "rasputin15"
	},
/area/shuttle/midway)
"Cm" = (
/obj/effect/attach_point/fuel/midway{
	attach_id = 10
	},
/turf/closed/shuttle/midway/transparent{
	icon_state = "28"
	},
/area/shuttle/midway)
"Cr" = (
/obj/structure/prop/ice_colony/hula_girl{
	pixel_x = -10;
	pixel_y = 16
	},
/obj/structure/blocker/invisible_wall,
/obj/structure/machinery/computer/cameras/dropship/midway,
/turf/open/shuttle/dropship{
	icon_state = "rasputin15"
	},
/area/shuttle/midway)
"Db" = (
/turf/closed/shuttle/midway/transparent{
	icon_state = "26"
	},
/area/shuttle/midway)
"Dg" = (
/turf/open/shuttle/dropship,
/area/shuttle/midway)
"Ds" = (
/obj/structure/stairs/perspective,
/obj/structure/platform{
	dir = 4;
	layer = 2.7
	},
/turf/open/shuttle/dropship{
	icon_state = "rasputin3"
	},
/area/shuttle/midway)
"DH" = (
/turf/closed/shuttle/midway/transparent{
	icon_state = "89"
	},
/area/shuttle/midway)
"Ed" = (
/turf/closed/shuttle/midway{
	icon_state = "25"
	},
/area/shuttle/midway)
"EN" = (
/obj/structure/shuttle/part/dropship1/nose_front_right{
	name = "\improper Midway"
	},
/turf/template_noop,
/area/shuttle/midway)
"Fu" = (
/obj/structure/shuttle/part/dropship1/transparent/lower_right_wing{
	name = "\improper Midway"
	},
/obj/effect/attach_point/weapon/midway/right_wing,
/turf/template_noop,
/area/shuttle/midway)
"Gf" = (
/obj/structure/machinery/camera/autoname/golden_arrow/midway{
	pixel_x = -6;
	pixel_y = -16
	},
/obj/structure/machinery/light{
	dir = 4;
	pixel_x = 14
	},
/turf/open/shuttle/dropship{
	icon_state = "rasputin2"
	},
/area/shuttle/midway)
"Gh" = (
/turf/open/shuttle/dropship{
	icon_state = "rasputin7"
	},
/area/shuttle/midway)
"Go" = (
/obj/structure/shuttle/part/dropship1/transparent/outer_left_weapons{
	name = "\improper Midway"
	},
/obj/effect/attach_point/weapon/midway/left_fore,
/turf/template_noop,
/area/shuttle/midway)
"Hj" = (
/turf/closed/shuttle/midway{
	icon_state = "75"
	},
/area/shuttle/midway)
"Hz" = (
/obj/structure/shuttle/part/dropship1/left_outer_wing_connector{
	name = "\improper Midway"
	},
/turf/template_noop,
/area/shuttle/midway)
"HY" = (
/obj/structure/machinery/door/airlock/multi_tile/almayer/dropshiprear/ds1{
	id = "aft_door";
	name = "\improper Midway cargo door"
	},
/turf/open/shuttle/dropship{
	icon_state = "rasputin15"
	},
/area/shuttle/midway)
"Id" = (
/obj/effect/attach_point/crew_weapon/midway{
	attach_id = 7
	},
/turf/open/shuttle/dropship{
	icon_state = "rasputin15"
	},
/area/shuttle/midway)
"Ji" = (
/turf/closed/shuttle/midway{
	icon_state = "64"
	},
/area/shuttle/midway)
"Jq" = (
/turf/closed/shuttle/midway{
	icon_state = "72"
	},
/area/shuttle/midway)
"Kp" = (
/obj/structure/machinery/door/airlock/multi_tile/almayer/dropshiprear/dropshipside/ds1/midway{
	dir = 1;
	id = "starboard_door"
	},
/turf/open/shuttle/dropship{
	icon_state = "rasputin15"
	},
/area/shuttle/midway)
"Ks" = (
/obj/structure/shuttle/part/dropship1/transparent/lower_left_wing{
	name = "\improper Midway"
	},
/obj/effect/attach_point/weapon/midway/left_wing,
/turf/template_noop,
/area/shuttle/midway)
"Kv" = (
/obj/structure/machinery/light{
	dir = 4;
	pixel_x = 14
	},
/turf/open/shuttle/dropship{
	icon_state = "rasputin3"
	},
/area/shuttle/midway)
"Kw" = (
/turf/template_noop,
/area/template_noop)
"Lr" = (
/turf/closed/shuttle/midway{
	icon_state = "48"
	},
/area/shuttle/midway)
"LY" = (
/obj/structure/blocker/invisible_wall,
/obj/structure/machinery/computer/shuttle/dropship/flight,
/turf/open/shuttle/dropship{
	icon_state = "rasputin15"
	},
/area/shuttle/midway)
"LZ" = (
/obj/structure/shuttle/part/dropship1/transparent/upper_right_wing{
	name = "\improper Midway"
	},
/turf/template_noop,
/area/shuttle/midway)
"Mw" = (
/obj/structure/shuttle/part/dropship1/transparent/nose_center{
	name = "\improper Midway";
	icon_state = "105"
	},
/obj/effect/attach_point/electronics/midway{
	attach_id = 6
	},
/turf/template_noop,
/area/shuttle/midway)
"Mz" = (
/obj/structure/stairs/perspective,
/obj/structure/platform{
	dir = 8;
	layer = 2.7
	},
/turf/open/shuttle/dropship{
	icon_state = "rasputin3"
	},
/area/shuttle/midway)
"ME" = (
/turf/open/shuttle/dropship{
	icon_state = "rasputin15"
	},
/area/shuttle/midway)
"OB" = (
/turf/closed/shuttle/midway/transparent{
	icon_state = "96"
	},
/area/shuttle/midway)
"Pc" = (
/turf/closed/shuttle/midway/transparent{
	icon_state = "98"
	},
/area/shuttle/midway)
"PP" = (
/obj/structure/machinery/door/airlock/hatch/cockpit,
/obj/structure/blocker/forcefield/multitile_vehicles,
/turf/open/shuttle/dropship{
	icon_state = "rasputin15"
	},
/area/shuttle/midway)
"Qk" = (
/obj/docking_port/mobile/marine_dropship/midway,
/turf/open/shuttle/dropship{
	icon_state = "rasputin15"
	},
/area/shuttle/midway)
"QI" = (
/obj/structure/shuttle/part/dropship1/lower_left_wall{
	name = "\improper Midway"
	},
/turf/template_noop,
/area/shuttle/midway)
"QK" = (
/obj/structure/machinery/light{
	dir = 8;
	pixel_x = -14
	},
/turf/open/shuttle/dropship{
	icon_state = "rasputin3"
	},
/area/shuttle/midway)
"Rm" = (
/obj/structure/platform_decoration{
	dir = 8
	},
/obj/effect/decal/warning_stripes{
	icon_state = "N";
	pixel_y = 1
	},
/turf/open/shuttle/dropship{
	icon_state = "rasputin6"
	},
/area/shuttle/midway)
"SS" = (
/obj/structure/machinery/door/airlock/multi_tile/almayer/dropshiprear/dropshipside/ds1/midway{
	dir = 2;
	id = "port_door"
	},
/turf/open/shuttle/dropship{
	icon_state = "rasputin15"
	},
/area/shuttle/midway)
"SZ" = (
/obj/structure/shuttle/part/dropship1/transparent/right_inner_bottom_wing{
	name = "\improper Midway"
	},
/turf/template_noop,
/area/shuttle/midway)
"Tl" = (
/obj/structure/shuttle/part/dropship1/transparent/nose_top_right{
	name = "\improper Midway"
	},
/turf/template_noop,
/area/shuttle/midway)
"UI" = (
/obj/structure/bed/chair/vehicle{
	pixel_x = -8
	},
/obj/structure/bed/chair/vehicle{
	pixel_x = 8
	},
/turf/open/shuttle/dropship{
	icon_state = "rasputin15"
	},
/area/shuttle/midway)
"Vu" = (
/turf/closed/shuttle/midway{
	icon_state = "67"
	},
/area/shuttle/midway)
"VU" = (
/turf/closed/shuttle/midway{
	icon_state = "73"
	},
/area/shuttle/midway)
"WN" = (
/obj/structure/bed/chair/vehicle{
	dir = 1;
	pixel_x = -8
	},
/obj/structure/bed/chair/vehicle{
	dir = 1;
	pixel_x = 8
	},
/turf/open/shuttle/dropship{
	icon_state = "rasputin15"
	},
/area/shuttle/midway)
"XH" = (
/obj/effect/attach_point/fuel/midway{
	pixel_x = -32;
	attach_id = 11
	},
/turf/closed/shuttle/midway/transparent{
	icon_state = "33"
	},
/area/shuttle/midway)
"Yr" = (
/turf/closed/shuttle/midway{
	icon_state = "81"
	},
/area/shuttle/midway)
"Zr" = (
/obj/structure/shuttle/part/dropship1/transparent/outer_right_weapons{
	name = "\improper Midway"
	},
/obj/effect/attach_point/weapon/midway/right_fore,
/turf/template_noop,
/area/shuttle/midway)
"Zu" = (
/turf/closed/shuttle/midway/transparent{
	icon_state = "29"
	},
/area/shuttle/midway)
"ZZ" = (
/turf/closed/shuttle/midway/transparent{
	icon_state = "39"
	},
/area/shuttle/midway)

(1,1,1) = {"
Kw
Kw
Kw
Kw
Kw
mG
od
Ks
Kw
Kw
Kw
ul
af
Cm
dD
BU
Kw
mE
"}
(2,1,1) = {"
Kw
Kw
Kw
Go
Hj
Jq
Vu
xp
ME
SS
QI
gw
ls
Zu
zm
bm
Kw
eu
"}
(3,1,1) = {"
im
mR
vJ
hO
Yr
UI
iv
jy
ME
dr
BI
dE
dE
Bn
hl
rr
dB
Hz
"}
(4,1,1) = {"
ok
OB
Cr
hL
ti
ux
bs
jW
jW
jW
Ds
Rm
jW
je
QK
HY
Kw
Kw
"}
(5,1,1) = {"
nH
Aw
LY
tf
PP
jW
Dg
WN
ME
Qk
Id
kC
ME
ME
ME
ME
Kw
Kw
"}
(6,1,1) = {"
Mw
Pc
go
Gf
ro
ux
Gh
jW
jW
jW
Mz
mL
tG
jW
Kv
ME
Kw
Kw
"}
(7,1,1) = {"
Tl
EN
yO
DH
rq
UI
Cc
xy
ME
dr
Lr
yB
yB
sl
Ed
lC
mh
yN
"}
(8,1,1) = {"
Kw
Kw
Kw
Zr
wB
VU
ym
Ji
ME
Kp
rF
ul
BS
rR
Db
BU
Kw
SZ
"}
(9,1,1) = {"
Kw
Kw
Kw
Kw
Kw
LZ
vN
Fu
Kw
Kw
Kw
gw
ZZ
XH
if
bm
Kw
tP
"}
