//MAP CONVERTED BY dmm2tgm.py THIS HEADER COMMENT PREVENTS RECONVERSION, DO NOT REMOVE
"aa" = (
/obj/structure/stairs/perspective,
/obj/structure/platform{
	dir = 8
	},
/turf/open/shuttle/dropship{
	icon_state = "rasputin3"
	},
/area/shuttle/tulagi)
"at" = (
/turf/template_noop,
/area/space)
"aV" = (
/obj/structure/shuttle/part/dropship2/transparent/engine_right_exhaust,
/turf/template_noop,
/area/shuttle/tulagi)
"aX" = (
/obj/structure/machinery/camera/autoname/almayer/dropship_two{
	pixel_x = 8;
	pixel_y = -16;
	network = list("Golden Arrow","Cyclone")
	},
/turf/open/shuttle/dropship{
	icon_state = "rasputin15"
	},
/area/shuttle/tulagi)
"bd" = (
/turf/open/shuttle/dropship{
	icon_state = "floor8"
	},
/area/shuttle/tulagi)
"by" = (
/turf/closed/shuttle/tulagi{
	icon_state = "47"
	},
/area/shuttle/tulagi)
"bz" = (
/turf/closed/shuttle/tulagi/transparent{
	icon_state = "92"
	},
/area/shuttle/tulagi)
"bB" = (
/turf/open/shuttle/dropship{
	icon_state = "rasputin15"
	},
/area/shuttle/tulagi)
"cF" = (
/turf/closed/shuttle/tulagi/transparent{
	icon_state = "80"
	},
/area/shuttle/tulagi)
"cK" = (
/obj/structure/stairs/perspective,
/obj/structure/platform{
	dir = 4
	},
/turf/open/shuttle/dropship{
	icon_state = "rasputin3"
	},
/area/shuttle/tulagi)
"cO" = (
/obj/structure/machinery/computer/shuttle/dropship/flight{
	shuttleId = dropship_tulagi
	},
/obj/structure/blocker/invisible_wall,
/turf/open/shuttle/dropship{
	icon_state = "rasputin15"
	},
/area/shuttle/tulagi)
"cS" = (
/turf/closed/shuttle/tulagi{
	icon_state = "75"
	},
/area/shuttle/tulagi)
"dp" = (
/turf/closed/shuttle/tulagi/transparent{
	icon_state = "34"
	},
/area/shuttle/tulagi)
"eh" = (
/turf/closed/shuttle/tulagi/transparent{
	icon_state = "27"
	},
/area/shuttle/tulagi)
"eq" = (
/turf/open/shuttle/dropship{
	icon_state = "rasputin7"
	},
/area/shuttle/tulagi)
"eE" = (
/obj/structure/shuttle/part/dropship2/left_inner_wing_connector,
/turf/template_noop,
/area/shuttle/tulagi)
"fa" = (
/obj/structure/machinery/door/airlock/hatch/cockpit/two,
/obj/structure/blocker/forcefield/multitile_vehicles,
/turf/open/shuttle/dropship{
	icon_state = "rasputin15"
	},
/area/shuttle/tulagi)
"fs" = (
/obj/structure/bed/chair/dropship/passenger{
	pixel_x = -8
	},
/obj/structure/bed/chair/dropship/passenger{
	pixel_x = 9
	},
/turf/open/shuttle/dropship{
	icon_state = "rasputin15"
	},
/area/shuttle/tulagi)
"fD" = (
/obj/structure/shuttle/part/dropship2/nose_front_left,
/turf/template_noop,
/area/shuttle/tulagi)
"gt" = (
/turf/closed/shuttle/tulagi{
	icon_state = "69"
	},
/area/shuttle/tulagi)
"gz" = (
/obj/structure/shuttle/part/dropship2/transparent/nose_top_right,
/turf/template_noop,
/area/shuttle/tulagi)
"hb" = (
/obj/effect/attach_point/weapon/dropship2/left_wing,
/obj/structure/shuttle/part/dropship2/transparent/lower_left_wing,
/obj/effect/attach_point/weapon/midway/left_wing{
	ship_tag = "dropship_cyclone"
	},
/turf/template_noop,
/area/shuttle/tulagi)
"iG" = (
/turf/closed/shuttle/tulagi{
	icon_state = "62"
	},
/area/shuttle/tulagi)
"iY" = (
/obj/effect/attach_point/weapon/midway/right_fore,
/obj/structure/shuttle/part/dropship2/transparent/outer_right_weapons,
/turf/template_noop,
/area/shuttle/tulagi)
"jQ" = (
/obj/effect/attach_point/fuel/dropship2,
/turf/closed/shuttle/tulagi/transparent{
	icon_state = "32"
	},
/area/shuttle/tulagi)
"ki" = (
/turf/closed/shuttle/tulagi/transparent{
	icon_state = "39"
	},
/area/shuttle/tulagi)
"kp" = (
/obj/structure/shuttle/part/dropship2/left_outer_wing_connector,
/turf/template_noop,
/area/shuttle/tulagi)
"kQ" = (
/turf/closed/shuttle/tulagi{
	icon_state = "48"
	},
/area/shuttle/tulagi)
"lA" = (
/obj/structure/machinery/camera/autoname/golden_arrow/midway{
	dir = 4;
	pixel_x = -23;
	network = list("Golden Arrow","Cyclone")
	},
/turf/open/shuttle/dropship{
	icon_state = "rasputin3"
	},
/area/shuttle/tulagi)
"lB" = (
/obj/structure/shuttle/part/dropship2/lower_right_wall,
/turf/template_noop,
/area/shuttle/tulagi)
"lQ" = (
/turf/closed/shuttle/tulagi{
	icon_state = "72"
	},
/area/shuttle/tulagi)
"mh" = (
/obj/effect/attach_point/crew_weapon/midway{
	ship_tag = "dropship_cyclone"
	},
/turf/open/shuttle/dropship{
	icon_state = "rasputin15"
	},
/area/shuttle/tulagi)
"oU" = (
/obj/structure/shuttle/part/dropship2/nose_front_right,
/turf/template_noop,
/area/shuttle/tulagi)
"po" = (
/obj/structure/shuttle/part/dropship2/transparent/right_inner_bottom_wing,
/turf/template_noop,
/area/shuttle/tulagi)
"qv" = (
/turf/closed/shuttle/tulagi{
	icon_state = "77"
	},
/area/shuttle/tulagi)
"rC" = (
/obj/structure/shuttle/part/dropship2/transparent/upper_right_wing,
/turf/template_noop,
/area/shuttle/tulagi)
"rQ" = (
/turf/open/shuttle/dropship{
	icon_state = "rasputin8"
	},
/area/shuttle/tulagi)
"sC" = (
/turf/closed/shuttle/tulagi/transparent{
	icon_state = "33"
	},
/area/shuttle/tulagi)
"sF" = (
/obj/structure/stairs/perspective,
/turf/open/shuttle/dropship{
	icon_state = "rasputin15"
	},
/area/shuttle/tulagi)
"sY" = (
/turf/closed/shuttle/tulagi{
	icon_state = "83"
	},
/area/shuttle/tulagi)
"vj" = (
/obj/structure/shuttle/part/dropship2/transparent/right_outer_bottom_wing,
/turf/template_noop,
/area/shuttle/tulagi)
"vq" = (
/turf/closed/shuttle/tulagi{
	icon_state = "42"
	},
/area/shuttle/tulagi)
"vA" = (
/turf/closed/shuttle/tulagi{
	icon_state = "43"
	},
/area/shuttle/tulagi)
"vK" = (
/turf/closed/shuttle/tulagi{
	icon_state = "73"
	},
/area/shuttle/tulagi)
"vP" = (
/obj/structure/bed/chair/dropship/passenger{
	dir = 8
	},
/turf/open/shuttle/dropship{
	icon_state = "rasputin15"
	},
/area/shuttle/tulagi)
"we" = (
/obj/structure/machinery/cm_vending/sorted/medical/wall_med{
	pixel_x = -30
	},
/obj/structure/bed/chair/dropship/passenger{
	dir = 4
	},
/turf/open/shuttle/dropship{
	icon_state = "rasputin15"
	},
/area/shuttle/tulagi)
"wm" = (
/turf/closed/shuttle/tulagi/transparent{
	icon_state = "26"
	},
/area/shuttle/tulagi)
"wq" = (
/obj/structure/machinery/computer/cameras/dropship/two{
	name = "\improper 'Tulagi' camera controls";
	network = list("Cyclone","Laser Targets")
	},
/obj/structure/blocker/invisible_wall,
/turf/open/shuttle/dropship{
	icon_state = "rasputin15"
	},
/area/shuttle/tulagi)
"wD" = (
/turf/open/shuttle/dropship{
	icon_state = "rasputin14"
	},
/area/shuttle/tulagi)
"xc" = (
/obj/effect/attach_point/weapon/dropship2/right_wing,
/obj/structure/shuttle/part/dropship2/transparent/lower_right_wing,
/obj/effect/attach_point/weapon/midway/right_wing{
	ship_tag = "dropship_cyclone"
	},
/turf/template_noop,
/area/shuttle/tulagi)
"zy" = (
/obj/structure/machinery/light{
	dir = 8;
	pixel_x = -14
	},
/turf/open/shuttle/dropship{
	icon_state = "rasputin3"
	},
/area/shuttle/tulagi)
"zK" = (
/turf/closed/shuttle/tulagi{
	icon_state = "64"
	},
/area/shuttle/tulagi)
"zT" = (
/turf/closed/shuttle/tulagi/transparent{
	icon_state = "98"
	},
/area/shuttle/tulagi)
"Az" = (
/obj/structure/shuttle/part/dropship2/transparent/engine_left_exhaust,
/turf/template_noop,
/area/shuttle/tulagi)
"AC" = (
/obj/structure/shuttle/part/dropship2/transparent/left_outer_inner_wing,
/turf/template_noop,
/area/shuttle/tulagi)
"Bb" = (
/obj/structure/shuttle/part/dropship2/transparent/middle_left_wing,
/turf/template_noop,
/area/shuttle/tulagi)
"Bu" = (
/obj/structure/machinery/door/airlock/multi_tile/almayer/dropshiprear/dropshipside/ds2/cyclone{
	dir = 1;
	id = "starboard_door";
	name = "\improper Tulagi crew hatch"
	},
/turf/open/shuttle/dropship{
	icon_state = "rasputin15"
	},
/area/shuttle/tulagi)
"CD" = (
/obj/structure/machinery/cm_vending/sorted/medical/wall_med{
	pixel_x = 30
	},
/turf/open/shuttle/dropship{
	icon_state = "rasputin3"
	},
/area/shuttle/tulagi)
"CG" = (
/turf/open/shuttle/dropship{
	icon_state = "rasputin6"
	},
/area/shuttle/tulagi)
"CT" = (
/turf/closed/shuttle/tulagi/transparent{
	icon_state = "23"
	},
/area/shuttle/tulagi)
"DJ" = (
/obj/structure/shuttle/part/dropship2/lower_left_wall,
/turf/template_noop,
/area/shuttle/tulagi)
"Ej" = (
/obj/structure/machinery/door/airlock/multi_tile/almayer/dropshiprear/ds2{
	id = "aft_door";
	name = "\improper Tulagi cargo door"
	},
/turf/open/shuttle/dropship{
	icon_state = "rasputin15"
	},
/area/shuttle/tulagi)
"GI" = (
/turf/closed/shuttle/tulagi/transparent{
	icon_state = "38"
	},
/area/shuttle/tulagi)
"Ho" = (
/obj/structure/shuttle/part/dropship2/transparent/engine_left_cap,
/turf/template_noop,
/area/shuttle/tulagi)
"IW" = (
/turf/closed/shuttle/tulagi{
	icon_state = "18"
	},
/area/shuttle/tulagi)
"KU" = (
/turf/closed/shuttle/tulagi/transparent{
	icon_state = "94"
	},
/area/shuttle/tulagi)
"KX" = (
/obj/effect/attach_point/fuel/dropship2,
/turf/closed/shuttle/tulagi/transparent{
	icon_state = "28"
	},
/area/shuttle/tulagi)
"LI" = (
/turf/closed/shuttle/tulagi/transparent{
	icon_state = "78"
	},
/area/shuttle/tulagi)
"MJ" = (
/obj/structure/shuttle/part/dropship2/right_inner_wing_connector,
/turf/template_noop,
/area/shuttle/tulagi)
"Nx" = (
/obj/structure/bed/chair/dropship/passenger{
	dir = 4
	},
/turf/open/shuttle/dropship{
	icon_state = "rasputin15"
	},
/area/shuttle/tulagi)
"Pi" = (
/obj/structure/shuttle/part/dropship2/right_outer_wing_connector,
/turf/template_noop,
/area/shuttle/tulagi)
"Pl" = (
/turf/closed/shuttle/tulagi/transparent{
	icon_state = "89"
	},
/area/shuttle/tulagi)
"Pp" = (
/obj/structure/shuttle/part/dropship2/transparent/engine_right_cap,
/turf/template_noop,
/area/shuttle/tulagi)
"PR" = (
/turf/closed/shuttle/tulagi/transparent{
	icon_state = "96"
	},
/area/shuttle/tulagi)
"PV" = (
/turf/closed/shuttle/tulagi/transparent{
	icon_state = "35"
	},
/area/shuttle/tulagi)
"Qe" = (
/obj/structure/shuttle/part/dropship2/transparent/nose_center,
/turf/template_noop,
/area/shuttle/tulagi)
"Qw" = (
/turf/closed/shuttle/tulagi{
	icon_state = "25"
	},
/area/shuttle/tulagi)
"QY" = (
/turf/closed/shuttle/tulagi{
	icon_state = "19"
	},
/area/shuttle/tulagi)
"Rd" = (
/turf/closed/shuttle/tulagi{
	icon_state = "37"
	},
/area/shuttle/tulagi)
"Rn" = (
/obj/structure/shuttle/part/dropship2/transparent/middle_right_wing,
/turf/template_noop,
/area/shuttle/tulagi)
"Rw" = (
/turf/closed/shuttle/tulagi/transparent{
	icon_state = "97"
	},
/area/shuttle/tulagi)
"RC" = (
/turf/open/shuttle/dropship{
	icon_state = "rasputin3"
	},
/area/shuttle/tulagi)
"RH" = (
/turf/closed/shuttle/tulagi{
	icon_state = "67"
	},
/area/shuttle/tulagi)
"RI" = (
/turf/closed/shuttle/tulagi/transparent{
	icon_state = "22"
	},
/area/shuttle/tulagi)
"RT" = (
/turf/closed/shuttle/tulagi{
	icon_state = "80"
	},
/area/shuttle/tulagi)
"RU" = (
/obj/structure/shuttle/part/dropship2/transparent/nose_top_left,
/turf/template_noop,
/area/shuttle/tulagi)
"Sc" = (
/obj/structure/shuttle/part/dropship2/transparent/left_outer_bottom_wing,
/turf/template_noop,
/area/shuttle/tulagi)
"SM" = (
/obj/structure/bed/chair/dropship/pilot{
	dir = 1
	},
/turf/open/shuttle/dropship{
	icon_state = "rasputin15"
	},
/area/shuttle/tulagi)
"Tp" = (
/obj/structure/machinery/computer/dropship_weapons/dropship2{
	name = "\improper 'Tulagi' weapons controls"
	},
/obj/structure/blocker/invisible_wall,
/turf/open/shuttle/dropship{
	icon_state = "rasputin15"
	},
/area/shuttle/tulagi)
"TP" = (
/obj/structure/machinery/light{
	dir = 4;
	pixel_x = 14
	},
/turf/open/shuttle/dropship{
	icon_state = "rasputin3"
	},
/area/shuttle/tulagi)
"TX" = (
/turf/open/shuttle/dropship{
	icon_state = "rasputin4"
	},
/area/shuttle/tulagi)
"Ub" = (
/obj/structure/shuttle/part/dropship2/transparent/upper_left_wing,
/turf/template_noop,
/area/shuttle/tulagi)
"Uv" = (
/obj/structure/machinery/camera/autoname/golden_arrow/midway{
	dir = 8;
	pixel_x = 23;
	network = list("Golden Arrow","Cyclone")
	},
/obj/structure/bed/chair/dropship/passenger{
	dir = 8
	},
/turf/open/shuttle/dropship{
	icon_state = "rasputin15"
	},
/area/shuttle/tulagi)
"UL" = (
/turf/closed/shuttle/tulagi{
	icon_state = "36"
	},
/area/shuttle/tulagi)
"UQ" = (
/obj/docking_port/mobile/marine_dropship/tulagi,
/turf/open/shuttle/dropship{
	icon_state = "rasputin14"
	},
/area/shuttle/tulagi)
"Vj" = (
/turf/closed/shuttle/tulagi/transparent{
	icon_state = "86"
	},
/area/shuttle/tulagi)
"VB" = (
/turf/closed/shuttle/tulagi{
	icon_state = "31"
	},
/area/shuttle/tulagi)
"WK" = (
/turf/closed/shuttle/tulagi{
	icon_state = "24"
	},
/area/shuttle/tulagi)
"YS" = (
/obj/effect/attach_point/weapon/midway/left_fore,
/obj/structure/shuttle/part/dropship2/transparent/outer_left_weapons,
/turf/template_noop,
/area/shuttle/tulagi)
"Zh" = (
/obj/structure/machinery/light{
	dir = 8;
	pixel_x = -14
	},
/obj/structure/bed/chair/dropship/passenger{
	dir = 4
	},
/turf/open/shuttle/dropship{
	icon_state = "rasputin15"
	},
/area/shuttle/tulagi)
"ZL" = (
/obj/structure/machinery/light{
	dir = 4;
	pixel_x = 14
	},
/obj/structure/bed/chair/dropship/passenger{
	dir = 8
	},
/turf/open/shuttle/dropship{
	icon_state = "rasputin15"
	},
/area/shuttle/tulagi)
"ZT" = (
/turf/closed/shuttle/tulagi{
	icon_state = "30"
	},
/area/shuttle/tulagi)
"ZU" = (
/turf/closed/shuttle/tulagi/transparent{
	icon_state = "29"
	},
/area/shuttle/tulagi)

(1,1,1) = {"
at
at
at
at
at
Ub
Bb
hb
at
at
at
Ho
dp
KX
RI
Az
at
Sc
"}
(2,1,1) = {"
at
at
at
YS
cS
lQ
RH
iG
bB
Bu
DJ
Pp
PV
ZU
CT
aV
at
AC
"}
(3,1,1) = {"
RU
fD
bz
Vj
qv
Nx
we
Zh
mh
wD
by
vq
UL
ZT
WK
IW
eE
kp
"}
(4,1,1) = {"
Qe
PR
wq
aX
LI
CG
RC
RC
TX
wD
aa
CG
RC
lA
zy
Ej
at
at
"}
(5,1,1) = {"
Qe
Rw
cO
SM
fa
bd
fs
mh
bd
UQ
sF
bd
bB
bB
bB
bB
at
at
"}
(6,1,1) = {"
Qe
zT
Tp
bB
cF
eq
RC
RC
rQ
wD
cK
eq
CD
RC
TP
bB
at
at
"}
(7,1,1) = {"
gz
oU
KU
Pl
RT
vP
Uv
ZL
mh
wD
kQ
vA
Rd
VB
Qw
QY
MJ
Pi
"}
(8,1,1) = {"
at
at
at
iY
sY
vK
gt
zK
bB
Bu
lB
Ho
GI
jQ
wm
Az
at
po
"}
(9,1,1) = {"
at
at
at
at
at
rC
Rn
xc
at
at
at
Pp
ki
sC
eh
aV
at
vj
"}
