//MAP CONVERTED BY dmm2tgm.py THIS HEADER COMMENT PREVENTS RECONVERSION, DO NOT REMOVE
"ag" = (
/turf/closed/shuttle/cyclone/transparent{
	icon_state = "86b"
	},
/area/shuttle/cyclone)
"aP" = (
/obj/structure/shuttle/part/cyclone/transparent{
	icon_state = "3"
	},
/turf/template_noop,
/area/shuttle/cyclone)
"bw" = (
/obj/structure/shuttle/part/cyclone/transparent{
	icon_state = "90"
	},
/obj/effect/attach_point/weapon/cyclone/right_fore,
/turf/template_noop,
/area/shuttle/cyclone)
"cj" = (
/obj/structure/shuttle/part/cyclone/transparent{
	icon_state = "95a"
	},
/turf/template_noop,
/area/shuttle/cyclone)
"cm" = (
/obj/structure/bed/chair/dropship/passenger{
	dir = 8
	},
/turf/open/shuttle/dropship{
	icon_state = "rasputin15"
	},
/area/shuttle/cyclone)
"cy" = (
/obj/structure/stairs/perspective,
/obj/structure/platform{
	dir = 8
	},
/turf/open/shuttle/dropship{
	icon_state = "rasputin3"
	},
/area/shuttle/cyclone)
"cR" = (
/turf/closed/shuttle/cyclone/transparent{
	icon_state = "39"
	},
/area/shuttle/cyclone)
"dN" = (
/turf/closed/shuttle/cyclone{
	icon_state = "42"
	},
/area/shuttle/cyclone)
"eu" = (
/obj/structure/bed/chair/dropship/passenger{
	dir = 4
	},
/obj/structure/machinery/light/double{
	dir = 8
	},
/turf/open/shuttle/dropship{
	icon_state = "rasputin15"
	},
/area/shuttle/cyclone)
"eT" = (
/obj/structure/shuttle/part/cyclone/transparent,
/turf/template_noop,
/area/shuttle/cyclone)
"fo" = (
/obj/structure/shuttle/part/cyclone/transparent{
	icon_state = "40"
	},
/turf/template_noop,
/area/shuttle/cyclone)
"fr" = (
/turf/closed/shuttle/cyclone{
	icon_state = "30"
	},
/area/shuttle/cyclone)
"fy" = (
/obj/structure/shuttle/part/cyclone/transparent{
	icon_state = "91"
	},
/obj/effect/attach_point/electronics/cyclone,
/turf/template_noop,
/area/shuttle/cyclone)
"fV" = (
/obj/effect/decal/warning_stripes{
	icon_state = "S";
	pixel_y = 2
	},
/obj/effect/decal/warning_stripes{
	icon_state = "N";
	pixel_y = -1
	},
/turf/open/shuttle/dropship{
	icon_state = "rasputin14"
	},
/area/shuttle/cyclone)
"gn" = (
/obj/docking_port/mobile/marine_dropship/cyclone,
/turf/open/shuttle/dropship{
	icon_state = "floor8"
	},
/area/shuttle/cyclone)
"ha" = (
/obj/effect/attach_point/fuel/cyclone,
/turf/closed/shuttle/cyclone/transparent{
	icon_state = "32"
	},
/area/shuttle/cyclone)
"hd" = (
/turf/closed/shuttle/cyclone/transparent{
	icon_state = "33"
	},
/area/shuttle/cyclone)
"hu" = (
/obj/structure/shuttle/part/cyclone/transparent{
	icon_state = "6"
	},
/turf/template_noop,
/area/shuttle/cyclone)
"hS" = (
/obj/structure/shuttle/part/cyclone/transparent{
	icon_state = "41"
	},
/turf/template_noop,
/area/shuttle/cyclone)
"hV" = (
/obj/structure/shuttle/part/cyclone/transparent{
	icon_state = "21"
	},
/turf/template_noop,
/area/shuttle/cyclone)
"ia" = (
/obj/structure/stairs/perspective{
	dir = 1;
	icon_state = "p_stair_full";
	pixel_y = 22
	},
/obj/structure/machinery/computer/dropship_weapons/cyclone/small{
	pixel_y = 8;
	pixel_x = 8
	},
/obj/structure/bed/chair/vehicle/dropship_cockpit/copilot{
	dir = 1;
	pixel_x = 8;
	layer = 5
	},
/turf/open/shuttle/dropship{
	icon_state = "rasputin15"
	},
/area/shuttle/cyclone)
"iO" = (
/obj/structure/shuttle/part/cyclone/transparent{
	icon_state = "8"
	},
/turf/template_noop,
/area/shuttle/cyclone)
"lc" = (
/obj/structure/machinery/light/double{
	dir = 4
	},
/turf/open/shuttle/dropship{
	icon_state = "rasputin3"
	},
/area/shuttle/cyclone)
"lV" = (
/turf/closed/shuttle/cyclone{
	icon_state = "18"
	},
/area/shuttle/cyclone)
"ml" = (
/obj/structure/bed/chair/dropship/passenger{
	dir = 8
	},
/obj/structure/machinery/cm_vending/sorted/medical/wall_med{
	pixel_y = 26;
	pixel_x = -10
	},
/turf/open/shuttle/dropship{
	icon_state = "rasputin15"
	},
/area/shuttle/cyclone)
"mI" = (
/turf/closed/shuttle/cyclone{
	icon_state = "67"
	},
/area/shuttle/cyclone)
"mO" = (
/obj/structure/shuttle/part/cyclone/transparent{
	icon_state = "71"
	},
/turf/template_noop,
/area/shuttle/cyclone)
"nj" = (
/turf/open/shuttle/dropship{
	icon_state = "rasputin6"
	},
/area/shuttle/cyclone)
"nH" = (
/obj/structure/stairs/perspective,
/turf/open/shuttle/dropship{
	icon_state = "rasputin15"
	},
/area/shuttle/cyclone)
"od" = (
/turf/closed/shuttle/cyclone/transparent{
	icon_state = "23"
	},
/area/shuttle/cyclone)
"oX" = (
/obj/structure/bed/chair/dropship/passenger{
	dir = 8
	},
/obj/structure/machinery/camera/autoname/golden_arrow/cyclone{
	dir = 8;
	pixel_x = 23
	},
/turf/open/shuttle/dropship{
	icon_state = "rasputin15"
	},
/area/shuttle/cyclone)
"pb" = (
/turf/closed/shuttle/cyclone{
	icon_state = "62"
	},
/area/shuttle/cyclone)
"pj" = (
/obj/structure/shuttle/part/cyclone/transparent{
	icon_state = "9"
	},
/obj/structure/shuttle/part/cyclone/transparent{
	icon_state = "41"
	},
/turf/template_noop,
/area/shuttle/cyclone)
"pz" = (
/obj/structure/shuttle/part/cyclone/transparent{
	icon_state = "66"
	},
/turf/template_noop,
/area/shuttle/cyclone)
"qj" = (
/obj/structure/machinery/light/double{
	dir = 8
	},
/turf/open/shuttle/dropship{
	icon_state = "rasputin3"
	},
/area/shuttle/cyclone)
"qs" = (
/turf/closed/shuttle/cyclone{
	icon_state = "47"
	},
/area/shuttle/cyclone)
"qN" = (
/turf/closed/shuttle/cyclone{
	icon_state = "25"
	},
/area/shuttle/cyclone)
"qX" = (
/turf/closed/shuttle/cyclone{
	icon_state = "48"
	},
/area/shuttle/cyclone)
"ro" = (
/obj/structure/shuttle/part/cyclone/transparent{
	icon_state = "99a"
	},
/turf/template_noop,
/area/shuttle/cyclone)
"rB" = (
/turf/closed/shuttle/cyclone/transparent{
	icon_state = "29"
	},
/area/shuttle/cyclone)
"sa" = (
/turf/closed/shuttle/cyclone{
	icon_state = "73"
	},
/area/shuttle/cyclone)
"sA" = (
/turf/closed/shuttle/cyclone{
	icon_state = "37"
	},
/area/shuttle/cyclone)
"sR" = (
/obj/structure/bed/chair/dropship/passenger{
	dir = 4
	},
/turf/open/shuttle/dropship{
	icon_state = "rasputin15"
	},
/area/shuttle/cyclone)
"tU" = (
/turf/closed/shuttle/cyclone{
	icon_state = "24"
	},
/area/shuttle/cyclone)
"uH" = (
/turf/closed/shuttle/cyclone{
	icon_state = "72"
	},
/area/shuttle/cyclone)
"vt" = (
/turf/closed/shuttle/cyclone/transparent{
	icon_state = "86a"
	},
/area/shuttle/cyclone)
"vH" = (
/turf/closed/shuttle/cyclone/transparent{
	icon_state = "34"
	},
/area/shuttle/cyclone)
"vT" = (
/obj/structure/shuttle/part/cyclone/transparent{
	icon_state = "5"
	},
/turf/template_noop,
/area/shuttle/cyclone)
"wk" = (
/turf/template_noop,
/area/space)
"wA" = (
/turf/closed/shuttle/cyclone/transparent{
	icon_state = "35"
	},
/area/shuttle/cyclone)
"xY" = (
/obj/structure/shuttle/part/cyclone/transparent{
	icon_state = "85"
	},
/obj/effect/attach_point/weapon/cyclone/left_fore,
/turf/template_noop,
/area/shuttle/cyclone)
"yA" = (
/obj/structure/shuttle/part/cyclone/gunpod_prop,
/turf/template_noop,
/area/shuttle/cyclone)
"yP" = (
/obj/structure/stairs/perspective,
/obj/structure/platform{
	dir = 4
	},
/turf/open/shuttle/dropship{
	icon_state = "rasputin3"
	},
/area/shuttle/cyclone)
"zz" = (
/turf/closed/shuttle/cyclone/transparent{
	icon_state = "80"
	},
/area/shuttle/cyclone)
"zG" = (
/turf/closed/shuttle/cyclone{
	icon_state = "31"
	},
/area/shuttle/cyclone)
"zH" = (
/turf/closed/shuttle/cyclone/transparent{
	icon_state = "38"
	},
/area/shuttle/cyclone)
"zL" = (
/obj/structure/shuttle/part/cyclone/transparent/nosecone{
	icon_state = "102"
	},
/turf/template_noop,
/area/shuttle/cyclone)
"Ak" = (
/obj/effect/decal/warning_stripes{
	icon_state = "N";
	pixel_y = -1
	},
/obj/effect/decal/warning_stripes{
	icon_state = "S";
	pixel_y = 2
	},
/obj/structure/machinery/door/airlock/multi_tile/almayer/dropshiprear/ds2{
	id = "aft_door";
	name = "\improper Cyclone cargo door"
	},
/turf/open/shuttle/dropship{
	icon_state = "rasputin14"
	},
/area/shuttle/cyclone)
"Ax" = (
/obj/structure/shuttle/part/dropship2/lower_right_wall{
	name = "\improper Cyclone"
	},
/obj/structure/shuttle/part/cyclone/transparent{
	icon_state = "40"
	},
/turf/template_noop,
/area/shuttle/cyclone)
"AP" = (
/turf/closed/shuttle/cyclone{
	icon_state = "83"
	},
/area/shuttle/cyclone)
"Bt" = (
/turf/closed/shuttle/cyclone/transparent{
	icon_state = "89a"
	},
/area/shuttle/cyclone)
"BU" = (
/obj/structure/bed/chair/dropship/passenger{
	dir = 4
	},
/obj/structure/machinery/cm_vending/sorted/medical/wall_med{
	pixel_y = 26;
	pixel_x = 10
	},
/obj/structure/extinguisher_cabinet/lifeboat{
	pixel_y = 27;
	pixel_x = -2
	},
/turf/open/shuttle/dropship{
	icon_state = "rasputin15"
	},
/area/shuttle/cyclone)
"Cb" = (
/obj/structure/shuttle/part/cyclone/transparent{
	icon_state = "74"
	},
/turf/template_noop,
/area/shuttle/cyclone)
"Cf" = (
/obj/structure/shuttle/part/cyclone/transparent{
	icon_state = "7"
	},
/turf/template_noop,
/area/shuttle/cyclone)
"Da" = (
/obj/structure/shuttle/part/cyclone/transparent{
	icon_state = "20"
	},
/turf/template_noop,
/area/shuttle/cyclone)
"Df" = (
/obj/structure/shuttle/part/cyclone/transparent{
	icon_state = "4"
	},
/turf/template_noop,
/area/shuttle/cyclone)
"Dl" = (
/obj/structure/machinery/camera/autoname/golden_arrow/cyclone{
	dir = 4;
	pixel_x = -23
	},
/turf/open/shuttle/dropship{
	icon_state = "rasputin3"
	},
/area/shuttle/cyclone)
"EP" = (
/turf/closed/shuttle/cyclone{
	icon_state = "75"
	},
/area/shuttle/cyclone)
"Fz" = (
/obj/effect/attach_point/fuel/cyclone,
/turf/closed/shuttle/cyclone/transparent{
	icon_state = "28"
	},
/area/shuttle/cyclone)
"FD" = (
/obj/structure/bed/chair/dropship/passenger{
	dir = 8
	},
/obj/structure/machinery/light/double{
	dir = 4
	},
/turf/open/shuttle/dropship{
	icon_state = "rasputin15"
	},
/area/shuttle/cyclone)
"FV" = (
/turf/open/shuttle/dropship{
	icon_state = "floor8"
	},
/area/shuttle/cyclone)
"GE" = (
/turf/closed/shuttle/cyclone{
	icon_state = "43"
	},
/area/shuttle/cyclone)
"GJ" = (
/turf/closed/shuttle/cyclone/transparent{
	icon_state = "27"
	},
/area/shuttle/cyclone)
"Hg" = (
/turf/closed/shuttle/cyclone{
	icon_state = "69"
	},
/area/shuttle/cyclone)
"Iz" = (
/obj/structure/machinery/door/airlock/hatch/cockpit/two,
/obj/structure/blocker/forcefield/multitile_vehicles,
/turf/open/shuttle/dropship{
	icon_state = "rasputin15"
	},
/area/shuttle/cyclone)
"IP" = (
/obj/structure/shuttle/part/cyclone/transparent{
	icon_state = "61"
	},
/obj/effect/attach_point/weapon/cyclone/left_wing,
/turf/template_noop,
/area/shuttle/cyclone)
"IZ" = (
/obj/structure/shuttle/part/cyclone/transparent{
	icon_state = "70"
	},
/turf/template_noop,
/area/shuttle/cyclone)
"Kv" = (
/turf/closed/shuttle/cyclone{
	icon_state = "81"
	},
/area/shuttle/cyclone)
"KQ" = (
/obj/structure/bed/chair/dropship/passenger/folded{
	pixel_y = 8;
	buckling_y = 8
	},
/turf/open/shuttle/dropship{
	icon_state = "rasputin15"
	},
/area/shuttle/cyclone)
"KU" = (
/turf/open/shuttle/dropship{
	icon_state = "rasputin8"
	},
/area/shuttle/cyclone)
"MU" = (
/obj/structure/shuttle/part/cyclone/transparent{
	icon_state = "84"
	},
/obj/effect/attach_point/electronics/cyclone,
/turf/template_noop,
/area/shuttle/cyclone)
"Ob" = (
/turf/open/shuttle/dropship{
	icon_state = "rasputin7"
	},
/area/shuttle/cyclone)
"Pg" = (
/obj/structure/machinery/computer/shuttle/dropship/flight/small{
	pixel_y = 16;
	pixel_x = 6
	},
/obj/structure/phone_base{
	dir = 4;
	pixel_x = -19;
	pixel_y = 12;
	layer = 3.1;
	phone_category = "Dropship";
	name = "Cyclone telephone receiver";
	phone_id = "Cyclone"
	},
/obj/structure/bed/chair/vehicle/dropship_cockpit/pilot{
	dir = 1;
	pixel_x = 6;
	pixel_y = 8
	},
/turf/open/shuttle/dropship{
	icon_state = "rasputin15"
	},
/area/shuttle/cyclone)
"QN" = (
/obj/structure/shuttle/part/cyclone/transparent{
	icon_state = "65"
	},
/obj/effect/attach_point/weapon/cyclone/right_wing,
/turf/template_noop,
/area/shuttle/cyclone)
"RR" = (
/obj/structure/shuttle/part/cyclone/transparent/nosecone{
	icon_state = "100"
	},
/turf/template_noop,
/area/shuttle/cyclone)
"Sk" = (
/turf/open/shuttle/dropship{
	icon_state = "rasputin3"
	},
/area/shuttle/cyclone)
"Sl" = (
/turf/closed/shuttle/cyclone{
	icon_state = "77"
	},
/area/shuttle/cyclone)
"Ty" = (
/turf/open/shuttle/dropship{
	icon_state = "rasputin15"
	},
/area/shuttle/cyclone)
"Uo" = (
/turf/closed/shuttle/cyclone{
	icon_state = "64"
	},
/area/shuttle/cyclone)
"Vu" = (
/turf/open/shuttle/dropship{
	icon_state = "rasputin4"
	},
/area/shuttle/cyclone)
"Wr" = (
/turf/closed/shuttle/cyclone/transparent{
	icon_state = "26"
	},
/area/shuttle/cyclone)
"Ws" = (
/turf/closed/shuttle/cyclone{
	icon_state = "19"
	},
/area/shuttle/cyclone)
"Wv" = (
/turf/closed/shuttle/cyclone/transparent{
	icon_state = "22"
	},
/area/shuttle/cyclone)
"XU" = (
/turf/closed/shuttle/cyclone/transparent{
	icon_state = "97a"
	},
/area/shuttle/cyclone)
"XY" = (
/turf/closed/shuttle/cyclone/transparent{
	icon_state = "89b"
	},
/area/shuttle/cyclone)
"YL" = (
/turf/closed/shuttle/cyclone{
	icon_state = "36"
	},
/area/shuttle/cyclone)
"ZG" = (
/obj/structure/shuttle/part/cyclone/transparent{
	icon_state = "2"
	},
/turf/template_noop,
/area/shuttle/cyclone)
"ZU" = (
/turf/closed/shuttle/cyclone/transparent{
	icon_state = "78"
	},
/area/shuttle/cyclone)

(1,1,1) = {"
wk
wk
wk
wk
wk
mO
pz
IP
wk
fo
vH
Fz
Wv
Da
wk
eT
"}
(2,1,1) = {"
wk
wk
wk
MU
EP
uH
mI
pb
dN
pj
wA
rB
od
hV
wk
ZG
"}
(3,1,1) = {"
wk
wk
wk
xY
Sl
BU
sR
eu
sR
qs
YL
fr
tU
lV
Cf
aP
"}
(4,1,1) = {"
RR
cj
ag
vt
ZU
nj
Sk
Sk
Vu
cy
Sk
Dl
qj
Ak
wk
wk
"}
(5,1,1) = {"
yA
XU
Pg
ia
Iz
FV
KQ
KQ
gn
nH
Ty
Ty
Ty
fV
wk
wk
"}
(6,1,1) = {"
zL
ro
XY
Bt
zz
Ob
Sk
Sk
KU
yP
Sk
Sk
lc
fV
wk
wk
"}
(7,1,1) = {"
wk
wk
wk
bw
Kv
ml
oX
FD
cm
qX
sA
zG
qN
Ws
iO
Df
"}
(8,1,1) = {"
wk
wk
wk
fy
AP
sa
Hg
Uo
GE
Ax
zH
ha
Wr
Da
wk
vT
"}
(9,1,1) = {"
wk
wk
wk
wk
wk
Cb
IZ
QN
wk
hS
cR
hd
GJ
hV
wk
hu
"}
