//MAP CONVERTED BY dmm2tgm.py THIS HEADER COMMENT PREVENTS RECONVERSION, DO NOT REMOVE
"bm" = (
/turf/closed/shuttle/midway/transparent{
	icon_state = "97"
	},
/area/space)
"bv" = (
/obj/structure/shuttle/part/dropship1/transparent/outer_left_weapons{
	name = "\improper Midway"
	},
/obj/effect/attach_point/weapon/midway/left_fore,
/turf/template_noop,
/area/space)
"bw" = (
/obj/effect/attach_point/crew_weapon/midway,
/obj/structure/machinery/light{
	dir = 4;
	pixel_x = 14
	},
/turf/open/shuttle/dropship{
	icon_state = "rasputin15"
	},
/area/space)
"bM" = (
/turf/closed/shuttle/midway{
	icon_state = "69"
	},
/area/space)
"bO" = (
/turf/closed/shuttle/midway{
	icon_state = "30"
	},
/area/space)
"dw" = (
/obj/structure/machinery/light{
	dir = 4;
	pixel_x = 14
	},
/turf/open/shuttle/dropship{
	icon_state = "rasputin3"
	},
/area/space)
"eX" = (
/obj/structure/shuttle/part/dropship2/transparent/engine_right_cap{
	name = "\improper Midway"
	},
/turf/template_noop,
/area/space)
"fQ" = (
/obj/structure/shuttle/part/dropship1/transparent/middle_left_wing{
	name = "\improper Midway"
	},
/turf/template_noop,
/area/space)
"gg" = (
/obj/effect/attach_point/fuel/midway{
	pixel_x = -32
	},
/turf/closed/shuttle/midway/transparent{
	icon_state = "33"
	},
/area/space)
"gk" = (
/obj/structure/platform_decoration{
	dir = 4
	},
/obj/effect/decal/warning_stripes{
	icon_state = "N";
	pixel_y = 1
	},
/turf/open/shuttle/dropship{
	icon_state = "rasputin7"
	},
/area/space)
"gX" = (
/obj/structure/shuttle/part/dropship2/transparent/engine_left_cap{
	name = "\improper Midway"
	},
/turf/template_noop,
/area/space)
"hn" = (
/turf/open/shuttle/dropship{
	icon_state = "rasputin3"
	},
/area/space)
"hT" = (
/obj/structure/shuttle/part/dropship1/transparent/left_outer_bottom_wing{
	name = "\improper Midway"
	},
/turf/template_noop,
/area/space)
"im" = (
/obj/structure/shuttle/part/dropship1/right_inner_wing_connector{
	name = "\improper Midway"
	},
/turf/open/space/basic,
/area/space)
"jt" = (
/obj/structure/machinery/door/airlock/hatch/cockpit,
/obj/structure/blocker/forcefield/multitile_vehicles,
/turf/open/shuttle/dropship{
	icon_state = "rasputin15"
	},
/area/space)
"jy" = (
/turf/closed/shuttle/midway{
	icon_state = "75"
	},
/area/space)
"jA" = (
/turf/closed/shuttle/midway/transparent{
	icon_state = "27"
	},
/area/space)
"jP" = (
/turf/open/shuttle/dropship{
	icon_state = "rasputin15"
	},
/area/space)
"kB" = (
/turf/closed/shuttle/midway{
	icon_state = "64"
	},
/area/space)
"kH" = (
/obj/structure/shuttle/part/dropship1/transparent/nose_top_right{
	name = "\improper Midway"
	},
/turf/template_noop,
/area/space)
"kI" = (
/obj/structure/bed/chair/vehicle{
	pixel_x = -8
	},
/obj/structure/bed/chair/vehicle{
	pixel_x = 8
	},
/turf/open/shuttle/dropship{
	icon_state = "rasputin15"
	},
/area/space)
"kL" = (
/obj/structure/bed/chair/vehicle{
	dir = 1;
	pixel_x = -8
	},
/obj/structure/bed/chair/vehicle{
	dir = 1;
	pixel_x = 8
	},
/turf/open/shuttle/dropship{
	icon_state = "rasputin15"
	},
/area/space)
"kN" = (
/turf/closed/shuttle/midway/transparent{
	icon_state = "34"
	},
/area/space)
"la" = (
/obj/structure/platform{
	dir = 1
	},
/obj/effect/decal/warning_stripes{
	icon_state = "N";
	pixel_y = 1
	},
/turf/open/shuttle/dropship{
	icon_state = "floor8"
	},
/area/space)
"lo" = (
/obj/structure/machinery/door/airlock/multi_tile/almayer/dropshiprear/dropshipside/ds1/midway{
	dir = 1;
	id = "starboard_door"
	},
/turf/open/shuttle/dropship{
	icon_state = "rasputin15"
	},
/area/space)
"lJ" = (
/obj/structure/prop/ice_colony/hula_girl{
	pixel_x = -10;
	pixel_y = 16
	},
/obj/structure/blocker/invisible_wall,
/obj/structure/machinery/computer/cameras/dropship/midway,
/turf/open/shuttle/dropship{
	icon_state = "rasputin15"
	},
/area/space)
"lK" = (
/turf/closed/shuttle/midway{
	icon_state = "72"
	},
/area/space)
"lX" = (
/turf/closed/shuttle/midway/transparent{
	icon_state = "22"
	},
/area/space)
"mq" = (
/turf/closed/shuttle/midway{
	icon_state = "24"
	},
/area/space)
"po" = (
/turf/closed/shuttle/midway/transparent{
	icon_state = "26"
	},
/area/space)
"pp" = (
/turf/closed/shuttle/ert{
	icon_state = "wy8"
	},
/area/space)
"qm" = (
/obj/effect/attach_point/crew_weapon/midway,
/obj/structure/machinery/light{
	dir = 8;
	pixel_x = -14
	},
/turf/open/shuttle/dropship{
	icon_state = "rasputin15"
	},
/area/space)
"rd" = (
/turf/closed/shuttle/midway/transparent{
	icon_state = "32"
	},
/area/space)
"rU" = (
/turf/open/shuttle/dropship,
/area/space)
"sh" = (
/obj/structure/shuttle/part/dropship1/lower_left_wall{
	name = "\improper Midway"
	},
/turf/template_noop,
/area/space)
"ts" = (
/obj/structure/shuttle/part/dropship1/transparent/upper_left_wing{
	name = "\improper Midway"
	},
/turf/template_noop,
/area/space)
"tv" = (
/obj/structure/machinery/door/airlock/multi_tile/almayer/dropshiprear/dropshipside/ds1/midway{
	dir = 1;
	id = "port_door"
	},
/turf/open/shuttle/dropship{
	icon_state = "rasputin15"
	},
/area/space)
"tC" = (
/obj/structure/shuttle/part/dropship1/transparent/engine_right_exhaust{
	name = "\improper Midway"
	},
/turf/template_noop,
/area/space)
"tQ" = (
/obj/structure/platform_decoration{
	dir = 8
	},
/obj/effect/decal/warning_stripes{
	icon_state = "N";
	pixel_y = 1
	},
/turf/open/shuttle/dropship{
	icon_state = "rasputin6"
	},
/area/space)
"tR" = (
/turf/closed/shuttle/midway{
	icon_state = "104"
	},
/area/space)
"uo" = (
/obj/structure/shuttle/part/dropship1/transparent/engine_left_exhaust{
	name = "\improper Midway"
	},
/turf/template_noop,
/area/space)
"uT" = (
/obj/structure/machinery/cm_vending/sorted/medical/wall_med{
	pixel_x = -30
	},
/turf/open/shuttle/dropship{
	icon_state = "rasputin15"
	},
/area/space)
"vU" = (
/turf/closed/shuttle/midway/transparent{
	icon_state = "98"
	},
/area/space)
"vY" = (
/turf/closed/shuttle/ert{
	icon_state = "wy9"
	},
/area/space)
"wN" = (
/obj/structure/shuttle/part/dropship1/left_inner_wing_connector{
	name = "\improper Midway"
	},
/turf/open/space/basic,
/area/space)
"wR" = (
/obj/structure/shuttle/part/dropship1/transparent/lower_right_wing{
	name = "\improper Midway"
	},
/obj/effect/attach_point/weapon/midway/right_wing,
/turf/template_noop,
/area/space)
"xb" = (
/obj/effect/attach_point/crew_weapon/midway,
/turf/open/shuttle/dropship{
	icon_state = "rasputin15"
	},
/area/space)
"xw" = (
/turf/closed/shuttle/midway{
	icon_state = "83"
	},
/area/space)
"xz" = (
/turf/closed/shuttle/ert{
	icon_state = "wy20"
	},
/area/space)
"zh" = (
/obj/structure/shuttle/part/dropship1/transparent/left_inner_bottom_wing{
	name = "\improper Midway"
	},
/turf/template_noop,
/area/space)
"zk" = (
/turf/closed/shuttle/ert{
	icon_state = "wy5"
	},
/area/space)
"zu" = (
/obj/structure/blocker/invisible_wall,
/obj/structure/machinery/computer/shuttle/dropship/flight,
/turf/open/shuttle/dropship{
	icon_state = "rasputin15"
	},
/area/space)
"zF" = (
/turf/closed/shuttle/midway{
	icon_state = "25"
	},
/area/space)
"zI" = (
/turf/closed/shuttle/ert{
	icon_state = "wy21"
	},
/area/space)
"zK" = (
/turf/closed/shuttle/ert{
	icon_state = "wy3"
	},
/area/space)
"At" = (
/obj/structure/shuttle/part/dropship1/transparent/upper_right_wing{
	name = "\improper Midway"
	},
/turf/template_noop,
/area/space)
"AP" = (
/obj/structure/shuttle/part/dropship1/transparent/nose_center{
	name = "\improper Midway"
	},
/turf/template_noop,
/area/space)
"AU" = (
/turf/closed/shuttle/midway{
	icon_state = "31"
	},
/area/space)
"Bl" = (
/turf/closed/shuttle/ert{
	icon_state = "wy27"
	},
/area/space)
"Bq" = (
/obj/structure/shuttle/part/dropship1/transparent/lower_left_wing{
	name = "\improper Midway"
	},
/obj/effect/attach_point/weapon/midway/left_wing,
/turf/template_noop,
/area/space)
"Bv" = (
/turf/closed/shuttle/midway/transparent{
	icon_state = "23"
	},
/area/space)
"BN" = (
/turf/closed/shuttle/midway/transparent{
	icon_state = "96"
	},
/area/space)
"CC" = (
/turf/closed/shuttle/midway/transparent{
	icon_state = "29"
	},
/area/space)
"Dh" = (
/obj/structure/shuttle/part/dropship1/transparent/outer_right_weapons{
	name = "\improper Midway"
	},
/obj/effect/attach_point/weapon/midway/right_fore,
/turf/template_noop,
/area/space)
"EB" = (
/turf/closed/shuttle/midway{
	icon_state = "92"
	},
/area/space)
"Fp" = (
/obj/structure/machinery/light{
	dir = 8;
	pixel_x = -14
	},
/turf/open/shuttle/dropship{
	icon_state = "rasputin2"
	},
/area/space)
"FF" = (
/obj/structure/shuttle/part/dropship1/transparent/middle_right_wing{
	name = "\improper Midway"
	},
/turf/template_noop,
/area/space)
"GL" = (
/obj/structure/phone_base/rotary{
	name = "Midway Telephone";
	phone_category = "Dropship";
	phone_id = "Midway";
	pixel_x = 11;
	pixel_y = 16
	},
/obj/structure/blocker/invisible_wall,
/obj/structure/machinery/computer/dropship_weapons/midway,
/turf/open/shuttle/dropship{
	icon_state = "rasputin15"
	},
/area/space)
"HW" = (
/turf/closed/shuttle/midway{
	icon_state = "67"
	},
/area/space)
"IU" = (
/obj/structure/shuttle/part/dropship1/left_outer_wing_connector{
	name = "\improper Midway"
	},
/turf/open/space/basic,
/area/space)
"Ji" = (
/turf/closed/shuttle/midway{
	icon_state = "73"
	},
/area/space)
"JF" = (
/obj/structure/shuttle/part/dropship1/right_outer_wing_connector{
	name = "\improper Midway"
	},
/turf/open/space/basic,
/area/space)
"Ki" = (
/obj/structure/extinguisher_cabinet/lifeboat{
	pixel_x = 12
	},
/turf/closed/shuttle/ert{
	icon_state = "wy27"
	},
/area/space)
"KE" = (
/turf/closed/shuttle/midway/transparent{
	icon_state = "39"
	},
/area/space)
"Lv" = (
/obj/structure/machinery/camera/autoname/golden_arrow/midway{
	pixel_x = -6;
	pixel_y = -16
	},
/obj/structure/machinery/light{
	dir = 4;
	pixel_x = 14
	},
/turf/open/shuttle/dropship{
	icon_state = "rasputin2"
	},
/area/space)
"MV" = (
/turf/open/shuttle/dropship{
	icon_state = "rasputin6"
	},
/area/space)
"Ng" = (
/obj/structure/shuttle/part/dropship1/transparent/right_inner_bottom_wing{
	name = "\improper Midway"
	},
/turf/template_noop,
/area/space)
"Nx" = (
/obj/structure/stairs/perspective,
/obj/structure/platform{
	dir = 4;
	layer = 2.7
	},
/turf/open/shuttle/dropship{
	icon_state = "rasputin3"
	},
/area/space)
"Op" = (
/obj/structure/bed/chair/dropship/pilot{
	dir = 1
	},
/turf/open/shuttle/dropship{
	icon_state = "rasputin15"
	},
/area/space)
"OO" = (
/turf/closed/shuttle/midway/transparent{
	icon_state = "86"
	},
/area/space)
"OQ" = (
/obj/structure/shuttle/part/dropship1/transparent/nose_top_left{
	name = "\improper Midway"
	},
/turf/template_noop,
/area/space)
"OW" = (
/obj/docking_port/mobile/marine_dropship/midway,
/turf/open/shuttle/dropship{
	icon_state = "rasputin15"
	},
/area/space)
"Pu" = (
/obj/structure/stairs/perspective,
/obj/structure/platform{
	dir = 8;
	layer = 2.7
	},
/turf/open/shuttle/dropship{
	icon_state = "rasputin3"
	},
/area/space)
"Qz" = (
/obj/structure/machinery/camera/autoname/golden_arrow/midway{
	dir = 8;
	pixel_x = 23
	},
/turf/open/shuttle/dropship{
	icon_state = "rasputin15"
	},
/area/space)
"QX" = (
/turf/closed/shuttle/ert{
	icon_state = "wy4"
	},
/area/space)
"Rv" = (
/turf/closed/shuttle/midway/transparent{
	icon_state = "38"
	},
/area/space)
"Sw" = (
/turf/closed/shuttle/midway/transparent{
	icon_state = "35"
	},
/area/space)
"SE" = (
/obj/structure/machinery/light{
	dir = 8;
	pixel_x = -14
	},
/turf/open/shuttle/dropship{
	icon_state = "rasputin3"
	},
/area/space)
"SG" = (
/obj/structure/bed/chair/vehicle{
	pixel_x = -8
	},
/obj/structure/bed/chair/vehicle{
	pixel_x = 8
	},
/turf/open/shuttle/dropship{
	icon_state = "rasputin14"
	},
/area/space)
"SQ" = (
/obj/structure/machinery/cm_vending/sorted/medical/wall_med{
	pixel_x = 30
	},
/turf/open/shuttle/dropship{
	icon_state = "rasputin3"
	},
/area/space)
"TN" = (
/turf/template_noop,
/area/space)
"TT" = (
/turf/open/shuttle/dropship{
	icon_state = "rasputin7"
	},
/area/space)
"Ud" = (
/obj/structure/machinery/door_control{
	id = "dropship_midway";
	name = "Dropship Lockdown";
	normaldoorcontrol = 3;
	pixel_y = -19;
	req_one_access_txt = "3;22"
	},
/turf/open/shuttle/dropship{
	icon_state = "rasputin15"
	},
/area/space)
"UJ" = (
/turf/closed/shuttle/midway/transparent{
	icon_state = "89"
	},
/area/space)
"UT" = (
/obj/structure/machinery/camera/autoname/golden_arrow/midway{
	dir = 4;
	pixel_x = -23
	},
/turf/open/shuttle/dropship{
	icon_state = "rasputin3"
	},
/area/space)
"UU" = (
/turf/closed/shuttle/midway{
	icon_state = "62"
	},
/area/space)
"Vk" = (
/turf/closed/shuttle/ert{
	icon_state = "wy25"
	},
/area/space)
"Vw" = (
/obj/effect/attach_point/fuel/midway,
/turf/closed/shuttle/midway/transparent{
	icon_state = "28"
	},
/area/space)
"Wb" = (
/obj/structure/shuttle/part/dropship1/transparent/right_outer_bottom_wing{
	name = "\improper Midway"
	},
/turf/template_noop,
/area/space)
"WN" = (
/turf/closed/shuttle/midway{
	icon_state = "103"
	},
/area/space)
"Yl" = (
/turf/closed/shuttle/midway{
	icon_state = "94"
	},
/area/space)
"YP" = (
/obj/structure/machinery/door/airlock/multi_tile/almayer/dropshiprear/ds1{
	id = "aft_door";
	name = "\improper Midway cargo door"
	},
/turf/open/shuttle/dropship{
	icon_state = "rasputin15"
	},
/area/space)
"Zl" = (
/obj/structure/shuttle/part/dropship1/transparent/nose_center{
	name = "\improper Midway";
	icon_state = "105"
	},
/obj/effect/attach_point/electronics/midway,
/turf/template_noop,
/area/space)

(1,1,1) = {"
TN
TN
TN
TN
TN
ts
fQ
Bq
TN
TN
TN
gX
kN
Vw
lX
uo
TN
zh
"}
(2,1,1) = {"
TN
TN
TN
bv
jy
lK
HW
UU
jP
tv
sh
eX
Sw
CC
Bv
tC
TN
hT
"}
(3,1,1) = {"
OQ
xz
EB
OO
zI
kI
uT
qm
jP
Ud
pp
QX
QX
bO
mq
WN
wN
IU
"}
(4,1,1) = {"
Zl
BN
lJ
Fp
Ki
SG
MV
hn
hn
hn
Nx
tQ
hn
UT
SE
YP
TN
TN
"}
(5,1,1) = {"
AP
bm
zu
Op
jt
hn
rU
kL
jP
OW
xb
la
jP
jP
jP
jP
TN
TN
"}
(6,1,1) = {"
Zl
vU
GL
Lv
Bl
SG
TT
hn
hn
hn
Pu
gk
SQ
hn
dw
jP
TN
TN
"}
(7,1,1) = {"
kH
Vk
Yl
UJ
zI
kI
Qz
bw
jP
Ud
vY
zk
zk
AU
zF
tR
im
JF
"}
(8,1,1) = {"
TN
TN
TN
Dh
xw
Ji
bM
kB
jP
lo
zK
gX
Rv
rd
po
uo
TN
Ng
"}
(9,1,1) = {"
TN
TN
TN
TN
TN
At
FF
wR
TN
TN
TN
eX
KE
gg
jA
tC
TN
Wb
"}
