//MAP CONVERTED BY dmm2tgm.py THIS HEADER COMMENT PREVENTS RECONVERSION, DO NOT REMOVE
"aq" = (
/turf/closed/shuttle/tripoli{
	icon_state = "34"
	},
/area/shuttle/tripoli)
"au" = (
/turf/closed/shuttle/tripoli{
	icon_state = "27"
	},
/area/shuttle/tripoli)
"bd" = (
/obj/structure/shuttle/part/tripoli,
/turf/template_noop,
/area/shuttle/tripoli)
"bl" = (
/obj/structure/shuttle/part/tripoli{
	icon_state = "2"
	},
/turf/template_noop,
/area/shuttle/tripoli)
"bJ" = (
/turf/closed/shuttle/tripoli{
	icon_state = "24"
	},
/area/shuttle/tripoli)
"cC" = (
/turf/closed/shuttle/tripoli{
	icon_state = "25"
	},
/area/shuttle/tripoli)
"dJ" = (
/turf/closed/shuttle/tripoli/transparent{
	icon_state = "80"
	},
/area/shuttle/tripoli)
"dU" = (
/obj/structure/shuttle/part/tripoli{
	icon_state = "70"
	},
/turf/template_noop,
/area/shuttle/tripoli)
"eb" = (
/obj/structure/shuttle/part/tripoli{
	icon_state = "17"
	},
/turf/template_noop,
/area/shuttle/tripoli)
"ed" = (
/turf/template_noop,
/area/space)
"en" = (
/obj/structure/shuttle/part/tripoli{
	icon_state = "6"
	},
/turf/template_noop,
/area/shuttle/tripoli)
"eq" = (
/turf/closed/shuttle/tripoli{
	icon_state = "69"
	},
/area/shuttle/tripoli)
"fD" = (
/turf/closed/shuttle/tripoli{
	icon_state = "83"
	},
/area/shuttle/tripoli)
"fO" = (
/turf/closed/shuttle/tripoli{
	icon_state = "35"
	},
/area/shuttle/tripoli)
"hb" = (
/turf/closed/shuttle/tripoli{
	icon_state = "72"
	},
/area/shuttle/tripoli)
"hm" = (
/obj/structure/platform_decoration{
	dir = 8
	},
/obj/effect/decal/warning_stripes{
	icon_state = "N";
	pixel_y = 1
	},
/obj/structure/platform_decoration{
	dir = 4
	},
/turf/open/shuttle/dropship/light_grey_single_wide_up_to_down,
/area/shuttle/tripoli)
"hU" = (
/obj/structure/bed/chair/dropship/passenger{
	dir = 8
	},
/turf/open/shuttle/dropship/medium_grey_single_wide_up_to_down,
/area/shuttle/tripoli)
"iZ" = (
/obj/structure/stairs/perspective,
/obj/structure/platform{
	dir = 4;
	layer = 2.7
	},
/obj/structure/platform{
	dir = 8
	},
/turf/open/shuttle/dropship/light_grey_single_wide_up_to_down,
/area/shuttle/tripoli)
"jA" = (
/obj/structure/shuttle/part/tripoli{
	icon_state = "7"
	},
/turf/template_noop,
/area/shuttle/tripoli)
"jM" = (
/obj/effect/attach_point/fuel/tripoli{
	dir = 1
	},
/turf/closed/shuttle/tripoli{
	icon_state = "32"
	},
/area/shuttle/tripoli)
"kg" = (
/turf/closed/shuttle/tripoli{
	icon_state = "31"
	},
/area/shuttle/tripoli)
"kt" = (
/turf/closed/shuttle/tripoli/transparent{
	icon_state = "86b"
	},
/area/shuttle/tripoli)
"kI" = (
/turf/closed/shuttle/tripoli{
	icon_state = "104"
	},
/area/shuttle/tripoli)
"li" = (
/turf/closed/shuttle/tripoli/transparent{
	icon_state = "89a"
	},
/area/shuttle/tripoli)
"lJ" = (
/obj/structure/shuttle/part/tripoli/transparent/nosecone{
	icon_state = "100"
	},
/turf/template_noop,
/area/shuttle/tripoli)
"mz" = (
/obj/structure/shuttle/part/tripoli{
	icon_state = "46"
	},
/obj/structure/shuttle/part/dropship2/transparent/engine_right_cap{
	name = "\improper Tripoli"
	},
/turf/template_noop,
/area/shuttle/tripoli)
"mY" = (
/obj/structure/shuttle/part/tripoli{
	icon_state = "21"
	},
/turf/template_noop,
/area/shuttle/tripoli)
"nf" = (
/obj/structure/shuttle/part/tripoli{
	icon_state = "20"
	},
/turf/template_noop,
/area/shuttle/tripoli)
"pg" = (
/obj/structure/shuttle/part/tripoli/gunpod_prop,
/turf/template_noop,
/area/shuttle/tripoli)
"pD" = (
/turf/closed/shuttle/tripoli{
	icon_state = "62"
	},
/area/shuttle/tripoli)
"pQ" = (
/turf/closed/shuttle/tripoli/transparent{
	icon_state = "89b"
	},
/area/shuttle/tripoli)
"qt" = (
/obj/structure/machinery/camera/autoname/golden_arrow/tripoli,
/obj/structure/extinguisher_cabinet/lifeboat,
/obj/structure/bed/chair/dropship/passenger{
	dir = 8
	},
/obj/structure/machinery/cm_vending/sorted/medical/wall_med{
	pixel_y = 26;
	pixel_x = -10
	},
/turf/open/shuttle/dropship/medium_grey_single_wide_up_to_down,
/area/shuttle/tripoli)
"qK" = (
/turf/open/shuttle/dropship/medium_grey_single_wide_up_to_down,
/area/shuttle/tripoli)
"qV" = (
/obj/structure/shuttle/part/tripoli{
	icon_state = "5"
	},
/turf/template_noop,
/area/shuttle/tripoli)
"rb" = (
/turf/closed/shuttle/tripoli{
	icon_state = "22"
	},
/area/shuttle/tripoli)
"rs" = (
/turf/closed/shuttle/tripoli{
	icon_state = "30"
	},
/area/shuttle/tripoli)
"rB" = (
/obj/structure/shuttle/part/tripoli{
	icon_state = "71"
	},
/turf/template_noop,
/area/shuttle/tripoli)
"sJ" = (
/turf/closed/shuttle/tripoli/transparent{
	icon_state = "97a"
	},
/area/shuttle/tripoli)
"ta" = (
/turf/closed/shuttle/tripoli{
	icon_state = "26"
	},
/area/shuttle/tripoli)
"ty" = (
/turf/closed/shuttle/tripoli{
	icon_state = "67"
	},
/area/shuttle/tripoli)
"ua" = (
/turf/open/shuttle/dropship/light_grey_bottom_right,
/area/shuttle/tripoli)
"uq" = (
/obj/structure/shuttle/part/tripoli{
	icon_state = "91"
	},
/turf/template_noop,
/area/shuttle/tripoli)
"uz" = (
/turf/closed/shuttle/tripoli{
	icon_state = "48"
	},
/area/shuttle/tripoli)
"vc" = (
/obj/structure/machinery/camera/autoname/golden_arrow/tripoli{
	dir = 4
	},
/turf/open/shuttle/dropship/light_grey_single_wide_up_to_down,
/area/shuttle/tripoli)
"vm" = (
/obj/effect/decal/warning_stripes{
	icon_state = "N";
	pixel_y = -1
	},
/obj/effect/decal/warning_stripes{
	icon_state = "S";
	pixel_y = 2
	},
/obj/structure/machinery/door/airlock/multi_tile/almayer/dropshiprear/ds1{
	name = "\improper Tripoli cargo door"
	},
/turf/open/shuttle/dropship/medium_grey_single_wide_left_to_right,
/area/shuttle/tripoli)
"xi" = (
/obj/structure/shuttle/part/tripoli{
	icon_state = "16"
	},
/turf/template_noop,
/area/shuttle/tripoli)
"xl" = (
/obj/effect/attach_point/crew_weapon/tripoli,
/obj/docking_port/mobile/marine_dropship/tripoli,
/turf/open/shuttle/dropship/medium_grey_single_wide_up_to_down,
/area/shuttle/tripoli)
"xA" = (
/obj/structure/shuttle/part/tripoli{
	icon_state = "90"
	},
/obj/effect/attach_point/weapon/tripoli/right_fore,
/turf/template_noop,
/area/shuttle/tripoli)
"xD" = (
/obj/structure/machinery/light/double{
	dir = 8
	},
/turf/open/shuttle/dropship/light_grey_single_wide_up_to_down,
/area/shuttle/tripoli)
"xN" = (
/obj/structure/shuttle/part/dropship2/transparent/engine_left_cap{
	name = "\improper Tripoli"
	},
/turf/template_noop,
/area/shuttle/tripoli)
"xQ" = (
/obj/structure/machinery/light/double{
	dir = 4
	},
/obj/structure/bed/chair/dropship/passenger{
	dir = 8
	},
/turf/open/shuttle/dropship/medium_grey_single_wide_up_to_down,
/area/shuttle/tripoli)
"yR" = (
/turf/closed/shuttle/tripoli{
	icon_state = "29"
	},
/area/shuttle/tripoli)
"zM" = (
/turf/closed/shuttle/tripoli{
	icon_state = "42"
	},
/area/shuttle/tripoli)
"Bj" = (
/turf/closed/shuttle/tripoli{
	icon_state = "23"
	},
/area/shuttle/tripoli)
"Bx" = (
/obj/structure/bed/chair/dropship/passenger/folded{
	pixel_y = 8;
	buckling_y = 8
	},
/turf/open/shuttle/dropship/medium_grey_single_wide_up_to_down,
/area/shuttle/tripoli)
"Do" = (
/obj/structure/stairs/perspective,
/obj/structure/platform{
	dir = 8;
	layer = 2.7
	},
/obj/structure/platform{
	dir = 4
	},
/turf/open/shuttle/dropship/light_grey_single_wide_up_to_down,
/area/shuttle/tripoli)
"EP" = (
/obj/structure/shuttle/part/tripoli/transparent/nosecone{
	icon_state = "102"
	},
/turf/template_noop,
/area/shuttle/tripoli)
"FL" = (
/obj/structure/shuttle/part/tripoli{
	icon_state = "74"
	},
/turf/template_noop,
/area/shuttle/tripoli)
"FX" = (
/obj/structure/machinery/light/double{
	dir = 4
	},
/turf/open/shuttle/dropship/light_grey_single_wide_up_to_down,
/area/shuttle/tripoli)
"Gd" = (
/turf/closed/shuttle/tripoli{
	icon_state = "75"
	},
/area/shuttle/tripoli)
"Gv" = (
/obj/structure/shuttle/part/tripoli{
	icon_state = "4"
	},
/turf/template_noop,
/area/shuttle/tripoli)
"HI" = (
/obj/structure/machinery/cm_vending/sorted/medical/wall_med{
	pixel_y = 26;
	pixel_x = 10
	},
/obj/structure/extinguisher_cabinet/lifeboat{
	pixel_y = 27;
	pixel_x = -2
	},
/obj/structure/bed/chair/dropship/passenger{
	dir = 4
	},
/turf/open/shuttle/dropship/medium_grey_single_wide_up_to_down,
/area/shuttle/tripoli)
"Ie" = (
/turf/closed/shuttle/tripoli/transparent{
	icon_state = "86a"
	},
/area/shuttle/tripoli)
"Ih" = (
/obj/structure/shuttle/part/tripoli{
	icon_state = "8"
	},
/turf/template_noop,
/area/shuttle/tripoli)
"IJ" = (
/obj/effect/attach_point/fuel/tripoli{
	dir = 1
	},
/turf/closed/shuttle/tripoli{
	icon_state = "28"
	},
/area/shuttle/tripoli)
"IZ" = (
/obj/structure/platform_decoration{
	dir = 4
	},
/obj/effect/decal/warning_stripes{
	icon_state = "N";
	pixel_y = 1
	},
/obj/structure/platform_decoration{
	dir = 8
	},
/turf/open/shuttle/dropship/light_grey_single_wide_up_to_down,
/area/shuttle/tripoli)
"Jq" = (
/obj/structure/stairs/perspective{
	dir = 1;
	icon_state = "p_stair_full";
	pixel_y = 22
	},
/obj/structure/machinery/computer/dropship_weapons/tripoli/small{
	pixel_y = 8;
	pixel_x = 8
	},
/obj/structure/bed/chair/vehicle/dropship_cockpit/copilot{
	dir = 1;
	pixel_x = 8;
	layer = 5
	},
/turf/open/shuttle/dropship/medium_grey_single_wide_up_to_down,
/area/shuttle/tripoli)
"JU" = (
/turf/closed/shuttle/tripoli{
	icon_state = "103"
	},
/area/shuttle/tripoli)
"JY" = (
/obj/effect/decal/warning_stripes{
	icon_state = "S";
	pixel_y = 2
	},
/obj/effect/decal/warning_stripes{
	icon_state = "N";
	pixel_y = -1
	},
/turf/open/shuttle/dropship/medium_grey_single_wide_left_to_right,
/area/shuttle/tripoli)
"Lj" = (
/obj/structure/shuttle/part/tripoli/transparent{
	icon_state = "95a"
	},
/turf/template_noop,
/area/shuttle/tripoli)
"Mn" = (
/turf/closed/shuttle/tripoli{
	icon_state = "47"
	},
/area/shuttle/tripoli)
"Mx" = (
/turf/closed/shuttle/tripoli{
	icon_state = "33"
	},
/area/shuttle/tripoli)
"Na" = (
/obj/structure/shuttle/part/tripoli{
	icon_state = "61"
	},
/obj/effect/attach_point/weapon/tripoli/left_wing,
/turf/template_noop,
/area/shuttle/tripoli)
"Nk" = (
/turf/open/shuttle/dropship/light_grey_top_right,
/area/shuttle/tripoli)
"Nz" = (
/obj/structure/machinery/light/double{
	dir = 8
	},
/obj/structure/bed/chair/dropship/passenger{
	dir = 4
	},
/turf/open/shuttle/dropship/medium_grey_single_wide_up_to_down,
/area/shuttle/tripoli)
"NE" = (
/turf/closed/shuttle/tripoli/transparent{
	icon_state = "78"
	},
/area/shuttle/tripoli)
"Oz" = (
/obj/structure/phone_base{
	dir = 4;
	pixel_x = -19;
	pixel_y = 12;
	layer = 3.1;
	phone_category = "Dropship";
	name = "Tripoli telephone receiver";
	phone_id = "Tripoli"
	},
/obj/structure/bed/chair/vehicle/dropship_cockpit/pilot{
	dir = 1;
	pixel_x = 6;
	pixel_y = 8
	},
/obj/structure/machinery/computer/shuttle/dropship/flight/small{
	pixel_y = 16;
	pixel_x = 6
	},
/obj/structure/machinery/light/small{
	light_color = "#C02526";
	color = "#C02526";
	dir = 4;
	pixel_y = 15;
	breakable = 0
	},
/turf/open/shuttle/dropship/medium_grey_single_wide_up_to_down,
/area/shuttle/tripoli)
"OB" = (
/turf/open/shuttle/dropship/light_grey_top_left,
/area/shuttle/tripoli)
"OE" = (
/obj/structure/shuttle/part/tripoli/transparent{
	icon_state = "99a"
	},
/turf/template_noop,
/area/shuttle/tripoli)
"OY" = (
/obj/effect/attach_point/crew_weapon/midway,
/turf/open/shuttle/dropship/medium_grey_single_wide_up_to_down,
/area/shuttle/tripoli)
"OZ" = (
/obj/structure/shuttle/part/dropship2/transparent/engine_right_cap{
	name = "\improper Tripoli"
	},
/turf/template_noop,
/area/shuttle/tripoli)
"Pi" = (
/turf/open/shuttle/dropship/light_grey_bottom_left,
/area/shuttle/tripoli)
"PI" = (
/obj/structure/shuttle/part/tripoli{
	icon_state = "3"
	},
/turf/template_noop,
/area/shuttle/tripoli)
"Qb" = (
/obj/structure/shuttle/part/tripoli{
	icon_state = "65"
	},
/obj/effect/attach_point/weapon/tripoli/right_wing,
/turf/template_noop,
/area/shuttle/tripoli)
"Qs" = (
/turf/closed/shuttle/tripoli{
	icon_state = "77"
	},
/area/shuttle/tripoli)
"Qy" = (
/obj/structure/shuttle/part/tripoli{
	icon_state = "84"
	},
/obj/effect/attach_point/electronics/tripoli,
/turf/template_noop,
/area/shuttle/tripoli)
"QX" = (
/turf/closed/shuttle/tripoli{
	icon_state = "73"
	},
/area/shuttle/tripoli)
"RT" = (
/turf/closed/shuttle/tripoli{
	icon_state = "64"
	},
/area/shuttle/tripoli)
"Sf" = (
/turf/closed/shuttle/tripoli{
	icon_state = "43"
	},
/area/shuttle/tripoli)
"Sy" = (
/turf/closed/shuttle/tripoli{
	icon_state = "39"
	},
/area/shuttle/tripoli)
"Tw" = (
/obj/structure/shuttle/part/tripoli{
	icon_state = "49"
	},
/obj/structure/shuttle/part/dropship2/transparent/engine_left_cap{
	name = "\improper Tripoli"
	},
/turf/template_noop,
/area/shuttle/tripoli)
"UO" = (
/obj/structure/bed/chair/dropship/passenger{
	dir = 4
	},
/turf/open/shuttle/dropship/medium_grey_single_wide_up_to_down,
/area/shuttle/tripoli)
"Vg" = (
/obj/structure/platform{
	dir = 1
	},
/obj/effect/decal/warning_stripes{
	icon_state = "N";
	pixel_y = 1
	},
/obj/structure/blocker/forcefield/multitile_vehicles,
/turf/open/shuttle/dropship/medium_grey_single_wide_up_to_down,
/area/shuttle/tripoli)
"VF" = (
/obj/structure/blocker/forcefield/multitile_vehicles,
/obj/structure/machinery/door/airlock/hatch/cockpit{
	dir = 1
	},
/turf/open/shuttle/dropship/medium_grey_single_wide_up_to_down,
/area/shuttle/tripoli)
"WP" = (
/turf/closed/shuttle/tripoli{
	icon_state = "38"
	},
/area/shuttle/tripoli)
"Xl" = (
/turf/open/shuttle/dropship/light_grey_single_wide_left_to_right,
/area/shuttle/tripoli)
"YE" = (
/obj/structure/shuttle/part/tripoli{
	icon_state = "85"
	},
/obj/effect/attach_point/weapon/tripoli/left_fore,
/turf/template_noop,
/area/shuttle/tripoli)
"YS" = (
/turf/open/shuttle/dropship/light_grey_single_wide_up_to_down,
/area/shuttle/tripoli)
"Zb" = (
/obj/structure/shuttle/part/tripoli{
	icon_state = "66"
	},
/turf/template_noop,
/area/shuttle/tripoli)

(1,1,1) = {"
ed
ed
ed
ed
ed
rB
Zb
Na
ed
xN
aq
IJ
rb
xi
ed
bd
"}
(2,1,1) = {"
ed
ed
ed
Qy
Gd
hb
ty
pD
zM
mz
fO
yR
Bj
eb
ed
bl
"}
(3,1,1) = {"
ed
ed
ed
YE
Qs
HI
Nz
UO
UO
Mn
zM
rs
bJ
JU
jA
PI
"}
(4,1,1) = {"
lJ
Lj
kt
Ie
NE
OB
YS
Pi
iZ
hm
xD
vc
YS
vm
ed
ed
"}
(5,1,1) = {"
pg
sJ
Oz
Jq
VF
Xl
Bx
Xl
xl
Vg
qK
OY
qK
JY
ed
ed
"}
(6,1,1) = {"
EP
OE
pQ
li
dJ
Nk
YS
ua
Do
IZ
FX
YS
YS
JY
ed
ed
"}
(7,1,1) = {"
ed
ed
ed
xA
Qs
qt
xQ
hU
hU
uz
Sf
kg
cC
kI
Ih
Gv
"}
(8,1,1) = {"
ed
ed
ed
uq
fD
QX
eq
RT
Sf
Tw
WP
jM
ta
nf
ed
qV
"}
(9,1,1) = {"
ed
ed
ed
ed
ed
FL
dU
Qb
ed
OZ
Sy
Mx
au
mY
ed
en
"}
