//MAP CONVERTED BY dmm2tgm.py THIS HEADER COMMENT PREVENTS RECONVERSION, DO NOT REMOVE
"aA" = (
/obj/structure/bed/chair/vehicle{
	dir = 4;
	pixel_x = -9
	},
/obj/effect/decal/warning_stripes{
	icon_state = "E";
	pixel_x = -12
	},
/turf/open/floor/strata/multi_tiles/west,
/area/shuttle/ds_upp)
"cO" = (
/obj/structure/machinery/door/airlock/dropship_hatch/upp{
	id = "port_door"
	},
/turf/open/floor/strata/floor3/east,
/area/shuttle/ds_upp)
"cS" = (
/obj/structure/platform/mineral{
	dir = 1;
	color = "#464847"
	},
/turf/open/floor/strata/floor3/east,
/area/shuttle/ds_upp)
"cU" = (
/obj/effect/decal/warning_stripes{
	icon_state = "S";
	pixel_x = 12;
	pixel_y = 29
	},
/turf/open/floor/strata/multi_tiles/west,
/area/shuttle/ds_upp)
"di" = (
/turf/closed/shuttle/ert{
	icon_state = "rightengine_11";
	opacity = 0
	},
/area/shuttle/ds_upp)
"ey" = (
/obj/effect/decal/warning_stripes{
	icon_state = "W";
	pixel_x = -1
	},
/turf/open/floor/strata/floor3/east,
/area/shuttle/ds_upp)
"eE" = (
/obj/structure/barricade/handrail/strata{
	dir = 8;
	can_buckle = 1
	},
/turf/open/floor/plating/plating_catwalk/strata,
/area/shuttle/ds_upp)
"ft" = (
/obj/structure/bed/chair/vehicle{
	pixel_x = 9;
	dir = 8
	},
/obj/effect/decal/warning_stripes{
	icon_state = "E";
	pixel_x = -15
	},
/turf/open/floor/strata/multi_tiles/west,
/area/shuttle/ds_upp)
"hg" = (
/turf/closed/shuttle/ert{
	icon_state = "upp9"
	},
/area/shuttle/ds_upp)
"hS" = (
/obj/structure/bed/chair/vehicle{
	dir = 4;
	pixel_x = -9
	},
/obj/effect/decal/warning_stripes{
	icon_state = "E"
	},
/turf/open/floor/plating/plating_catwalk/strata,
/area/shuttle/ds_upp)
"iN" = (
/obj/effect/decal/warning_stripes{
	icon_state = "S";
	pixel_y = -1
	},
/turf/open/floor/plating/plating_catwalk/strata,
/area/shuttle/ds_upp)
"jZ" = (
/obj/effect/decal/warning_stripes{
	icon_state = "S";
	pixel_x = -1
	},
/turf/open/floor/strata/multi_tiles/west,
/area/shuttle/ds_upp)
"kt" = (
/obj/structure/machinery/camera/autoname/golden_arrow/midway{
	dir = 8;
	pixel_x = 23;
	network = list("Chapaev","Akademia Nauk")
	},
/obj/structure/barricade/handrail/strata{
	dir = 4;
	can_buckle = 1
	},
/turf/open/floor/plating/plating_catwalk/strata,
/area/shuttle/ds_upp)
"ld" = (
/obj/effect/attach_point/weapon/midway/left_wing{
	ship_tag = "dropship_upp"
	},
/turf/closed/shuttle/ert{
	icon_state = "upp201"
	},
/area/shuttle/ds_upp)
"lf" = (
/obj/structure/machinery/light{
	dir = 1;
	pixel_y = 11
	},
/obj/structure/barricade/handrail/strata{
	dir = 8;
	can_buckle = 1
	},
/turf/open/floor/plating/plating_catwalk/strata,
/area/shuttle/ds_upp)
"lm" = (
/turf/closed/shuttle/ert{
	icon_state = "upp1"
	},
/area/shuttle/ds_upp)
"nZ" = (
/obj/structure/machinery/camera/autoname/golden_arrow/midway{
	dir = 4;
	pixel_x = -23;
	network = list("Chapaev","Akademia Nauk")
	},
/obj/structure/barricade/handrail/strata{
	dir = 8;
	can_buckle = 1
	},
/turf/open/floor/plating/plating_catwalk/strata,
/area/shuttle/ds_upp)
"pv" = (
/turf/closed/shuttle/ert{
	icon_state = "leftengine_3";
	opacity = 0
	},
/area/shuttle/ds_upp)
"qf" = (
/turf/closed/shuttle/ert{
	icon_state = "T61"
	},
/area/shuttle/ds_upp)
"rr" = (
/obj/structure/machinery/computer/dropship_weapons/midway{
	name = "\improper 'Akademia Nauk' weapons controls";
	shuttle_tag = "dropship_upp";
	faction = "UPP";
	req_one_access = list(230, 235,240)
	},
/obj/structure/blocker/invisible_wall,
/turf/open/floor/strata/floor3/east,
/area/shuttle/ds_upp)
"si" = (
/obj/structure/bed/chair/vehicle{
	pixel_x = 9;
	dir = 8
	},
/obj/effect/decal/warning_stripes{
	icon_state = "W"
	},
/turf/open/floor/plating/plating_catwalk/strata,
/area/shuttle/ds_upp)
"um" = (
/obj/effect/decal/warning_stripes{
	icon_state = "S";
	pixel_x = 12
	},
/turf/open/floor/strata/floor3/east,
/area/shuttle/ds_upp)
"wi" = (
/obj/effect/decal/warning_stripes{
	icon_state = "N";
	pixel_y = 1;
	pixel_x = -1
	},
/obj/structure/machinery/door/airlock/multi_tile/almayer/dropshiprear/upp{
	id = "aft_door"
	},
/turf/open/floor/strata/floor3/east,
/area/shuttle/ds_upp)
"wO" = (
/turf/closed/shuttle/ert{
	icon_state = "upp201"
	},
/area/shuttle/ds_upp)
"xc" = (
/turf/closed/shuttle/ert{
	icon_state = "upp_rightengine"
	},
/area/shuttle/ds_upp)
"xv" = (
/obj/structure/machinery/light{
	dir = 8;
	pixel_x = -14
	},
/obj/structure/barricade/handrail/strata{
	dir = 8;
	can_buckle = 1
	},
/turf/open/floor/plating/plating_catwalk/strata,
/area/shuttle/ds_upp)
"xE" = (
/turf/closed/shuttle/ert{
	icon_state = "upp4"
	},
/area/shuttle/ds_upp)
"Ab" = (
/obj/effect/attach_point/crew_weapon/midway{
	attach_id = 7;
	ship_tag = "dropship_upp"
	},
/obj/structure/barricade/handrail/strata{
	can_buckle = 1
	},
/obj/effect/decal/warning_stripes{
	icon_state = "S"
	},
/turf/open/floor/strata/multi_tiles/southwest,
/area/shuttle/ds_upp)
"AK" = (
/turf/closed/shuttle/ert{
	icon_state = "upp21"
	},
/area/shuttle/ds_upp)
"BD" = (
/obj/effect/decal/warning_stripes{
	icon_state = "N";
	pixel_y = 1
	},
/turf/open/floor/strata/floor3/east,
/area/shuttle/ds_upp)
"BT" = (
/turf/closed/shuttle/ert{
	icon_state = "rightengine_2";
	opacity = 0
	},
/area/shuttle/ds_upp)
"CV" = (
/obj/structure/barricade/handrail/strata{
	dir = 4;
	can_buckle = 1
	},
/obj/structure/machinery/cm_vending/sorted/medical/wall_med/limited{
	name = "\improper MinZdrav dispenser";
	desc = "A wall-mounted medical equipment dispenser. Provided by Ministry of Health of UPP, it contains a small quantity of emergency supplies.";
	pixel_x = 30
	},
/turf/open/floor/plating/plating_catwalk/strata,
/area/shuttle/ds_upp)
"DG" = (
/turf/closed/shuttle/ert{
	icon_state = "leftengine_2";
	opacity = 0
	},
/area/shuttle/ds_upp)
"Ek" = (
/obj/effect/attach_point/crew_weapon/midway{
	attach_id = 7;
	ship_tag = "dropship_upp"
	},
/turf/open/floor/strata/multi_tiles/southwest,
/area/shuttle/ds_upp)
"Fc" = (
/obj/structure/barricade/handrail/strata{
	dir = 4;
	can_buckle = 1
	},
/turf/open/floor/plating/plating_catwalk/strata,
/area/shuttle/ds_upp)
"Fz" = (
/turf/closed/shuttle/ert{
	icon_state = "rightengine_3";
	opacity = 0
	},
/area/shuttle/ds_upp)
"FF" = (
/obj/effect/decal/warning_stripes{
	icon_state = "E";
	pixel_x = 1
	},
/turf/open/floor/strata/multi_tiles/west,
/area/shuttle/ds_upp)
"FG" = (
/obj/structure/machinery/light{
	dir = 8;
	pixel_x = -14
	},
/obj/structure/bed/chair/dropship/pilot{
	dir = 1;
	layer = 6
	},
/obj/effect/decal/warning_stripes{
	icon_state = "E";
	pixel_x = 1
	},
/turf/open/floor/strata/multi_tiles/southwest,
/area/shuttle/ds_upp)
"FY" = (
/obj/structure/stairs{
	layer = 2.1
	},
/turf/open/floor/strata/floor3/east,
/area/shuttle/ds_upp)
"Gn" = (
/obj/effect/decal/warning_stripes{
	icon_state = "S";
	layer = 2
	},
/turf/open/floor/strata/floor3/east,
/area/shuttle/ds_upp)
"GH" = (
/obj/structure/machinery/computer/shuttle/dropship/flight,
/obj/structure/blocker/invisible_wall,
/obj/item/frame/camera{
	pixel_x = 12;
	pixel_y = 17;
	name = "broken dashcam";
	desc = "Welp, no more funny crash vids..."
	},
/turf/open/floor/strata/floor3/east,
/area/shuttle/ds_upp)
"GY" = (
/obj/docking_port/mobile/marine_dropship/upp,
/turf/closed/shuttle/ert{
	icon_state = "uppwall"
	},
/area/shuttle/ds_upp)
"Hk" = (
/turf/closed/shuttle/ert{
	icon_state = "upp251"
	},
/area/shuttle/ds_upp)
"HB" = (
/turf/closed/shuttle/dropship1/transparent{
	name = "wall";
	icon = 'icons/turf/ert_shuttle.dmi';
	icon_state = "upp27"
	},
/area/shuttle/ds_upp)
"HD" = (
/turf/closed/shuttle/ert{
	icon_state = "upp3"
	},
/area/shuttle/ds_upp)
"IK" = (
/obj/effect/decal/warning_stripes{
	icon_state = "S"
	},
/turf/open/floor/strata/multi_tiles/west,
/area/shuttle/ds_upp)
"Jo" = (
/obj/effect/attach_point/weapon/midway/left_fore,
/obj/effect/attach_point/weapon/midway/right_fore{
	ship_tag = "dropship_upp"
	},
/turf/template_noop,
/area/template_noop)
"Jy" = (
/turf/template_noop,
/area/template_noop)
"JN" = (
/obj/effect/decal/warning_stripes{
	icon_state = "S";
	pixel_x = -13;
	pixel_y = 29
	},
/turf/open/floor/strata/multi_tiles/west,
/area/shuttle/ds_upp)
"Ko" = (
/obj/structure/machinery/light{
	dir = 1;
	pixel_y = 11
	},
/obj/structure/barricade/handrail/strata{
	dir = 4;
	can_buckle = 1
	},
/turf/open/floor/plating/plating_catwalk/strata,
/area/shuttle/ds_upp)
"Kv" = (
/obj/structure/bed/chair/vehicle{
	pixel_x = -8;
	pixel_y = 7
	},
/obj/structure/bed/chair/vehicle{
	pixel_x = 8;
	pixel_y = 7
	},
/turf/open/floor/strata/floor3/east,
/area/shuttle/ds_upp)
"LD" = (
/obj/effect/decal/warning_stripes{
	icon_state = "W";
	pixel_x = -1
	},
/turf/open/floor/strata/multi_tiles/west,
/area/shuttle/ds_upp)
"LW" = (
/obj/structure/machinery/light{
	dir = 8;
	pixel_x = -14
	},
/obj/structure/bed/chair/vehicle{
	dir = 4;
	pixel_x = -9
	},
/obj/effect/decal/warning_stripes{
	icon_state = "E"
	},
/turf/open/floor/plating/plating_catwalk/strata,
/area/shuttle/ds_upp)
"MF" = (
/turf/closed/shuttle/ert{
	icon_state = "upp_leftengine"
	},
/area/shuttle/ds_upp)
"Nh" = (
/turf/closed/shuttle/ert{
	icon_state = "uppwall"
	},
/area/shuttle/ds_upp)
"Ou" = (
/obj/structure/machinery/door/airlock/hatch/cockpit/upp,
/turf/open/floor/strata/floor3/east,
/area/shuttle/ds_upp)
"OE" = (
/obj/effect/attach_point/crew_weapon/midway{
	attach_id = 8;
	ship_tag = "dropship_upp"
	},
/turf/open/floor/strata/multi_tiles/southwest,
/area/shuttle/ds_upp)
"PQ" = (
/obj/effect/attach_point/weapon/midway/right_wing{
	ship_tag = "dropship_upp"
	},
/turf/closed/shuttle/ert{
	icon_state = "upp251"
	},
/area/shuttle/ds_upp)
"Qk" = (
/obj/structure/machinery/computer/cameras/dropship/midway{
	network = list("Akademia Nauk","Laser Targets");
	name = "\improper 'Akademia Nauk' camera controls"
	},
/obj/structure/blocker/invisible_wall,
/obj/structure/phone_base{
	pixel_y = 32;
	name = "Akademia Nauk Telephone";
	phone_category = "Dropship";
	phone_id = "Akademia Nauk";
	networks_receive = list("UPP");
	networks_transmit = list("UPP")
	},
/turf/open/floor/strata/floor3/east,
/area/shuttle/ds_upp)
"RX" = (
/obj/structure/machinery/light{
	dir = 4;
	pixel_x = 14
	},
/obj/structure/machinery/camera/autoname/golden_arrow/midway{
	pixel_x = -6;
	pixel_y = -16
	},
/obj/structure/bed/chair/dropship/pilot{
	dir = 1;
	layer = 6
	},
/obj/effect/decal/warning_stripes{
	icon_state = "W";
	pixel_x = -1
	},
/turf/open/floor/strata/multi_tiles/southwest,
/area/shuttle/ds_upp)
"Sn" = (
/obj/effect/decal/warning_stripes{
	icon_state = "S";
	pixel_x = 12;
	pixel_y = 29
	},
/obj/structure/machinery/camera/autoname/golden_arrow/midway{
	network = list("Chapaev","Akademia Nauk")
	},
/turf/open/floor/plating/plating_catwalk/strata,
/area/shuttle/ds_upp)
"Sx" = (
/turf/closed/shuttle/ert{
	icon_state = "upp5"
	},
/area/shuttle/ds_upp)
"Th" = (
/turf/open/floor/strata/multi_tiles/west,
/area/shuttle/ds_upp)
"Tq" = (
/turf/open/floor/plating/plating_catwalk/strata,
/area/shuttle/ds_upp)
"TG" = (
/turf/closed/shuttle/ert{
	icon_state = "upp23"
	},
/area/shuttle/ds_upp)
"TO" = (
/obj/structure/machinery/light{
	dir = 4;
	pixel_x = 14
	},
/obj/structure/bed/chair/vehicle{
	pixel_x = 9;
	dir = 8
	},
/obj/effect/decal/warning_stripes{
	icon_state = "W"
	},
/turf/open/floor/plating/plating_catwalk/strata,
/area/shuttle/ds_upp)
"Wy" = (
/obj/effect/attach_point/crew_weapon/midway{
	attach_id = 9;
	ship_tag = "dropship_upp"
	},
/turf/open/floor/strata/multi_tiles/southwest,
/area/shuttle/ds_upp)
"Xb" = (
/obj/effect/decal/warning_stripes{
	icon_state = "S";
	pixel_x = 19
	},
/obj/effect/decal/warning_stripes{
	icon_state = "S";
	pixel_x = -5
	},
/obj/effect/decal/warning_stripes{
	icon_state = "N";
	pixel_y = 1
	},
/turf/open/floor/plating/plating_catwalk/strata,
/area/shuttle/ds_upp)
"Xe" = (
/obj/effect/attach_point/weapon/midway/left_fore,
/obj/effect/attach_point/weapon/midway/left_fore{
	ship_tag = "dropship_upp"
	},
/turf/template_noop,
/area/template_noop)
"Xo" = (
/turf/closed/shuttle/ert{
	icon_state = "T151"
	},
/area/shuttle/ds_upp)
"XE" = (
/obj/structure/barricade/handrail/strata{
	can_buckle = 1
	},
/obj/effect/decal/warning_stripes{
	icon_state = "S"
	},
/turf/open/floor/strata/multi_tiles/west,
/area/shuttle/ds_upp)
"Ya" = (
/obj/effect/decal/warning_stripes{
	icon_state = "E";
	pixel_x = 1
	},
/turf/open/floor/strata/floor3/east,
/area/shuttle/ds_upp)
"Yn" = (
/turf/open/floor/strata/floor3/east,
/area/shuttle/ds_upp)
"YJ" = (
/obj/structure/barricade/handrail/strata{
	dir = 8;
	can_buckle = 1
	},
/obj/structure/machinery/cm_vending/sorted/medical/wall_med/limited{
	name = "\improper MinZdrav dispenser";
	desc = "A wall-mounted medical equipment dispenser. Provided by Ministry of Health of UPP, it contains a small quantity of emergency supplies.";
	pixel_x = -30
	},
/turf/open/floor/plating/plating_catwalk/strata,
/area/shuttle/ds_upp)
"Zh" = (
/obj/structure/machinery/light{
	dir = 4;
	pixel_x = 14
	},
/obj/structure/barricade/handrail/strata{
	dir = 4;
	can_buckle = 1
	},
/turf/open/floor/plating/plating_catwalk/strata,
/area/shuttle/ds_upp)
"Zm" = (
/turf/closed/shuttle/ert{
	icon_state = "upp8"
	},
/area/shuttle/ds_upp)
"Zn" = (
/turf/closed/shuttle/ert{
	icon_state = "leftengine_11";
	opacity = 0
	},
/area/shuttle/ds_upp)
"ZO" = (
/turf/closed/shuttle/ert{
	icon_state = "upp22"
	},
/area/shuttle/ds_upp)

(1,1,1) = {"
Jy
Jy
Jy
Jy
ld
cO
cO
MF
pv
Zn
Jy
Jy
qf
MF
pv
DG
Zn
Jy
"}
(2,1,1) = {"
Jy
Jy
Xe
wO
ZO
LD
LD
Zm
xE
xE
xE
xE
xE
xE
MF
pv
DG
Zn
"}
(3,1,1) = {"
wO
xE
xE
AK
lf
OE
Yn
Tq
nZ
xv
YJ
eE
Gn
FY
Zm
xE
xE
lm
"}
(4,1,1) = {"
AK
Qk
FG
HB
Th
Ya
um
ft
ft
ft
ft
cU
XE
cS
jZ
LW
hS
wi
"}
(5,1,1) = {"
HB
GH
Th
Ou
iN
Kv
Xb
Nh
Nh
GY
Nh
Sn
Ab
cS
Ek
Th
Th
Yn
"}
(6,1,1) = {"
AK
rr
RX
HB
Th
ey
Yn
aA
aA
aA
aA
JN
XE
cS
IK
TO
si
BD
"}
(7,1,1) = {"
Hk
Sx
Sx
AK
Ko
Wy
Yn
Tq
kt
Zh
CV
Fc
Gn
FY
hg
Sx
Sx
HD
"}
(8,1,1) = {"
Jy
Jy
Jo
Hk
TG
FF
FF
hg
Sx
Sx
Sx
Sx
Sx
Sx
xc
Fz
BT
di
"}
(9,1,1) = {"
Jy
Jy
Jy
Jy
PQ
cO
cO
xc
Fz
di
Jy
Jy
Xo
xc
Fz
BT
di
Jy
"}
