//MAP CONVERTED BY dmm2tgm.py THIS HEADER COMMENT PREVENTS RECONVERSION, DO NOT REMOVE
"ak" = (
/obj/structure/shuttle/part/typhoon/transparent{
	icon_state = "33"
	},
/turf/template_noop,
/area/shuttle/tornado)
"am" = (
/obj/structure/machinery/light/double{
	dir = 8;
	pixel_y = -5
	},
/obj/structure/bed/chair/dropship/passenger{
	dir = 4
	},
/turf/open/shuttle/dropship/medium_grey_single_wide_up_to_down,
/area/shuttle/tornado)
"aA" = (
/turf/open/shuttle/dropship/light_grey_bottom_right,
/area/shuttle/tornado)
"aT" = (
/obj/structure/shuttle/part/tornado/transparent{
	icon_state = "22"
	},
/turf/template_noop,
/area/shuttle/tornado)
"aU" = (
/turf/closed/shuttle/typhoon{
	icon_state = "72"
	},
/area/shuttle/tornado)
"aX" = (
/turf/template_noop,
/area/space)
"aZ" = (
/obj/structure/shuttle/part/typhoon/transparent{
	icon_state = "32"
	},
/turf/template_noop,
/area/shuttle/tornado)
"bo" = (
/obj/structure/machinery/cm_vending/sorted/medical/wall_med/limited{
	pixel_y = 25
	},
/obj/structure/bed/chair/dropship/passenger/folded{
	dir = 4;
	buckling_y = 3;
	pixel_y = 3
	},
/turf/open/shuttle/dropship/light_grey_top_right,
/area/shuttle/tornado)
"bN" = (
/obj/structure/machinery/light/double{
	dir = 4;
	pixel_y = -5
	},
/obj/structure/surface/table/almayer,
/obj/item/storage/surgical_tray/empty,
/obj/item/reagent_container/hypospray/autoinjector/oxycodone{
	pixel_y = 9;
	pixel_x = -3
	},
/turf/open/shuttle/dropship/medium_grey_single_wide_up_to_down,
/area/shuttle/tornado)
"dg" = (
/obj/structure/platform_decoration{
	dir = 4
	},
/obj/structure/platform_decoration{
	dir = 8
	},
/turf/open/shuttle/dropship/medium_grey_single_wide_up_to_down,
/area/shuttle/tornado)
"dD" = (
/obj/structure/machinery/camera/autoname/golden_arrow/typhoon{
	dir = 8;
	pixel_x = 24
	},
/turf/open/shuttle/dropship/medium_grey_single_wide_up_to_down,
/area/shuttle/tornado)
"ez" = (
/obj/structure/machinery/computer/overwatch/toc{
	pixel_y = 14
	},
/obj/structure/surface/table/reinforced/toc/west{
	pixel_y = -7
	},
/obj/structure/machinery/prop/almayer/CICmap/arc{
	pixel_y = 9;
	pixel_x = -9
	},
/obj/structure/machinery/computer/railgun/toc{
	pixel_y = 14;
	pixel_x = 7
	},
/turf/open/shuttle/dropship/medium_grey_single_wide_up_to_down,
/area/shuttle/tornado)
"fj" = (
/obj/structure/shuttle/part/typhoon/transparent{
	icon_state = "16"
	},
/turf/template_noop,
/area/shuttle/tornado)
"fo" = (
/obj/structure/shuttle/part/typhoon/transparent{
	icon_state = "17"
	},
/turf/template_noop,
/area/shuttle/tornado)
"fy" = (
/turf/closed/shuttle/typhoon/transparent{
	icon_state = "86b"
	},
/area/shuttle/tornado)
"fC" = (
/obj/structure/shuttle/part/typhoon/transparent,
/turf/template_noop,
/area/shuttle/tornado)
"gB" = (
/obj/structure/bed/chair/dropship/passenger{
	dir = 8
	},
/obj/structure/barricade/handrail{
	dir = 1
	},
/turf/open/shuttle/dropship/medium_grey_single_wide_up_to_down,
/area/shuttle/tornado)
"gR" = (
/obj/structure/shuttle/part/typhoon/transparent{
	icon_state = "22"
	},
/turf/template_noop,
/area/shuttle/tornado)
"hu" = (
/obj/structure/phone_base{
	dir = 4;
	pixel_x = -19;
	pixel_y = 12;
	layer = 3.1;
	phone_category = "Dropship";
	name = "Typhoon telephone receiver";
	phone_id = "Typhoon"
	},
/obj/structure/bed/chair/vehicle/dropship_cockpit/pilot{
	dir = 1;
	pixel_x = 6;
	pixel_y = 8
	},
/obj/structure/machinery/computer/shuttle/dropship/flight/small{
	pixel_y = 16;
	pixel_x = 6
	},
/obj/structure/machinery/light/small{
	dir = 4;
	pixel_y = 15
	},
/turf/open/shuttle/dropship/medium_grey_single_wide_up_to_down,
/area/shuttle/tornado)
"il" = (
/turf/closed/shuttle/typhoon{
	icon_state = "103"
	},
/area/shuttle/tornado)
"ir" = (
/turf/closed/shuttle/typhoon{
	icon_state = "83"
	},
/area/shuttle/tornado)
"iA" = (
/turf/closed/shuttle/typhoon{
	icon_state = "24"
	},
/area/shuttle/tornado)
"jU" = (
/turf/open/shuttle/dropship/light_grey_single_wide_left_to_right,
/area/shuttle/tornado)
"kR" = (
/obj/structure/shuttle/part/typhoon/transparent{
	icon_state = "95a"
	},
/turf/template_noop,
/area/shuttle/tornado)
"lD" = (
/obj/structure/shuttle/part/typhoon/transparent{
	icon_state = "9"
	},
/turf/template_noop,
/area/shuttle/tornado)
"lI" = (
/obj/effect/attach_point/crew_weapon/typhoon,
/turf/open/shuttle/dropship/medium_grey_single_wide_up_to_down,
/area/shuttle/tornado)
"mh" = (
/obj/structure/shuttle/part/typhoon/transparent{
	icon_state = "71"
	},
/turf/template_noop,
/area/shuttle/tornado)
"np" = (
/obj/structure/shuttle/part/typhoon/transparent{
	icon_state = "39"
	},
/turf/template_noop,
/area/shuttle/tornado)
"on" = (
/obj/structure/shuttle/part/typhoon/transparent{
	icon_state = "4"
	},
/turf/template_noop,
/area/shuttle/tornado)
"oB" = (
/obj/structure/machinery/light/double{
	dir = 8;
	pixel_y = -5
	},
/obj/structure/bed/chair/vehicle/toc{
	dir = 1;
	pixel_y = 19;
	pixel_x = 16
	},
/turf/open/shuttle/dropship/medium_grey_single_wide_up_to_down,
/area/shuttle/tornado)
"pq" = (
/obj/structure/shuttle/part/typhoon/transparent/nosecone{
	icon_state = "100"
	},
/turf/template_noop,
/area/shuttle/tornado)
"qG" = (
/obj/structure/shuttle/part/typhoon/transparent{
	icon_state = "99a";
	layer = 2.97
	},
/turf/template_noop,
/area/shuttle/tornado)
"rs" = (
/obj/structure/shuttle/part/typhoon/transparent{
	icon_state = "41";
	density = 0;
	layer = 4.2
	},
/turf/template_noop,
/area/shuttle/tornado)
"rI" = (
/obj/structure/shuttle/part/typhoon/transparent{
	icon_state = "26"
	},
/turf/template_noop,
/area/shuttle/tornado)
"sz" = (
/turf/closed/shuttle/typhoon{
	icon_state = "25"
	},
/area/shuttle/tornado)
"tt" = (
/obj/structure/shuttle/part/typhoon/transparent{
	icon_state = "5"
	},
/turf/template_noop,
/area/shuttle/tornado)
"tY" = (
/obj/structure/shuttle/part/typhoon/transparent{
	icon_state = "32"
	},
/obj/effect/attach_point/fuel/typhoon{
	layer = 3.1;
	dir = 1
	},
/turf/template_noop,
/area/shuttle/tornado)
"uB" = (
/turf/open/shuttle/dropship/light_grey_single_wide_up_to_down,
/area/shuttle/tornado)
"vc" = (
/turf/closed/shuttle/typhoon{
	icon_state = "47"
	},
/area/shuttle/tornado)
"vp" = (
/obj/structure/stairs/perspective{
	icon_state = "p_stair_full";
	can_block_movement = 0
	},
/obj/structure/platform{
	dir = 4
	},
/obj/structure/platform{
	dir = 8
	},
/turf/open/shuttle/dropship/medium_grey_single_wide_up_to_down,
/area/shuttle/tornado)
"vv" = (
/obj/structure/machinery/camera/autoname/golden_arrow/typhoon{
	dir = 4;
	pixel_x = -24
	},
/obj/structure/bed/chair/dropship/passenger{
	dir = 4
	},
/obj/structure/barricade/handrail{
	dir = 1
	},
/turf/open/shuttle/dropship/medium_grey_single_wide_up_to_down,
/area/shuttle/tornado)
"vy" = (
/obj/structure/shuttle/part/typhoon/transparent{
	icon_state = "3"
	},
/turf/template_noop,
/area/shuttle/tornado)
"vF" = (
/obj/structure/bed/chair/dropship/passenger/folded{
	pixel_y = 8;
	buckling_y = 8
	},
/turf/open/shuttle/dropship/medium_grey_single_wide_up_to_down,
/area/shuttle/tornado)
"vL" = (
/obj/structure/shuttle/part/typhoon/transparent{
	icon_state = "6"
	},
/turf/template_noop,
/area/shuttle/tornado)
"wQ" = (
/obj/structure/machinery/light/double{
	dir = 4;
	pixel_y = -5
	},
/turf/open/shuttle/dropship/medium_grey_single_wide_up_to_down,
/area/shuttle/tornado)
"wU" = (
/obj/structure/shuttle/part/tornado/transparent{
	icon_state = "15"
	},
/turf/template_noop,
/area/shuttle/tornado)
"xi" = (
/turf/closed/shuttle/typhoon/transparent{
	icon_state = "89a"
	},
/area/shuttle/tornado)
"xW" = (
/obj/structure/shuttle/part/tornado/transparent{
	icon_state = "28"
	},
/turf/template_noop,
/area/shuttle/tornado)
"yq" = (
/obj/structure/shuttle/part/typhoon/transparent{
	icon_state = "74"
	},
/turf/template_noop,
/area/shuttle/tornado)
"zI" = (
/turf/closed/shuttle/typhoon/transparent{
	icon_state = "89b"
	},
/area/shuttle/tornado)
"zQ" = (
/turf/closed/shuttle/typhoon{
	icon_state = "36"
	},
/area/shuttle/tornado)
"Aj" = (
/obj/structure/shuttle/part/typhoon/gunpod_prop,
/turf/template_noop,
/area/shuttle/tornado)
"AK" = (
/obj/structure/shuttle/part/typhoon/transparent{
	icon_state = "23"
	},
/turf/template_noop,
/area/shuttle/tornado)
"AS" = (
/obj/structure/shuttle/part/typhoon/transparent{
	icon_state = "2"
	},
/turf/template_noop,
/area/shuttle/tornado)
"Ba" = (
/obj/structure/shuttle/part/typhoon/transparent{
	icon_state = "27"
	},
/turf/template_noop,
/area/shuttle/tornado)
"Bx" = (
/obj/structure/stairs/perspective{
	dir = 1;
	icon_state = "p_stair_full";
	pixel_y = 22
	},
/obj/structure/bed/chair/vehicle/dropship_cockpit/copilot{
	dir = 1;
	pixel_x = 8;
	layer = 5
	},
/obj/structure/machinery/computer/dropship_weapons/typhoon/small{
	pixel_x = 8;
	pixel_y = 8
	},
/turf/open/shuttle/dropship/medium_grey_single_wide_up_to_down,
/area/shuttle/tornado)
"Co" = (
/obj/structure/shuttle/part/tornado/transparent{
	icon_state = "26"
	},
/turf/template_noop,
/area/shuttle/tornado)
"Cw" = (
/obj/structure/platform{
	dir = 1
	},
/obj/structure/blocker/forcefield/multitile_vehicles,
/turf/open/shuttle/dropship/light_grey_single_wide_up_to_down,
/area/shuttle/tornado)
"CB" = (
/turf/open/shuttle/dropship/medium_grey_single_wide_up_to_down,
/area/shuttle/tornado)
"Dz" = (
/obj/structure/shuttle/part/typhoon/transparent{
	icon_state = "38"
	},
/turf/template_noop,
/area/shuttle/tornado)
"DE" = (
/turf/open/shuttle/dropship/light_grey_bottom_left,
/area/shuttle/tornado)
"Ed" = (
/turf/closed/shuttle/typhoon{
	icon_state = "77"
	},
/area/shuttle/tornado)
"EZ" = (
/obj/structure/shuttle/part/typhoon/transparent{
	icon_state = "28"
	},
/obj/effect/attach_point/fuel/typhoon{
	layer = 3.1;
	dir = 1
	},
/turf/template_noop,
/area/shuttle/tornado)
"FD" = (
/turf/closed/shuttle/typhoon{
	icon_state = "75"
	},
/area/shuttle/tornado)
"Gq" = (
/obj/structure/bed/portable_surgery{
	pixel_y = 5
	},
/obj/structure/machinery/iv_drip{
	pixel_y = 26;
	layer = 2.9
	},
/obj/structure/curtain/medical,
/turf/open/shuttle/dropship/medium_grey_single_wide_up_to_down,
/area/shuttle/tornado)
"GE" = (
/obj/structure/shuttle/part/tornado/transparent{
	icon_state = "29"
	},
/obj/structure/shuttle/part/typhoon/transparent{
	icon_state = "29"
	},
/turf/template_noop,
/area/shuttle/tornado)
"GX" = (
/turf/closed/shuttle/typhoon{
	icon_state = "30"
	},
/area/shuttle/tornado)
"Hj" = (
/obj/structure/shuttle/part/typhoon/transparent{
	icon_state = "40";
	density = 0;
	layer = 4.2
	},
/turf/template_noop,
/area/shuttle/tornado)
"Hw" = (
/obj/effect/attach_point/crew_weapon/typhoon,
/turf/open/shuttle/dropship/light_grey_single_wide_up_to_down,
/area/shuttle/tornado)
"IB" = (
/obj/structure/machinery/light/double{
	dir = 4;
	pixel_y = -5
	},
/obj/structure/bed/chair/dropship/passenger{
	dir = 8
	},
/turf/open/shuttle/dropship/medium_grey_single_wide_up_to_down,
/area/shuttle/tornado)
"IH" = (
/obj/structure/stairs/perspective{
	icon_state = "p_stair_full";
	can_block_movement = 0
	},
/obj/structure/platform{
	dir = 8
	},
/obj/structure/platform{
	dir = 4
	},
/turf/open/shuttle/dropship/medium_grey_single_wide_up_to_down,
/area/shuttle/tornado)
"IS" = (
/turf/closed/shuttle/typhoon{
	icon_state = "69"
	},
/area/shuttle/tornado)
"Jh" = (
/obj/structure/blocker/forcefield/multitile_vehicles,
/obj/structure/machinery/door/airlock/hatch/cockpit/three{
	dir = 1
	},
/turf/open/shuttle/dropship/medium_grey_single_wide_up_to_down,
/area/shuttle/tornado)
"Kl" = (
/obj/structure/bed/chair/dropship/passenger{
	dir = 4
	},
/turf/open/shuttle/dropship/medium_grey_single_wide_up_to_down,
/area/shuttle/tornado)
"KF" = (
/turf/closed/shuttle/typhoon{
	icon_state = "104"
	},
/area/shuttle/tornado)
"Lu" = (
/turf/closed/shuttle/typhoon{
	icon_state = "64"
	},
/area/shuttle/tornado)
"Lv" = (
/turf/closed/shuttle/typhoon/transparent{
	icon_state = "97a"
	},
/area/shuttle/tornado)
"Mn" = (
/obj/structure/machinery/light/double{
	dir = 8;
	pixel_y = -5
	},
/turf/open/shuttle/dropship/medium_grey_single_wide_up_to_down,
/area/shuttle/tornado)
"Ny" = (
/obj/effect/decal/warning_stripes{
	icon_state = "S";
	pixel_y = 2
	},
/obj/effect/decal/warning_stripes{
	icon_state = "N";
	pixel_y = -1
	},
/turf/open/shuttle/dropship/medium_grey_single_wide_left_to_right,
/area/shuttle/tornado)
"NS" = (
/obj/structure/shuttle/part/tornado/transparent{
	icon_state = "23"
	},
/obj/structure/shuttle/part/typhoon/transparent{
	icon_state = "23"
	},
/turf/template_noop,
/area/shuttle/tornado)
"Ot" = (
/obj/structure/platform_decoration{
	dir = 8
	},
/obj/structure/platform_decoration{
	dir = 4
	},
/turf/open/shuttle/dropship/medium_grey_single_wide_up_to_down,
/area/shuttle/tornado)
"OK" = (
/obj/structure/shuttle/part/typhoon/transparent{
	icon_state = "40";
	density = 0;
	layer = 4.2
	},
/obj/structure/shuttle/part/typhoon/transparent{
	icon_state = "65"
	},
/turf/template_noop,
/area/shuttle/tornado)
"Pb" = (
/obj/effect/decal/warning_stripes{
	icon_state = "N";
	pixel_y = -1
	},
/obj/effect/decal/warning_stripes{
	icon_state = "S";
	pixel_y = 2
	},
/obj/structure/machinery/door/airlock/multi_tile/almayer/dropshiprear/ds3{
	name = "\improper Typhoon cargo door";
	id = "aft_door"
	},
/turf/open/shuttle/dropship/medium_grey_single_wide_left_to_right,
/area/shuttle/tornado)
"PF" = (
/turf/closed/shuttle/typhoon{
	icon_state = "73"
	},
/area/shuttle/tornado)
"PI" = (
/obj/structure/shuttle/part/typhoon/transparent{
	icon_state = "70"
	},
/turf/template_noop,
/area/shuttle/tornado)
"Qe" = (
/obj/structure/shuttle/part/typhoon/transparent{
	icon_state = "41";
	density = 0;
	layer = 4.2
	},
/obj/structure/shuttle/part/typhoon/transparent{
	icon_state = "61"
	},
/turf/template_noop,
/area/shuttle/tornado)
"Qs" = (
/turf/closed/shuttle/typhoon{
	icon_state = "82"
	},
/area/shuttle/tornado)
"Rt" = (
/obj/structure/shuttle/part/typhoon/transparent{
	icon_state = "66"
	},
/turf/template_noop,
/area/shuttle/tornado)
"SJ" = (
/turf/closed/shuttle/typhoon{
	icon_state = "37"
	},
/area/shuttle/tornado)
"Tj" = (
/turf/closed/shuttle/typhoon{
	icon_state = "62"
	},
/area/shuttle/tornado)
"Tw" = (
/obj/structure/shuttle/part/typhoon/transparent/nosecone{
	icon_state = "102"
	},
/turf/template_noop,
/area/shuttle/tornado)
"Uh" = (
/obj/docking_port/mobile/marine_dropship/typhoon,
/obj/structure/bed/chair/dropship/passenger/folded{
	pixel_y = 8;
	buckling_y = 8
	},
/turf/open/shuttle/dropship/medium_grey_single_wide_up_to_down,
/area/shuttle/tornado)
"Uv" = (
/turf/closed/shuttle/typhoon{
	icon_state = "31"
	},
/area/shuttle/tornado)
"US" = (
/obj/structure/shuttle/part/typhoon/transparent{
	icon_state = "29"
	},
/turf/template_noop,
/area/shuttle/tornado)
"Vj" = (
/obj/structure/bed/chair/dropship/passenger{
	dir = 8
	},
/turf/open/shuttle/dropship/medium_grey_single_wide_up_to_down,
/area/shuttle/tornado)
"VC" = (
/obj/structure/machinery/camera/autoname/golden_arrow/typhoon{
	pixel_y = 32
	},
/obj/structure/surface/table/reinforced/toc/east{
	pixel_y = -7
	},
/obj/structure/machinery/computer/railgun/gatling/toc{
	pixel_y = 13;
	pixel_x = -7
	},
/obj/structure/phone_base/toc{
	pixel_y = 13;
	pixel_x = 11;
	phone_id = "Typhoon Overwatch";
	phone_category = "Overwatch";
	name = "Typhoon overwatch telephone receiver"
	},
/turf/open/shuttle/dropship/light_grey_top_left,
/area/shuttle/tornado)
"VP" = (
/turf/closed/shuttle/typhoon{
	icon_state = "48"
	},
/area/shuttle/tornado)
"Wa" = (
/turf/closed/shuttle/typhoon/transparent{
	icon_state = "86a"
	},
/area/shuttle/tornado)
"WL" = (
/obj/structure/shuttle/part/tornado/transparent{
	icon_state = "27"
	},
/turf/template_noop,
/area/shuttle/tornado)
"YX" = (
/turf/closed/shuttle/typhoon{
	icon_state = "67"
	},
/area/shuttle/tornado)

(1,1,1) = {"
aX
aX
aX
aX
aX
aX
aX
aX
Hj
Dz
EZ
gR
fj
aX
aX
aX
aX
aX
"}
(2,1,1) = {"
aX
aX
aX
aX
aX
mh
Rt
Rt
Qe
np
US
AK
fo
Hj
xW
aT
fj
fC
"}
(3,1,1) = {"
aX
aX
aX
Hj
FD
aU
YX
YX
Tj
zQ
GX
iA
lD
rs
GE
NS
fo
AS
"}
(4,1,1) = {"
aX
aX
aX
rs
Ed
ez
oB
vv
Kl
am
Kl
lI
vc
zQ
GX
iA
il
vy
"}
(5,1,1) = {"
pq
kR
fy
Wa
Qs
VC
uB
uB
uB
uB
DE
IH
dg
CB
Mn
CB
Pb
aX
"}
(6,1,1) = {"
Aj
Lv
hu
Bx
Jh
jU
CB
CB
Uh
vF
jU
CB
Cw
uB
Hw
uB
Ny
aX
"}
(7,1,1) = {"
Tw
qG
zI
xi
Ed
bo
uB
uB
uB
uB
aA
vp
Ot
dD
wQ
CB
Ny
aX
"}
(8,1,1) = {"
aX
aX
aX
Hj
Ed
Gq
bN
gB
Vj
IB
Vj
lI
VP
SJ
Uv
sz
KF
on
"}
(9,1,1) = {"
aX
aX
aX
rs
ir
PF
IS
IS
Lu
SJ
Uv
sz
wU
Hj
aZ
Co
fj
tt
"}
(10,1,1) = {"
aX
aX
aX
aX
aX
yq
PI
PI
OK
Dz
tY
rI
fj
rs
ak
WL
fo
vL
"}
(11,1,1) = {"
aX
aX
aX
aX
aX
aX
aX
aX
rs
np
ak
Ba
fo
aX
aX
aX
aX
aX
"}
