//MAP CONVERTED BY dmm2tgm.py THIS HEADER COMMENT PREVENTS RECONVERSION, DO NOT REMOVE
"af" = (
/turf/closed/shuttle/midway/transparent{
	icon_state = "34"
	},
/area/shuttle/midway)
"bm" = (
/obj/structure/shuttle/part/midway/transparent{
	icon_state = "21"
	},
/turf/template_noop,
/area/shuttle/midway)
"bs" = (
/turf/open/shuttle/dropship{
	icon_state = "rasputin6"
	},
/area/shuttle/midway)
"dr" = (
/obj/structure/bed/chair/dropship/passenger{
	dir = 4
	},
/obj/structure/machinery/light/double{
	dir = 8
	},
/turf/open/shuttle/dropship{
	icon_state = "rasputin15"
	},
/area/shuttle/midway)
"dB" = (
/obj/structure/shuttle/part/midway/transparent{
	icon_state = "7"
	},
/turf/template_noop,
/area/shuttle/midway)
"dD" = (
/turf/closed/shuttle/midway/transparent{
	icon_state = "22"
	},
/area/shuttle/midway)
"dE" = (
/turf/closed/shuttle/midway{
	icon_state = "36"
	},
/area/shuttle/midway)
"eu" = (
/obj/structure/shuttle/part/midway/transparent{
	icon_state = "2"
	},
/turf/template_noop,
/area/shuttle/midway)
"go" = (
/obj/structure/shuttle/part/midway/transparent{
	icon_state = "102"
	},
/turf/template_noop,
/area/shuttle/midway)
"gw" = (
/obj/structure/shuttle/part/midway/transparent{
	icon_state = "46"
	},
/obj/structure/shuttle/part/midway/transparent{
	icon_state = "41"
	},
/turf/template_noop,
/area/shuttle/midway)
"hl" = (
/turf/closed/shuttle/midway{
	icon_state = "24"
	},
/area/shuttle/midway)
"hL" = (
/obj/structure/shuttle/part/midway/transparent{
	icon_state = "95a"
	},
/turf/template_noop,
/area/shuttle/midway)
"hO" = (
/obj/structure/shuttle/part/midway/transparent{
	icon_state = "65"
	},
/obj/effect/attach_point/weapon/midway/right_wing,
/turf/template_noop,
/area/shuttle/midway)
"if" = (
/turf/closed/shuttle/midway/transparent{
	icon_state = "27"
	},
/area/shuttle/midway)
"im" = (
/turf/open/shuttle/dropship{
	icon_state = "rasputin4"
	},
/area/shuttle/midway)
"iv" = (
/obj/structure/bed/chair/dropship/passenger{
	dir = 8
	},
/turf/open/shuttle/dropship{
	icon_state = "rasputin15"
	},
/area/shuttle/midway)
"je" = (
/obj/structure/machinery/camera/autoname/golden_arrow/midway{
	dir = 4;
	pixel_x = -23
	},
/turf/open/shuttle/dropship{
	icon_state = "rasputin3"
	},
/area/shuttle/midway)
"jy" = (
/obj/structure/bed/chair/dropship/passenger{
	dir = 4
	},
/obj/structure/machinery/cm_vending/sorted/medical/wall_med{
	pixel_y = 26;
	pixel_x = 10
	},
/obj/structure/extinguisher_cabinet/lifeboat{
	pixel_y = 27;
	pixel_x = -2
	},
/turf/open/shuttle/dropship{
	icon_state = "rasputin15"
	},
/area/shuttle/midway)
"jW" = (
/turf/open/shuttle/dropship{
	icon_state = "rasputin3"
	},
/area/shuttle/midway)
"kC" = (
/obj/structure/platform{
	dir = 1
	},
/obj/structure/blocker/forcefield/multitile_vehicles,
/turf/open/shuttle/dropship{
	icon_state = "rasputin15"
	},
/area/shuttle/midway)
"ls" = (
/turf/closed/shuttle/midway/transparent{
	icon_state = "35"
	},
/area/shuttle/midway)
"lC" = (
/turf/closed/shuttle/midway{
	icon_state = "104"
	},
/area/shuttle/midway)
"mh" = (
/obj/structure/shuttle/part/midway/transparent{
	icon_state = "8"
	},
/turf/template_noop,
/area/shuttle/midway)
"mE" = (
/obj/structure/shuttle/part/midway/transparent,
/turf/template_noop,
/area/shuttle/midway)
"mG" = (
/obj/structure/shuttle/part/midway/transparent{
	icon_state = "41"
	},
/turf/template_noop,
/area/shuttle/midway)
"mL" = (
/obj/structure/platform_decoration{
	dir = 4
	},
/obj/structure/platform_decoration{
	dir = 8
	},
/turf/open/shuttle/dropship{
	icon_state = "rasputin3"
	},
/area/shuttle/midway)
"mR" = (
/obj/structure/bed/chair/dropship/passenger/folded{
	pixel_y = 8;
	buckling_y = 8
	},
/turf/open/shuttle/dropship{
	icon_state = "rasputin15"
	},
/area/shuttle/midway)
"od" = (
/turf/closed/shuttle/midway/transparent{
	icon_state = "89b"
	},
/area/shuttle/midway)
"ro" = (
/turf/closed/shuttle/midway/transparent{
	icon_state = "80"
	},
/area/shuttle/midway)
"rq" = (
/turf/closed/shuttle/midway{
	icon_state = "77"
	},
/area/shuttle/midway)
"rr" = (
/turf/closed/shuttle/midway{
	icon_state = "103"
	},
/area/shuttle/midway)
"rR" = (
/turf/closed/shuttle/midway/transparent{
	icon_state = "32"
	},
/area/shuttle/midway)
"sl" = (
/turf/closed/shuttle/midway{
	icon_state = "31"
	},
/area/shuttle/midway)
"tf" = (
/obj/structure/machinery/cm_vending/sorted/medical/wall_med{
	pixel_y = 26;
	pixel_x = -10
	},
/turf/closed/shuttle/midway/transparent{
	icon_state = "97a"
	},
/area/shuttle/midway)
"ti" = (
/turf/closed/shuttle/midway/transparent{
	icon_state = "86b"
	},
/area/shuttle/midway)
"tP" = (
/obj/structure/shuttle/part/midway/transparent{
	icon_state = "6"
	},
/turf/template_noop,
/area/shuttle/midway)
"ul" = (
/obj/structure/shuttle/part/midway/transparent{
	icon_state = "40"
	},
/turf/template_noop,
/area/shuttle/midway)
"ux" = (
/turf/closed/shuttle/midway/transparent{
	icon_state = "89a"
	},
/area/shuttle/midway)
"vJ" = (
/turf/open/shuttle/dropship{
	icon_state = "rasputin8"
	},
/area/shuttle/midway)
"vN" = (
/turf/closed/shuttle/midway/transparent{
	icon_state = "86a"
	},
/area/shuttle/midway)
"wB" = (
/turf/closed/shuttle/midway{
	icon_state = "83"
	},
/area/shuttle/midway)
"xp" = (
/turf/closed/shuttle/midway{
	icon_state = "62"
	},
/area/shuttle/midway)
"xy" = (
/obj/structure/bed/chair/dropship/passenger{
	dir = 8
	},
/obj/structure/machinery/cm_vending/sorted/medical/wall_med{
	pixel_y = 26;
	pixel_x = -10
	},
/turf/open/shuttle/dropship{
	icon_state = "rasputin15"
	},
/area/shuttle/midway)
"ym" = (
/turf/closed/shuttle/midway{
	icon_state = "69"
	},
/area/shuttle/midway)
"yB" = (
/turf/closed/shuttle/midway{
	icon_state = "54"
	},
/area/shuttle/midway)
"yN" = (
/obj/structure/shuttle/part/midway/transparent{
	icon_state = "4"
	},
/turf/template_noop,
/area/shuttle/midway)
"yO" = (
/obj/structure/shuttle/part/midway/transparent{
	icon_state = "61"
	},
/obj/effect/attach_point/weapon/midway/left_wing,
/turf/template_noop,
/area/shuttle/midway)
"zm" = (
/turf/closed/shuttle/midway/transparent{
	icon_state = "23"
	},
/area/shuttle/midway)
"Aw" = (
/obj/structure/shuttle/part/midway/transparent{
	icon_state = "91"
	},
/obj/effect/attach_point/electronics/midway,
/turf/template_noop,
/area/shuttle/midway)
"Bn" = (
/turf/closed/shuttle/midway{
	icon_state = "30"
	},
/area/shuttle/midway)
"BI" = (
/turf/closed/shuttle/midway{
	icon_state = "47"
	},
/area/shuttle/midway)
"BS" = (
/turf/closed/shuttle/midway/transparent{
	icon_state = "38"
	},
/area/shuttle/midway)
"BU" = (
/obj/structure/shuttle/part/midway/transparent{
	icon_state = "20"
	},
/turf/template_noop,
/area/shuttle/midway)
"Cc" = (
/obj/structure/bed/chair/dropship/passenger{
	dir = 4
	},
/turf/open/shuttle/dropship{
	icon_state = "rasputin15"
	},
/area/shuttle/midway)
"Cm" = (
/obj/effect/attach_point/fuel/midway{
	attach_id = 10
	},
/turf/closed/shuttle/midway/transparent{
	icon_state = "28"
	},
/area/shuttle/midway)
"Cr" = (
/obj/structure/shuttle/part/midway/transparent{
	icon_state = "100"
	},
/turf/template_noop,
/area/shuttle/midway)
"Db" = (
/turf/closed/shuttle/midway/transparent{
	icon_state = "26"
	},
/area/shuttle/midway)
"Dg" = (
/obj/structure/shuttle/part/midway/transparent{
	icon_state = "70"
	},
/turf/template_noop,
/area/shuttle/midway)
"Ds" = (
/obj/structure/stairs/perspective,
/obj/structure/platform{
	dir = 4;
	layer = 2.7
	},
/obj/structure/platform{
	dir = 8
	},
/turf/open/shuttle/dropship{
	icon_state = "rasputin3"
	},
/area/shuttle/midway)
"DH" = (
/obj/effect/decal/warning_stripes{
	icon_state = "S";
	pixel_y = 2
	},
/obj/effect/decal/warning_stripes{
	icon_state = "N";
	pixel_y = -1
	},
/turf/open/shuttle/dropship{
	icon_state = "rasputin14"
	},
/area/shuttle/midway)
"Ed" = (
/turf/closed/shuttle/midway{
	icon_state = "25"
	},
/area/shuttle/midway)
"EN" = (
/obj/structure/bed/chair/vehicle/dropship_cockpit/pilot{
	dir = 1;
	pixel_x = 6;
	pixel_y = 8
	},
/obj/structure/machinery/computer/shuttle/dropship/flight/small{
	pixel_y = 16;
	pixel_x = 6
	},
/obj/structure/phone_base{
	dir = 4;
	pixel_x = -19;
	pixel_y = 12;
	layer = 3.1;
	phone_category = "Dropship";
	name = "Midway telephone receiver";
	phone_id = "Midway"
	},
/turf/open/shuttle/dropship{
	icon_state = "rasputin15"
	},
/area/shuttle/midway)
"Fu" = (
/obj/structure/shuttle/part/midway/transparent{
	icon_state = "74"
	},
/turf/template_noop,
/area/shuttle/midway)
"Gf" = (
/obj/structure/shuttle/part/midway/transparent{
	icon_state = "99a"
	},
/turf/template_noop,
/area/shuttle/midway)
"Gh" = (
/turf/open/shuttle/dropship{
	icon_state = "rasputin7"
	},
/area/shuttle/midway)
"Go" = (
/obj/structure/stairs/perspective{
	dir = 1;
	icon_state = "p_stair_full";
	pixel_y = 22
	},
/obj/structure/machinery/computer/dropship_weapons/midway/small{
	pixel_y = 8;
	pixel_x = 8
	},
/obj/structure/bed/chair/vehicle/dropship_cockpit/copilot{
	dir = 1;
	pixel_x = 8;
	layer = 5
	},
/turf/open/shuttle/dropship{
	icon_state = "rasputin15"
	},
/area/shuttle/midway)
"Hj" = (
/turf/closed/shuttle/midway{
	icon_state = "75"
	},
/area/shuttle/midway)
"Hz" = (
/obj/structure/shuttle/part/midway/transparent{
	icon_state = "3"
	},
/turf/template_noop,
/area/shuttle/midway)
"HY" = (
/obj/effect/decal/warning_stripes{
	icon_state = "N";
	pixel_y = -1
	},
/obj/effect/decal/warning_stripes{
	icon_state = "S";
	pixel_y = 2
	},
/obj/structure/machinery/door/airlock/multi_tile/almayer/dropshiprear/ds4{
	id = "aft_door"
	},
/turf/open/shuttle/dropship{
	icon_state = "rasputin14"
	},
/area/shuttle/midway)
"Id" = (
/obj/effect/attach_point/crew_weapon/midway{
	attach_id = 7
	},
/turf/open/shuttle/dropship{
	icon_state = "rasputin15"
	},
/area/shuttle/midway)
"Ji" = (
/turf/closed/shuttle/midway{
	icon_state = "64"
	},
/area/shuttle/midway)
"Jq" = (
/turf/closed/shuttle/midway{
	icon_state = "72"
	},
/area/shuttle/midway)
"Ks" = (
/obj/structure/shuttle/part/midway/transparent{
	icon_state = "71"
	},
/turf/template_noop,
/area/shuttle/midway)
"Kv" = (
/obj/structure/machinery/light{
	dir = 4;
	pixel_x = 14
	},
/obj/structure/machinery/light/double{
	dir = 4
	},
/turf/open/shuttle/dropship{
	icon_state = "rasputin3"
	},
/area/shuttle/midway)
"Kw" = (
/turf/template_noop,
/area/template_noop)
"Lr" = (
/turf/closed/shuttle/midway{
	icon_state = "48"
	},
/area/shuttle/midway)
"LY" = (
/obj/structure/shuttle/part/midway/transparent{
	icon_state = "101"
	},
/turf/template_noop,
/area/shuttle/midway)
"LZ" = (
/obj/structure/shuttle/part/midway/transparent{
	icon_state = "84"
	},
/obj/effect/attach_point/electronics/midway,
/turf/template_noop,
/area/shuttle/midway)
"Mw" = (
/obj/structure/shuttle/part/midway/transparent{
	icon_state = "85"
	},
/obj/effect/attach_point/weapon/midway/left_fore,
/turf/template_noop,
/area/shuttle/midway)
"Mz" = (
/obj/structure/stairs/perspective,
/obj/structure/platform{
	dir = 8;
	layer = 2.7
	},
/obj/structure/platform{
	dir = 4
	},
/turf/open/shuttle/dropship{
	icon_state = "rasputin3"
	},
/area/shuttle/midway)
"ME" = (
/turf/open/shuttle/dropship{
	icon_state = "rasputin15"
	},
/area/shuttle/midway)
"Pc" = (
/turf/closed/shuttle/midway/transparent{
	icon_state = "78"
	},
/area/shuttle/midway)
"PP" = (
/obj/structure/blocker/forcefield/multitile_vehicles,
/obj/structure/machinery/door/airlock/hatch/cockpit/four,
/turf/open/shuttle/dropship{
	icon_state = "rasputin15"
	},
/area/shuttle/midway)
"Qk" = (
/obj/structure/shuttle/part/midway/transparent{
	icon_state = "15"
	},
/obj/structure/shuttle/part/midway/transparent{
	icon_state = "40"
	},
/turf/template_noop,
/area/shuttle/midway)
"QK" = (
/obj/structure/machinery/light/double{
	dir = 8
	},
/turf/open/shuttle/dropship{
	icon_state = "rasputin3"
	},
/area/shuttle/midway)
"Rm" = (
/obj/effect/attach_point/crew_weapon/midway{
	attach_id = 7
	},
/obj/docking_port/mobile/marine_dropship/midway,
/turf/open/shuttle/dropship{
	icon_state = "rasputin15"
	},
/area/shuttle/midway)
"SZ" = (
/obj/structure/shuttle/part/midway/transparent{
	icon_state = "5"
	},
/turf/template_noop,
/area/shuttle/midway)
"Tl" = (
/obj/structure/bed/chair/dropship/passenger{
	dir = 8
	},
/obj/structure/machinery/light/double{
	dir = 4;
	pixel_y = -5
	},
/turf/open/shuttle/dropship{
	icon_state = "rasputin15"
	},
/area/shuttle/midway)
"UI" = (
/obj/structure/shuttle/part/midway/transparent{
	icon_state = "90"
	},
/obj/effect/attach_point/weapon/midway/right_fore,
/turf/template_noop,
/area/shuttle/midway)
"Vu" = (
/turf/closed/shuttle/midway{
	icon_state = "67"
	},
/area/shuttle/midway)
"VU" = (
/turf/closed/shuttle/midway{
	icon_state = "73"
	},
/area/shuttle/midway)
"WN" = (
/turf/open/shuttle/dropship{
	icon_state = "floor8"
	},
/area/shuttle/midway)
"XH" = (
/obj/effect/attach_point/fuel/midway{
	pixel_x = -32;
	attach_id = 11
	},
/turf/closed/shuttle/midway/transparent{
	icon_state = "33"
	},
/area/shuttle/midway)
"Yr" = (
/turf/closed/shuttle/midway{
	icon_state = "81"
	},
/area/shuttle/midway)
"Zr" = (
/obj/structure/shuttle/part/midway/transparent{
	icon_state = "66"
	},
/turf/template_noop,
/area/shuttle/midway)
"Zu" = (
/turf/closed/shuttle/midway/transparent{
	icon_state = "29"
	},
/area/shuttle/midway)
"ZZ" = (
/turf/closed/shuttle/midway/transparent{
	icon_state = "39"
	},
/area/shuttle/midway)

(1,1,1) = {"
Kw
Kw
Kw
Kw
Kw
Ks
Zr
yO
Kw
ul
af
Cm
dD
BU
Kw
mE
"}
(2,1,1) = {"
Kw
Kw
Kw
LZ
Hj
Jq
Vu
xp
dE
gw
ls
Zu
zm
bm
Kw
eu
"}
(3,1,1) = {"
Kw
Kw
Kw
Mw
Yr
jy
Cc
dr
Cc
BI
dE
Bn
hl
rr
dB
Hz
"}
(4,1,1) = {"
Cr
hL
ti
vN
Pc
bs
jW
im
Ds
mL
jW
je
QK
HY
Kw
Kw
"}
(5,1,1) = {"
LY
tf
EN
Go
PP
WN
mR
WN
Rm
kC
ME
Id
ME
DH
Kw
Kw
"}
(6,1,1) = {"
go
Gf
od
ux
ro
Gh
jW
vJ
Mz
mL
jW
jW
Kv
DH
Kw
Kw
"}
(7,1,1) = {"
Kw
Kw
Kw
UI
rq
xy
iv
Tl
iv
Lr
yB
sl
Ed
lC
mh
yN
"}
(8,1,1) = {"
Kw
Kw
Kw
Aw
wB
VU
ym
Ji
yB
Qk
BS
rR
Db
BU
Kw
SZ
"}
(9,1,1) = {"
Kw
Kw
Kw
Kw
Kw
Fu
Dg
hO
Kw
mG
ZZ
XH
if
bm
Kw
tP
"}
