//MAP CONVERTED BY dmm2tgm.py THIS HEADER COMMENT PREVENTS RECONVERSION, DO NOT REMOVE
"aB" = (
/turf/open/shuttle/dropship/light_grey_bottom_right,
/area/shuttle/smartass)
"aH" = (
/obj/effect/attach_point/crew_weapon/smartass,
/turf/open/shuttle/dropship/medium_grey_single_wide_up_to_down,
/area/shuttle/smartass)
"bG" = (
/obj/effect/attach_point/fuel/smartass{
	dir = 1;
	attach_id = 10
	},
/turf/closed/shuttle/smartass{
	icon_state = "28"
	},
/area/shuttle/smartass)
"bN" = (
/turf/closed/shuttle/smartass{
	icon_state = "22"
	},
/area/shuttle/smartass)
"cb" = (
/obj/structure/machinery/cm_vending/sorted/medical/wall_med{
	pixel_y = 26;
	pixel_x = 10
	},
/obj/structure/extinguisher_cabinet/lifeboat{
	pixel_y = 27;
	pixel_x = -2
	},
/obj/structure/bed/chair/dropship/passenger{
	dir = 4
	},
/turf/open/shuttle/dropship/medium_grey_single_wide_up_to_down,
/area/shuttle/smartass)
"cD" = (
/turf/closed/shuttle/smartass{
	icon_state = "69"
	},
/area/shuttle/smartass)
"dI" = (
/obj/effect/decal/warning_stripes{
	icon_state = "S";
	pixel_y = 2
	},
/obj/effect/decal/warning_stripes{
	icon_state = "N";
	pixel_y = -1
	},
/turf/open/shuttle/dropship/medium_grey_single_wide_left_to_right,
/area/shuttle/smartass)
"dN" = (
/turf/closed/shuttle/smartass/transparent{
	icon_state = "97a"
	},
/area/shuttle/smartass)
"dX" = (
/obj/structure/bed/chair/dropship/passenger/folded{
	pixel_y = 8;
	buckling_y = 8
	},
/turf/open/shuttle/dropship/medium_grey_single_wide_up_to_down,
/area/shuttle/smartass)
"ed" = (
/turf/template_noop,
/area/space)
"eD" = (
/turf/closed/shuttle/smartass{
	icon_state = "30"
	},
/area/shuttle/smartass)
"eN" = (
/turf/closed/shuttle/smartass{
	icon_state = "73"
	},
/area/shuttle/smartass)
"eP" = (
/obj/structure/stairs/perspective,
/obj/structure/platform{
	dir = 4;
	layer = 2.7
	},
/obj/structure/platform{
	dir = 8
	},
/turf/open/shuttle/dropship/light_grey_single_wide_up_to_down,
/area/shuttle/smartass)
"fk" = (
/obj/structure/shuttle/part/smartass{
	icon_state = "61"
	},
/obj/effect/attach_point/weapon/smartass/left_wing,
/turf/template_noop,
/area/shuttle/smartass)
"fq" = (
/obj/structure/shuttle/part/smartass{
	icon_state = "5"
	},
/turf/template_noop,
/area/shuttle/smartass)
"fZ" = (
/obj/structure/shuttle/part/smartass{
	icon_state = "71"
	},
/turf/template_noop,
/area/shuttle/smartass)
"gO" = (
/turf/closed/shuttle/smartass{
	icon_state = "43"
	},
/area/shuttle/smartass)
"hx" = (
/turf/closed/shuttle/smartass{
	icon_state = "29"
	},
/area/shuttle/smartass)
"hS" = (
/turf/closed/shuttle/smartass/transparent{
	icon_state = "89b"
	},
/area/shuttle/smartass)
"ih" = (
/obj/structure/shuttle/part/smartass/transparent{
	icon_state = "95a"
	},
/turf/template_noop,
/area/shuttle/smartass)
"iS" = (
/obj/structure/shuttle/part/smartass/gunpod_prop,
/turf/template_noop,
/area/shuttle/smartass)
"jD" = (
/obj/structure/bed/chair/dropship/passenger{
	dir = 4
	},
/turf/open/shuttle/dropship/medium_grey_single_wide_up_to_down,
/area/shuttle/smartass)
"lj" = (
/obj/structure/shuttle/part/smartass{
	icon_state = "85"
	},
/obj/effect/attach_point/weapon/smartass/left_fore,
/turf/template_noop,
/area/shuttle/smartass)
"lv" = (
/turf/closed/shuttle/smartass/transparent{
	icon_state = "86a"
	},
/area/shuttle/smartass)
"ma" = (
/turf/closed/shuttle/smartass{
	icon_state = "83"
	},
/area/shuttle/smartass)
"mm" = (
/obj/structure/shuttle/part/smartass{
	icon_state = "17"
	},
/turf/template_noop,
/area/shuttle/smartass)
"mr" = (
/turf/closed/shuttle/smartass{
	icon_state = "26"
	},
/area/shuttle/smartass)
"nD" = (
/obj/structure/shuttle/part/smartass,
/turf/template_noop,
/area/shuttle/smartass)
"oF" = (
/obj/structure/shuttle/part/smartass{
	icon_state = "7"
	},
/turf/template_noop,
/area/shuttle/smartass)
"oU" = (
/turf/closed/shuttle/smartass{
	icon_state = "75"
	},
/area/shuttle/smartass)
"pw" = (
/turf/closed/shuttle/smartass{
	icon_state = "34"
	},
/area/shuttle/smartass)
"qf" = (
/obj/structure/shuttle/part/smartass{
	icon_state = "21"
	},
/turf/template_noop,
/area/shuttle/smartass)
"ql" = (
/obj/structure/stairs/perspective,
/obj/structure/platform{
	dir = 8;
	layer = 2.7
	},
/obj/structure/platform{
	dir = 4
	},
/turf/open/shuttle/dropship/light_grey_single_wide_up_to_down,
/area/shuttle/smartass)
"qo" = (
/obj/structure/shuttle/part/smartass{
	icon_state = "74"
	},
/turf/template_noop,
/area/shuttle/smartass)
"qH" = (
/turf/closed/shuttle/smartass{
	icon_state = "104"
	},
/area/shuttle/smartass)
"qR" = (
/obj/structure/machinery/light/double{
	dir = 8
	},
/turf/open/shuttle/dropship/light_grey_single_wide_up_to_down,
/area/shuttle/smartass)
"sb" = (
/obj/structure/shuttle/part/dropship2/transparent/engine_left_cap{
	name = "\improper Smart Ass"
	},
/turf/template_noop,
/area/shuttle/smartass)
"sD" = (
/turf/closed/shuttle/smartass{
	icon_state = "42"
	},
/area/shuttle/smartass)
"tD" = (
/turf/closed/shuttle/smartass{
	icon_state = "24"
	},
/area/shuttle/smartass)
"vJ" = (
/obj/structure/shuttle/part/smartass{
	icon_state = "84"
	},
/obj/effect/attach_point/electronics/tripoli,
/turf/template_noop,
/area/shuttle/smartass)
"wy" = (
/obj/structure/shuttle/part/smartass{
	icon_state = "65"
	},
/obj/effect/attach_point/weapon/smartass/right_wing,
/turf/template_noop,
/area/shuttle/smartass)
"wN" = (
/obj/structure/shuttle/part/smartass{
	icon_state = "46"
	},
/obj/structure/shuttle/part/dropship2/transparent/engine_right_cap{
	name = "\improper Smart Ass"
	},
/turf/template_noop,
/area/shuttle/smartass)
"xx" = (
/obj/structure/shuttle/part/smartass{
	icon_state = "6"
	},
/turf/template_noop,
/area/shuttle/smartass)
"ye" = (
/turf/open/shuttle/dropship/light_grey_top_right,
/area/shuttle/smartass)
"yB" = (
/obj/structure/shuttle/part/smartass{
	icon_state = "4"
	},
/turf/template_noop,
/area/shuttle/smartass)
"yS" = (
/obj/docking_port/mobile/marine_dropship/smartass,
/obj/effect/attach_point/crew_weapon/smartass,
/turf/open/shuttle/dropship/medium_grey_single_wide_up_to_down,
/area/shuttle/smartass)
"zl" = (
/turf/open/shuttle/dropship/light_grey_bottom_left,
/area/shuttle/smartass)
"zu" = (
/obj/structure/shuttle/part/smartass/transparent/nosecone{
	icon_state = "102"
	},
/turf/template_noop,
/area/shuttle/smartass)
"zB" = (
/turf/open/shuttle/dropship/light_grey_single_wide_left_to_right,
/area/shuttle/smartass)
"zC" = (
/turf/closed/shuttle/smartass{
	icon_state = "72"
	},
/area/shuttle/smartass)
"zS" = (
/obj/structure/shuttle/part/smartass{
	icon_state = "16"
	},
/turf/template_noop,
/area/shuttle/smartass)
"zX" = (
/obj/structure/shuttle/part/smartass{
	icon_state = "91"
	},
/obj/effect/attach_point/electronics/smartass,
/turf/template_noop,
/area/shuttle/smartass)
"Ac" = (
/turf/closed/shuttle/smartass/transparent{
	icon_state = "86b"
	},
/area/shuttle/smartass)
"Bg" = (
/obj/structure/phone_base{
	dir = 4;
	pixel_x = -19;
	pixel_y = 12;
	layer = 3.1;
	phone_category = "Dropship";
	name = "Smart Ass telephone receiver";
	phone_id = "Smart Ass"
	},
/obj/structure/bed/chair/vehicle/dropship_cockpit/pilot{
	dir = 1;
	pixel_x = 6;
	pixel_y = 8
	},
/obj/structure/machinery/computer/shuttle/dropship/flight/small{
	pixel_y = 16;
	pixel_x = 6
	},
/turf/open/shuttle/dropship/medium_grey_single_wide_up_to_down,
/area/shuttle/smartass)
"Bz" = (
/obj/structure/machinery/camera/autoname/sulaco/smartass{
	dir = 4
	},
/turf/open/shuttle/dropship/light_grey_single_wide_up_to_down,
/area/shuttle/smartass)
"Cb" = (
/obj/structure/shuttle/part/smartass{
	icon_state = "8"
	},
/turf/template_noop,
/area/shuttle/smartass)
"Cf" = (
/obj/structure/shuttle/part/smartass{
	icon_state = "3"
	},
/turf/template_noop,
/area/shuttle/smartass)
"Cu" = (
/obj/structure/extinguisher_cabinet/lifeboat,
/obj/structure/bed/chair/dropship/passenger{
	dir = 8
	},
/obj/structure/machinery/cm_vending/sorted/medical/wall_med{
	pixel_y = 26;
	pixel_x = -10
	},
/obj/structure/machinery/camera/autoname/sulaco/smartass,
/turf/open/shuttle/dropship/medium_grey_single_wide_up_to_down,
/area/shuttle/smartass)
"CD" = (
/obj/structure/machinery/light/double{
	dir = 4
	},
/obj/structure/bed/chair/dropship/passenger{
	dir = 8
	},
/turf/open/shuttle/dropship/medium_grey_single_wide_up_to_down,
/area/shuttle/smartass)
"CX" = (
/turf/open/shuttle/dropship/medium_grey_single_wide_up_to_down,
/area/shuttle/smartass)
"Dy" = (
/obj/structure/machinery/light/double{
	dir = 4
	},
/turf/open/shuttle/dropship/light_grey_single_wide_up_to_down,
/area/shuttle/smartass)
"DG" = (
/turf/closed/shuttle/smartass/transparent{
	icon_state = "78"
	},
/area/shuttle/smartass)
"DW" = (
/turf/closed/shuttle/smartass{
	icon_state = "35"
	},
/area/shuttle/smartass)
"Eb" = (
/turf/closed/shuttle/smartass{
	icon_state = "36"
	},
/area/shuttle/smartass)
"Eq" = (
/turf/open/shuttle/dropship/light_grey_top_left,
/area/shuttle/smartass)
"Ev" = (
/turf/closed/shuttle/smartass{
	icon_state = "23"
	},
/area/shuttle/smartass)
"Ew" = (
/turf/closed/shuttle/smartass{
	icon_state = "67"
	},
/area/shuttle/smartass)
"EM" = (
/turf/closed/shuttle/smartass{
	icon_state = "103"
	},
/area/shuttle/smartass)
"Fm" = (
/obj/structure/shuttle/part/smartass{
	icon_state = "70"
	},
/turf/template_noop,
/area/shuttle/smartass)
"Go" = (
/obj/structure/shuttle/part/smartass{
	icon_state = "2"
	},
/turf/template_noop,
/area/shuttle/smartass)
"Gt" = (
/turf/closed/shuttle/smartass/transparent{
	icon_state = "80"
	},
/area/shuttle/smartass)
"Jr" = (
/obj/structure/platform_decoration{
	dir = 8
	},
/obj/effect/decal/warning_stripes{
	icon_state = "N";
	pixel_y = 1
	},
/obj/structure/platform_decoration{
	dir = 4
	},
/turf/open/shuttle/dropship/light_grey_single_wide_up_to_down,
/area/shuttle/smartass)
"JC" = (
/turf/closed/shuttle/smartass{
	icon_state = "31"
	},
/area/shuttle/smartass)
"JV" = (
/obj/structure/platform_decoration{
	dir = 4
	},
/obj/effect/decal/warning_stripes{
	icon_state = "N";
	pixel_y = 1
	},
/obj/structure/platform_decoration{
	dir = 8
	},
/turf/open/shuttle/dropship/light_grey_single_wide_up_to_down,
/area/shuttle/smartass)
"Kj" = (
/turf/closed/shuttle/smartass{
	icon_state = "77"
	},
/area/shuttle/smartass)
"KU" = (
/obj/structure/shuttle/part/smartass{
	icon_state = "20"
	},
/turf/template_noop,
/area/shuttle/smartass)
"Ly" = (
/turf/closed/shuttle/smartass{
	icon_state = "25"
	},
/area/shuttle/smartass)
"Mh" = (
/turf/closed/shuttle/smartass{
	icon_state = "32"
	},
/area/shuttle/smartass)
"NV" = (
/turf/closed/shuttle/smartass{
	icon_state = "38"
	},
/area/shuttle/smartass)
"Oa" = (
/turf/closed/shuttle/smartass{
	icon_state = "62"
	},
/area/shuttle/smartass)
"Ot" = (
/obj/structure/blocker/forcefield/multitile_vehicles,
/obj/structure/machinery/door/airlock/hatch/cockpit{
	dir = 1
	},
/turf/open/shuttle/dropship/medium_grey_single_wide_up_to_down,
/area/shuttle/smartass)
"OF" = (
/turf/closed/shuttle/smartass{
	icon_state = "39"
	},
/area/shuttle/smartass)
"OI" = (
/obj/structure/shuttle/part/smartass{
	icon_state = "49"
	},
/obj/structure/shuttle/part/dropship2/transparent/engine_left_cap{
	name = "\improper Smart Ass"
	},
/turf/template_noop,
/area/shuttle/smartass)
"OM" = (
/obj/structure/shuttle/part/smartass{
	icon_state = "90"
	},
/obj/effect/attach_point/weapon/smartass/right_fore,
/turf/template_noop,
/area/shuttle/smartass)
"QE" = (
/obj/structure/platform{
	dir = 1
	},
/obj/effect/decal/warning_stripes{
	icon_state = "N";
	pixel_y = 1
	},
/obj/structure/blocker/forcefield/multitile_vehicles,
/turf/open/shuttle/dropship/medium_grey_single_wide_up_to_down,
/area/shuttle/smartass)
"Rd" = (
/obj/structure/shuttle/part/smartass/transparent/nosecone{
	icon_state = "100"
	},
/turf/template_noop,
/area/shuttle/smartass)
"RD" = (
/turf/closed/shuttle/smartass/transparent{
	icon_state = "89a"
	},
/area/shuttle/smartass)
"Sl" = (
/obj/effect/decal/warning_stripes{
	icon_state = "N";
	pixel_y = -1
	},
/obj/effect/decal/warning_stripes{
	icon_state = "S";
	pixel_y = 2
	},
/obj/structure/machinery/door/airlock/multi_tile/almayer/dropshiprear/ds6,
/turf/open/shuttle/dropship/medium_grey_single_wide_left_to_right,
/area/shuttle/smartass)
"Sr" = (
/turf/closed/shuttle/smartass{
	icon_state = "47"
	},
/area/shuttle/smartass)
"SW" = (
/turf/closed/shuttle/smartass{
	icon_state = "48"
	},
/area/shuttle/smartass)
"Ur" = (
/obj/structure/shuttle/part/smartass{
	icon_state = "66"
	},
/turf/template_noop,
/area/shuttle/smartass)
"Us" = (
/obj/structure/shuttle/part/dropship2/transparent/engine_right_cap{
	name = "\improper Smart Ass"
	},
/turf/template_noop,
/area/shuttle/smartass)
"VM" = (
/obj/structure/machinery/light/double{
	dir = 8
	},
/obj/structure/bed/chair/dropship/passenger{
	dir = 4
	},
/turf/open/shuttle/dropship/medium_grey_single_wide_up_to_down,
/area/shuttle/smartass)
"VP" = (
/obj/effect/attach_point/fuel/smartass{
	attach_id = 11;
	dir = 1;
	pixel_x = -32
	},
/turf/closed/shuttle/smartass{
	icon_state = "33"
	},
/area/shuttle/smartass)
"VR" = (
/turf/closed/shuttle/smartass{
	icon_state = "64"
	},
/area/shuttle/smartass)
"WS" = (
/obj/structure/shuttle/part/smartass/transparent{
	icon_state = "99a"
	},
/turf/template_noop,
/area/shuttle/smartass)
"Xr" = (
/obj/structure/stairs/perspective{
	dir = 1;
	icon_state = "p_stair_full";
	pixel_y = 22
	},
/obj/structure/bed/chair/vehicle/dropship_cockpit/copilot{
	dir = 1;
	pixel_x = 8;
	layer = 5
	},
/obj/structure/machinery/computer/dropship_weapons/smartass/small{
	pixel_x = 8;
	pixel_y = 8
	},
/turf/open/shuttle/dropship/medium_grey_single_wide_up_to_down,
/area/shuttle/smartass)
"XI" = (
/turf/closed/shuttle/smartass{
	icon_state = "27"
	},
/area/shuttle/smartass)
"XT" = (
/obj/structure/bed/chair/dropship/passenger{
	dir = 8
	},
/turf/open/shuttle/dropship/medium_grey_single_wide_up_to_down,
/area/shuttle/smartass)
"Zf" = (
/turf/closed/shuttle/smartass{
	icon_state = "37"
	},
/area/shuttle/smartass)
"ZQ" = (
/turf/open/shuttle/dropship/light_grey_single_wide_up_to_down,
/area/shuttle/smartass)
"ZW" = (
/turf/closed/shuttle/smartass{
	icon_state = "81"
	},
/area/shuttle/smartass)

(1,1,1) = {"
ed
ed
ed
ed
ed
fZ
Ur
fk
ed
sb
pw
bG
bN
zS
ed
nD
"}
(2,1,1) = {"
ed
ed
ed
vJ
oU
zC
Ew
Oa
sD
wN
DW
hx
Ev
mm
ed
Go
"}
(3,1,1) = {"
ed
ed
ed
lj
Kj
cb
VM
jD
jD
Sr
Eb
eD
tD
EM
oF
Cf
"}
(4,1,1) = {"
Rd
ih
Ac
lv
DG
Eq
ZQ
zl
eP
Jr
qR
Bz
ZQ
Sl
ed
ed
"}
(5,1,1) = {"
iS
dN
Bg
Xr
Ot
zB
dX
zB
yS
QE
CX
aH
CX
dI
ed
ed
"}
(6,1,1) = {"
zu
WS
hS
RD
Gt
ye
ZQ
aB
ql
JV
Dy
ZQ
ZQ
dI
ed
ed
"}
(7,1,1) = {"
ed
ed
ed
OM
ZW
Cu
CD
XT
XT
SW
Zf
JC
Ly
qH
Cb
yB
"}
(8,1,1) = {"
ed
ed
ed
zX
ma
eN
cD
VR
gO
OI
NV
Mh
mr
KU
ed
fq
"}
(9,1,1) = {"
ed
ed
ed
ed
ed
qo
Fm
wy
ed
Us
OF
VP
XI
qf
ed
xx
"}
