//MAP CONVERTED BY dmm2tgm.py THIS HEADER COMMENT PREVENTS RECONVERSION, DO NOT REMOVE
"aX" = (
/turf/template_noop,
/area/space)
"bi" = (
/obj/structure/stairs/perspective{
	dir = 1;
	icon_state = "p_stair_full";
	pixel_y = 22
	},
/obj/structure/bed/chair/vehicle/dropship_cockpit/copilot{
	dir = 1;
	pixel_x = 8;
	layer = 5
	},
/obj/structure/machinery/computer/dropship_weapons/typhoon/small{
	pixel_x = 8;
	pixel_y = 8
	},
/turf/open/shuttle/dropship/medium_grey_single_wide_up_to_down,
/area/shuttle/tornado{
	base_lighting_alpha = 0
	})
"bs" = (
/obj/structure/shuttle/part/tornado/transparent{
	icon_state = "26"
	},
/turf/template_noop,
/area/shuttle/tornado{
	base_lighting_alpha = 0
	})
"cg" = (
/obj/structure/shuttle/part/typhoon/transparent{
	icon_state = "66"
	},
/turf/template_noop,
/area/shuttle/tornado{
	base_lighting_alpha = 0
	})
"dV" = (
/turf/closed/shuttle/typhoon{
	icon_state = "75"
	},
/area/shuttle/tornado{
	base_lighting_alpha = 0
	})
"et" = (
/turf/closed/shuttle/typhoon{
	icon_state = "77"
	},
/area/shuttle/tornado{
	base_lighting_alpha = 0
	})
"fJ" = (
/obj/structure/shuttle/part/typhoon/transparent{
	icon_state = "99a";
	layer = 2.97
	},
/turf/template_noop,
/area/shuttle/tornado{
	base_lighting_alpha = 0
	})
"fZ" = (
/obj/structure/platform_decoration{
	dir = 8
	},
/obj/structure/platform_decoration{
	dir = 4
	},
/turf/open/shuttle/dropship/medium_grey_single_wide_up_to_down,
/area/shuttle/tornado{
	base_lighting_alpha = 0
	})
"gn" = (
/turf/open/shuttle/dropship/medium_grey_single_wide_up_to_down,
/area/shuttle/tornado{
	base_lighting_alpha = 0
	})
"gw" = (
/obj/structure/shuttle/part/tornado/transparent{
	icon_state = "27"
	},
/turf/template_noop,
/area/shuttle/tornado{
	base_lighting_alpha = 0
	})
"gx" = (
/turf/closed/shuttle/typhoon{
	icon_state = "47"
	},
/area/shuttle/tornado{
	base_lighting_alpha = 0
	})
"gN" = (
/turf/closed/shuttle/typhoon{
	icon_state = "24"
	},
/area/shuttle/tornado{
	base_lighting_alpha = 0
	})
"gY" = (
/turf/closed/shuttle/typhoon{
	icon_state = "67"
	},
/area/shuttle/tornado{
	base_lighting_alpha = 0
	})
"hS" = (
/obj/structure/bed/chair/dropship/passenger{
	dir = 4
	},
/turf/open/shuttle/dropship/medium_grey_single_wide_up_to_down,
/area/shuttle/tornado{
	base_lighting_alpha = 0
	})
"is" = (
/obj/structure/machinery/light/double{
	dir = 8;
	pixel_y = -5
	},
/turf/open/shuttle/dropship/medium_grey_single_wide_up_to_down,
/area/shuttle/tornado{
	base_lighting_alpha = 0
	})
"kC" = (
/obj/structure/machinery/camera/autoname/golden_arrow/typhoon{
	dir = 8;
	pixel_x = 24
	},
/turf/open/shuttle/dropship/medium_grey_single_wide_up_to_down,
/area/shuttle/tornado{
	base_lighting_alpha = 0
	})
"lA" = (
/turf/closed/shuttle/typhoon{
	icon_state = "73"
	},
/area/shuttle/tornado{
	base_lighting_alpha = 0
	})
"lM" = (
/turf/closed/shuttle/typhoon{
	icon_state = "48"
	},
/area/shuttle/tornado{
	base_lighting_alpha = 0
	})
"mE" = (
/turf/open/shuttle/dropship/light_grey_bottom_left,
/area/shuttle/tornado{
	base_lighting_alpha = 0
	})
"nM" = (
/turf/closed/shuttle/typhoon{
	icon_state = "64"
	},
/area/shuttle/tornado{
	base_lighting_alpha = 0
	})
"of" = (
/turf/closed/shuttle/typhoon{
	icon_state = "25"
	},
/area/shuttle/tornado{
	base_lighting_alpha = 0
	})
"oH" = (
/obj/structure/shuttle/part/typhoon/transparent{
	icon_state = "95a"
	},
/turf/template_noop,
/area/shuttle/tornado{
	base_lighting_alpha = 0
	})
"pQ" = (
/obj/structure/phone_base{
	dir = 4;
	pixel_x = -19;
	pixel_y = 12;
	layer = 3.1;
	phone_category = "Dropship";
	name = "Typhoon telephone receiver";
	phone_id = "Typhoon"
	},
/obj/structure/bed/chair/vehicle/dropship_cockpit/pilot{
	dir = 1;
	pixel_x = 6;
	pixel_y = 8
	},
/obj/structure/machinery/computer/shuttle/dropship/flight/small{
	pixel_y = 16;
	pixel_x = 6
	},
/obj/structure/machinery/light/small{
	light_color = "#C02526";
	color = "#C02526";
	dir = 4;
	pixel_y = 15;
	breakable = 0
	},
/turf/open/shuttle/dropship/medium_grey_single_wide_up_to_down,
/area/shuttle/tornado{
	base_lighting_alpha = 0
	})
"qH" = (
/obj/structure/machinery/cm_vending/sorted/medical/wall_med/limited{
	pixel_y = 25
	},
/obj/structure/bed/chair/dropship/passenger/folded{
	dir = 4;
	buckling_y = 3;
	pixel_y = 3
	},
/turf/open/shuttle/dropship/light_grey_top_right,
/area/shuttle/tornado{
	base_lighting_alpha = 0
	})
"rb" = (
/turf/closed/shuttle/typhoon{
	icon_state = "104"
	},
/area/shuttle/tornado{
	base_lighting_alpha = 0
	})
"rO" = (
/turf/closed/shuttle/typhoon{
	icon_state = "72"
	},
/area/shuttle/tornado{
	base_lighting_alpha = 0
	})
"tf" = (
/obj/structure/machinery/light/double{
	dir = 4;
	pixel_y = -5
	},
/obj/structure/surface/table/almayer,
/obj/item/storage/surgical_tray/empty,
/obj/item/reagent_container/hypospray/autoinjector/oxycodone{
	pixel_y = 9;
	pixel_x = -3
	},
/turf/open/shuttle/dropship/medium_grey_single_wide_up_to_down,
/area/shuttle/tornado{
	base_lighting_alpha = 0
	})
"uS" = (
/obj/structure/shuttle/part/typhoon/transparent{
	icon_state = "3"
	},
/turf/template_noop,
/area/shuttle/tornado{
	base_lighting_alpha = 0
	})
"vO" = (
/obj/structure/shuttle/part/typhoon/transparent{
	icon_state = "41";
	density = 0;
	layer = 4.2
	},
/obj/structure/shuttle/part/typhoon/transparent{
	icon_state = "61"
	},
/turf/template_noop,
/area/shuttle/tornado{
	base_lighting_alpha = 0
	})
"wd" = (
/turf/closed/shuttle/typhoon{
	icon_state = "36"
	},
/area/shuttle/tornado{
	base_lighting_alpha = 0
	})
"wI" = (
/obj/structure/shuttle/part/typhoon/transparent{
	icon_state = "16"
	},
/turf/template_noop,
/area/shuttle/tornado{
	base_lighting_alpha = 0
	})
"wO" = (
/obj/structure/machinery/light/double{
	dir = 8;
	pixel_y = -5
	},
/obj/structure/bed/chair/dropship/passenger{
	dir = 4
	},
/turf/open/shuttle/dropship/medium_grey_single_wide_up_to_down,
/area/shuttle/tornado{
	base_lighting_alpha = 0
	})
"xq" = (
/turf/closed/shuttle/typhoon{
	icon_state = "69"
	},
/area/shuttle/tornado{
	base_lighting_alpha = 0
	})
"xP" = (
/obj/structure/blocker/forcefield/multitile_vehicles,
/obj/structure/machinery/door/airlock/hatch/cockpit/three{
	dir = 1
	},
/turf/open/shuttle/dropship/medium_grey_single_wide_up_to_down,
/area/shuttle/tornado{
	base_lighting_alpha = 0
	})
"yk" = (
/turf/closed/shuttle/typhoon/transparent{
	icon_state = "89a"
	},
/area/shuttle/tornado{
	base_lighting_alpha = 0
	})
"yE" = (
/obj/structure/shuttle/part/typhoon/transparent{
	icon_state = "41";
	density = 0;
	layer = 4.2
	},
/turf/template_noop,
/area/shuttle/tornado{
	base_lighting_alpha = 0
	})
"zj" = (
/obj/structure/machinery/computer/overwatch/toc{
	pixel_y = 14
	},
/obj/structure/surface/table/reinforced/toc/west{
	pixel_y = -7
	},
/obj/structure/machinery/prop/almayer/CICmap/arc{
	pixel_y = 9;
	pixel_x = -9
	},
/obj/structure/machinery/computer/railgun/toc{
	pixel_y = 14;
	pixel_x = 7
	},
/turf/open/shuttle/dropship/medium_grey_single_wide_up_to_down,
/area/shuttle/tornado{
	base_lighting_alpha = 0
	})
"zS" = (
/turf/closed/shuttle/typhoon/transparent{
	icon_state = "89b"
	},
/area/shuttle/tornado{
	base_lighting_alpha = 0
	})
"Au" = (
/obj/structure/shuttle/part/typhoon/transparent{
	icon_state = "5"
	},
/turf/template_noop,
/area/shuttle/tornado{
	base_lighting_alpha = 0
	})
"Bz" = (
/obj/structure/shuttle/part/tornado/transparent{
	icon_state = "23"
	},
/obj/structure/shuttle/part/typhoon/transparent{
	icon_state = "23"
	},
/turf/template_noop,
/area/shuttle/tornado{
	base_lighting_alpha = 0
	})
"BL" = (
/obj/effect/attach_point/crew_weapon/typhoon,
/turf/open/shuttle/dropship/light_grey_single_wide_up_to_down,
/area/shuttle/tornado{
	base_lighting_alpha = 0
	})
"BO" = (
/obj/structure/shuttle/part/tornado/transparent{
	icon_state = "15"
	},
/turf/template_noop,
/area/shuttle/tornado{
	base_lighting_alpha = 0
	})
"BP" = (
/obj/structure/shuttle/part/typhoon/transparent{
	icon_state = "17"
	},
/turf/template_noop,
/area/shuttle/tornado{
	base_lighting_alpha = 0
	})
"Cl" = (
/obj/structure/shuttle/part/typhoon/transparent{
	icon_state = "6"
	},
/turf/template_noop,
/area/shuttle/tornado{
	base_lighting_alpha = 0
	})
"CD" = (
/obj/structure/bed/chair/dropship/passenger/folded{
	pixel_y = 8;
	buckling_y = 8
	},
/turf/open/shuttle/dropship/medium_grey_single_wide_up_to_down,
/area/shuttle/tornado{
	base_lighting_alpha = 0
	})
"CE" = (
/turf/closed/shuttle/typhoon/transparent{
	icon_state = "86b"
	},
/area/shuttle/tornado{
	base_lighting_alpha = 0
	})
"CI" = (
/obj/structure/stairs/perspective{
	icon_state = "p_stair_full";
	can_block_movement = 0
	},
/obj/structure/platform{
	dir = 4
	},
/obj/structure/platform{
	dir = 8
	},
/turf/open/shuttle/dropship/medium_grey_single_wide_up_to_down,
/area/shuttle/tornado{
	base_lighting_alpha = 0
	})
"CW" = (
/obj/structure/machinery/light/double{
	dir = 4;
	pixel_y = -5
	},
/obj/structure/bed/chair/dropship/passenger{
	dir = 8
	},
/turf/open/shuttle/dropship/medium_grey_single_wide_up_to_down,
/area/shuttle/tornado{
	base_lighting_alpha = 0
	})
"Da" = (
/obj/structure/bed/portable_surgery{
	pixel_y = 5
	},
/obj/structure/machinery/iv_drip{
	pixel_y = 26;
	layer = 2.9
	},
/obj/structure/curtain/medical,
/turf/open/shuttle/dropship/medium_grey_single_wide_up_to_down,
/area/shuttle/tornado{
	base_lighting_alpha = 0
	})
"De" = (
/obj/structure/machinery/camera/autoname/golden_arrow/typhoon{
	pixel_y = 32
	},
/obj/structure/surface/table/reinforced/toc/east{
	pixel_y = -7
	},
/obj/structure/machinery/computer/railgun/gatling/toc{
	pixel_y = 13;
	pixel_x = -7
	},
/obj/structure/phone_base/toc{
	pixel_y = 13;
	pixel_x = 11;
	phone_id = "Typhoon Overwatch";
	phone_category = "Overwatch";
	name = "Typhoon overwatch telephone receiver"
	},
/turf/open/shuttle/dropship/light_grey_top_left,
/area/shuttle/tornado{
	base_lighting_alpha = 0
	})
"Dl" = (
/turf/closed/shuttle/typhoon{
	icon_state = "83"
	},
/area/shuttle/tornado{
	base_lighting_alpha = 0
	})
"Du" = (
/obj/docking_port/mobile/marine_dropship/typhoon,
/obj/structure/bed/chair/dropship/passenger/folded{
	pixel_y = 8;
	buckling_y = 8
	},
/turf/open/shuttle/dropship/medium_grey_single_wide_up_to_down,
/area/shuttle/tornado{
	base_lighting_alpha = 0
	})
"Dv" = (
/obj/structure/shuttle/part/typhoon/transparent{
	icon_state = "32"
	},
/turf/template_noop,
/area/shuttle/tornado{
	base_lighting_alpha = 0
	})
"Fm" = (
/turf/closed/shuttle/typhoon/transparent{
	icon_state = "86a"
	},
/area/shuttle/tornado{
	base_lighting_alpha = 0
	})
"Gv" = (
/obj/structure/shuttle/part/typhoon/transparent{
	icon_state = "70"
	},
/turf/template_noop,
/area/shuttle/tornado{
	base_lighting_alpha = 0
	})
"HJ" = (
/obj/structure/shuttle/part/typhoon/transparent{
	icon_state = "32"
	},
/obj/effect/attach_point/fuel/typhoon{
	layer = 3.1;
	dir = 1
	},
/turf/template_noop,
/area/shuttle/tornado{
	base_lighting_alpha = 0
	})
"IR" = (
/obj/structure/shuttle/part/typhoon/transparent/nosecone{
	icon_state = "100"
	},
/turf/template_noop,
/area/shuttle/tornado{
	base_lighting_alpha = 0
	})
"IT" = (
/obj/structure/shuttle/part/typhoon/transparent{
	icon_state = "40";
	density = 0;
	layer = 4.2
	},
/turf/template_noop,
/area/shuttle/tornado{
	base_lighting_alpha = 0
	})
"IX" = (
/obj/structure/shuttle/part/typhoon/transparent{
	icon_state = "26"
	},
/turf/template_noop,
/area/shuttle/tornado{
	base_lighting_alpha = 0
	})
"Jb" = (
/obj/structure/shuttle/part/typhoon/transparent{
	icon_state = "33"
	},
/turf/template_noop,
/area/shuttle/tornado{
	base_lighting_alpha = 0
	})
"Jm" = (
/obj/structure/bed/chair/dropship/passenger{
	dir = 8
	},
/turf/open/shuttle/dropship/medium_grey_single_wide_up_to_down,
/area/shuttle/tornado{
	base_lighting_alpha = 0
	})
"JT" = (
/obj/structure/shuttle/part/typhoon/transparent{
	icon_state = "23"
	},
/turf/template_noop,
/area/shuttle/tornado{
	base_lighting_alpha = 0
	})
"KN" = (
/turf/open/shuttle/dropship/light_grey_single_wide_left_to_right,
/area/shuttle/tornado{
	base_lighting_alpha = 0
	})
"KW" = (
/obj/structure/bed/chair/dropship/passenger{
	dir = 8
	},
/obj/structure/barricade/handrail{
	dir = 1
	},
/turf/open/shuttle/dropship/medium_grey_single_wide_up_to_down,
/area/shuttle/tornado{
	base_lighting_alpha = 0
	})
"KX" = (
/obj/structure/shuttle/part/typhoon/transparent{
	icon_state = "22"
	},
/turf/template_noop,
/area/shuttle/tornado{
	base_lighting_alpha = 0
	})
"Lj" = (
/obj/structure/shuttle/part/typhoon/transparent{
	icon_state = "4"
	},
/turf/template_noop,
/area/shuttle/tornado{
	base_lighting_alpha = 0
	})
"LB" = (
/obj/structure/machinery/light/double{
	dir = 8;
	pixel_y = -5
	},
/obj/structure/bed/chair/vehicle/toc{
	dir = 1;
	pixel_y = 19;
	pixel_x = 16
	},
/turf/open/shuttle/dropship/medium_grey_single_wide_up_to_down,
/area/shuttle/tornado{
	base_lighting_alpha = 0
	})
"Mj" = (
/obj/effect/attach_point/crew_weapon/typhoon,
/turf/open/shuttle/dropship/medium_grey_single_wide_up_to_down,
/area/shuttle/tornado{
	base_lighting_alpha = 0
	})
"Mp" = (
/obj/structure/shuttle/part/typhoon/gunpod_prop,
/turf/template_noop,
/area/shuttle/tornado{
	base_lighting_alpha = 0
	})
"Ms" = (
/obj/structure/machinery/light/double{
	dir = 4;
	pixel_y = -5
	},
/turf/open/shuttle/dropship/medium_grey_single_wide_up_to_down,
/area/shuttle/tornado{
	base_lighting_alpha = 0
	})
"MB" = (
/turf/closed/shuttle/typhoon/transparent{
	icon_state = "97a"
	},
/area/shuttle/tornado{
	base_lighting_alpha = 0
	})
"Nf" = (
/obj/effect/decal/warning_stripes{
	icon_state = "S";
	pixel_y = 2
	},
/obj/effect/decal/warning_stripes{
	icon_state = "N";
	pixel_y = -1
	},
/turf/open/shuttle/dropship/medium_grey_single_wide_left_to_right,
/area/shuttle/tornado{
	base_lighting_alpha = 0
	})
"Oc" = (
/obj/structure/shuttle/part/typhoon/transparent{
	icon_state = "28"
	},
/obj/effect/attach_point/fuel/typhoon{
	layer = 3.1;
	dir = 1
	},
/turf/template_noop,
/area/shuttle/tornado{
	base_lighting_alpha = 0
	})
"Oh" = (
/turf/closed/shuttle/typhoon{
	icon_state = "103"
	},
/area/shuttle/tornado{
	base_lighting_alpha = 0
	})
"Or" = (
/turf/closed/shuttle/typhoon{
	icon_state = "82"
	},
/area/shuttle/tornado{
	base_lighting_alpha = 0
	})
"OE" = (
/obj/structure/shuttle/part/typhoon/transparent/nosecone{
	icon_state = "102"
	},
/turf/template_noop,
/area/shuttle/tornado{
	base_lighting_alpha = 0
	})
"OV" = (
/obj/structure/shuttle/part/tornado/transparent{
	icon_state = "28"
	},
/turf/template_noop,
/area/shuttle/tornado{
	base_lighting_alpha = 0
	})
"Qi" = (
/obj/structure/shuttle/part/typhoon/transparent{
	icon_state = "38"
	},
/turf/template_noop,
/area/shuttle/tornado{
	base_lighting_alpha = 0
	})
"QF" = (
/turf/closed/shuttle/typhoon{
	icon_state = "62"
	},
/area/shuttle/tornado{
	base_lighting_alpha = 0
	})
"Rb" = (
/obj/structure/shuttle/part/typhoon/transparent{
	icon_state = "29"
	},
/turf/template_noop,
/area/shuttle/tornado{
	base_lighting_alpha = 0
	})
"Re" = (
/obj/structure/platform{
	dir = 1
	},
/obj/structure/blocker/forcefield/multitile_vehicles,
/turf/open/shuttle/dropship/light_grey_single_wide_up_to_down,
/area/shuttle/tornado{
	base_lighting_alpha = 0
	})
"Rg" = (
/obj/structure/platform_decoration{
	dir = 4
	},
/obj/structure/platform_decoration{
	dir = 8
	},
/turf/open/shuttle/dropship/medium_grey_single_wide_up_to_down,
/area/shuttle/tornado{
	base_lighting_alpha = 0
	})
"Rw" = (
/turf/closed/shuttle/typhoon{
	icon_state = "31"
	},
/area/shuttle/tornado{
	base_lighting_alpha = 0
	})
"RB" = (
/obj/structure/shuttle/part/typhoon/transparent{
	icon_state = "39"
	},
/turf/template_noop,
/area/shuttle/tornado{
	base_lighting_alpha = 0
	})
"RH" = (
/obj/structure/shuttle/part/typhoon/transparent{
	icon_state = "27"
	},
/turf/template_noop,
/area/shuttle/tornado{
	base_lighting_alpha = 0
	})
"Sc" = (
/obj/structure/shuttle/part/typhoon/transparent{
	icon_state = "74"
	},
/turf/template_noop,
/area/shuttle/tornado{
	base_lighting_alpha = 0
	})
"Sz" = (
/turf/open/shuttle/dropship/light_grey_single_wide_up_to_down,
/area/shuttle/tornado{
	base_lighting_alpha = 0
	})
"Tc" = (
/obj/structure/shuttle/part/tornado/transparent{
	icon_state = "29"
	},
/obj/structure/shuttle/part/typhoon/transparent{
	icon_state = "29"
	},
/turf/template_noop,
/area/shuttle/tornado{
	base_lighting_alpha = 0
	})
"Ts" = (
/obj/structure/shuttle/part/typhoon/transparent{
	icon_state = "2"
	},
/turf/template_noop,
/area/shuttle/tornado{
	base_lighting_alpha = 0
	})
"TF" = (
/obj/structure/shuttle/part/typhoon/transparent{
	icon_state = "40";
	density = 0;
	layer = 4.2
	},
/obj/structure/shuttle/part/typhoon/transparent{
	icon_state = "65"
	},
/turf/template_noop,
/area/shuttle/tornado{
	base_lighting_alpha = 0
	})
"Uk" = (
/obj/structure/shuttle/part/typhoon/transparent,
/turf/template_noop,
/area/shuttle/tornado{
	base_lighting_alpha = 0
	})
"UV" = (
/obj/effect/decal/warning_stripes{
	icon_state = "N";
	pixel_y = -1
	},
/obj/effect/decal/warning_stripes{
	icon_state = "S";
	pixel_y = 2
	},
/obj/structure/machinery/door/airlock/multi_tile/almayer/dropshiprear/ds3{
	name = "\improper Typhoon cargo door";
	id = "aft_door"
	},
/turf/open/shuttle/dropship/medium_grey_single_wide_left_to_right,
/area/shuttle/tornado{
	base_lighting_alpha = 0
	})
"VM" = (
/obj/structure/shuttle/part/typhoon/transparent{
	icon_state = "9"
	},
/turf/template_noop,
/area/shuttle/tornado{
	base_lighting_alpha = 0
	})
"VV" = (
/obj/structure/shuttle/part/tornado/transparent{
	icon_state = "22"
	},
/turf/template_noop,
/area/shuttle/tornado{
	base_lighting_alpha = 0
	})
"Wr" = (
/obj/structure/stairs/perspective{
	icon_state = "p_stair_full";
	can_block_movement = 0
	},
/obj/structure/platform{
	dir = 8
	},
/obj/structure/platform{
	dir = 4
	},
/turf/open/shuttle/dropship/medium_grey_single_wide_up_to_down,
/area/shuttle/tornado{
	base_lighting_alpha = 0
	})
"XJ" = (
/obj/structure/machinery/camera/autoname/golden_arrow/typhoon{
	dir = 4;
	pixel_x = -24
	},
/obj/structure/bed/chair/dropship/passenger{
	dir = 4
	},
/obj/structure/barricade/handrail{
	dir = 1
	},
/turf/open/shuttle/dropship/medium_grey_single_wide_up_to_down,
/area/shuttle/tornado{
	base_lighting_alpha = 0
	})
"Yk" = (
/turf/open/shuttle/dropship/light_grey_bottom_right,
/area/shuttle/tornado{
	base_lighting_alpha = 0
	})
"YW" = (
/obj/structure/shuttle/part/typhoon/transparent{
	icon_state = "71"
	},
/turf/template_noop,
/area/shuttle/tornado{
	base_lighting_alpha = 0
	})
"Zk" = (
/turf/closed/shuttle/typhoon{
	icon_state = "30"
	},
/area/shuttle/tornado{
	base_lighting_alpha = 0
	})
"ZR" = (
/turf/closed/shuttle/typhoon{
	icon_state = "37"
	},
/area/shuttle/tornado{
	base_lighting_alpha = 0
	})

(1,1,1) = {"
aX
aX
aX
aX
aX
aX
aX
aX
IT
Qi
Oc
KX
wI
aX
aX
aX
aX
aX
"}
(2,1,1) = {"
aX
aX
aX
aX
aX
YW
cg
cg
vO
RB
Rb
JT
BP
IT
OV
VV
wI
Uk
"}
(3,1,1) = {"
aX
aX
aX
IT
dV
rO
gY
gY
QF
wd
Zk
gN
VM
yE
Tc
Bz
BP
Ts
"}
(4,1,1) = {"
aX
aX
aX
yE
et
zj
LB
XJ
hS
wO
hS
Mj
gx
wd
Zk
gN
Oh
uS
"}
(5,1,1) = {"
IR
oH
CE
Fm
Or
De
Sz
Sz
Sz
Sz
mE
Wr
Rg
gn
is
gn
UV
aX
"}
(6,1,1) = {"
Mp
MB
pQ
bi
xP
KN
gn
gn
Du
CD
KN
gn
Re
Sz
BL
Sz
Nf
aX
"}
(7,1,1) = {"
OE
fJ
zS
yk
et
qH
Sz
Sz
Sz
Sz
Yk
CI
fZ
kC
Ms
gn
Nf
aX
"}
(8,1,1) = {"
aX
aX
aX
IT
et
Da
tf
KW
Jm
CW
Jm
Mj
lM
ZR
Rw
of
rb
Lj
"}
(9,1,1) = {"
aX
aX
aX
yE
Dl
lA
xq
xq
nM
ZR
Rw
of
BO
IT
Dv
bs
wI
Au
"}
(10,1,1) = {"
aX
aX
aX
aX
aX
Sc
Gv
Gv
TF
Qi
HJ
IX
wI
yE
Jb
gw
BP
Cl
"}
(11,1,1) = {"
aX
aX
aX
aX
aX
aX
aX
aX
yE
RB
Jb
RH
BP
aX
aX
aX
aX
aX
"}
