//MAP CONVERTED BY dmm2tgm.py THIS HEADER COMMENT PREVENTS RECONVERSION, DO NOT REMOVE
"aq" = (
/obj/effect/attach_point/crew_weapon/tornado,
/turf/open/shuttle/dropship/light_grey_single_wide_up_to_down,
/area/shuttle/tornado)
"bd" = (
/turf/closed/shuttle/dropship3/tornado{
	icon_state = "19"
	},
/area/shuttle/tornado)
"bI" = (
/obj/structure/shuttle/part/tornado/transparent{
	icon_state = "41";
	layer = 4.2;
	density = 0
	},
/obj/structure/shuttle/part/tornado/transparent{
	icon_state = "61"
	},
/turf/template_noop,
/area/shuttle/tornado)
"bU" = (
/obj/structure/shuttle/part/tornado/transparent/nosecone{
	icon_state = "100"
	},
/turf/template_noop,
/area/shuttle/tornado)
"da" = (
/obj/structure/shuttle/part/tornado/transparent{
	icon_state = "40";
	density = 0;
	layer = 4.2
	},
/obj/structure/shuttle/part/tornado/transparent{
	icon_state = "65"
	},
/turf/template_noop,
/area/shuttle/tornado)
"do" = (
/turf/closed/shuttle/dropship3/tornado{
	icon_state = "67"
	},
/area/shuttle/tornado)
"dv" = (
/obj/structure/shuttle/part/tornado/transparent{
	icon_state = "33"
	},
/turf/template_noop,
/area/shuttle/tornado)
"dA" = (
/obj/structure/shuttle/part/tornado/transparent{
	icon_state = "22"
	},
/turf/template_noop,
/area/shuttle/tornado)
"dE" = (
/turf/closed/shuttle/dropship3/tornado{
	icon_state = "62"
	},
/area/shuttle/tornado)
"dG" = (
/obj/structure/shuttle/part/tornado/transparent{
	icon_state = "3";
	density = 0;
	layer = 4.2
	},
/turf/template_noop,
/area/shuttle/tornado)
"dI" = (
/obj/structure/shuttle/part/tornado/transparent{
	icon_state = "41";
	layer = 4.2;
	density = 0
	},
/turf/template_noop,
/area/shuttle/tornado)
"dL" = (
/obj/structure/bed/chair/dropship/passenger{
	dir = 4
	},
/obj/structure/machinery/cm_vending/sorted/medical/wall_med{
	pixel_y = 26;
	pixel_x = 10
	},
/obj/structure/extinguisher_cabinet/lifeboat{
	pixel_y = 27;
	pixel_x = -2
	},
/turf/open/shuttle/dropship/medium_grey_single_wide_up_to_down,
/area/shuttle/tornado)
"ej" = (
/obj/structure/shuttle/part/tornado/transparent{
	icon_state = "4";
	density = 0;
	layer = 4.2
	},
/turf/template_noop,
/area/shuttle/tornado)
"es" = (
/obj/effect/decal/warning_stripes{
	icon_state = "S";
	pixel_y = 2
	},
/obj/effect/decal/warning_stripes{
	icon_state = "N";
	pixel_y = -1
	},
/turf/open/shuttle/dropship/medium_grey_single_wide_left_to_right,
/area/shuttle/tornado)
"eQ" = (
/obj/structure/bed/chair/dropship/passenger{
	dir = 4
	},
/turf/open/shuttle/dropship/medium_grey_single_wide_up_to_down,
/area/shuttle/tornado)
"gh" = (
/obj/structure/shuttle/part/tornado/transparent{
	icon_state = "46";
	density = 0;
	layer = 4.2
	},
/turf/template_noop,
/area/shuttle/tornado)
"gZ" = (
/turf/closed/shuttle/dropship3/tornado{
	icon_state = "103"
	},
/area/shuttle/tornado)
"hl" = (
/obj/structure/stairs/perspective{
	dir = 1;
	icon_state = "p_stair_full";
	pixel_y = 22
	},
/obj/structure/bed/chair/vehicle/dropship_cockpit/copilot{
	dir = 1;
	layer = 5;
	pixel_x = 8
	},
/obj/structure/machinery/computer/dropship_weapons/tornado/small{
	pixel_y = 8;
	pixel_x = 8
	},
/turf/open/shuttle/dropship/medium_grey_single_wide_up_to_down,
/area/shuttle/tornado)
"iA" = (
/turf/closed/shuttle/dropship3/tornado{
	icon_state = "47"
	},
/area/shuttle/tornado)
"iG" = (
/obj/structure/shuttle/part/tornado/transparent{
	icon_state = "40";
	density = 0;
	layer = 4.2
	},
/turf/template_noop,
/area/shuttle/tornado)
"kd" = (
/obj/structure/shuttle/part/tornado{
	icon_state = "5"
	},
/turf/template_noop,
/area/shuttle/tornado)
"kp" = (
/turf/closed/shuttle/dropship3/tornado{
	icon_state = "73"
	},
/area/shuttle/tornado)
"ku" = (
/obj/structure/shuttle/part/tornado/transparent{
	icon_state = "99a"
	},
/turf/template_noop,
/area/shuttle/tornado)
"kF" = (
/turf/closed/shuttle/dropship3/tornado{
	icon_state = "86b";
	opacity = 0
	},
/area/shuttle/tornado)
"lk" = (
/obj/effect/attach_point/crew_weapon/tornado,
/turf/open/shuttle/dropship/medium_grey_single_wide_up_to_down,
/area/shuttle/tornado)
"ls" = (
/obj/structure/stairs/perspective{
	icon_state = "p_stair_full";
	can_block_movement = 0
	},
/obj/structure/platform{
	dir = 8
	},
/turf/open/shuttle/dropship/medium_grey_single_wide_up_to_down,
/area/shuttle/tornado)
"lS" = (
/obj/structure/bed/chair/dropship/passenger{
	dir = 8
	},
/turf/open/shuttle/dropship/medium_grey_single_wide_up_to_down,
/area/shuttle/tornado)
"mQ" = (
/turf/closed/shuttle/dropship3/tornado{
	icon_state = "89a";
	opacity = 0
	},
/area/shuttle/tornado)
"oh" = (
/turf/closed/shuttle/dropship3/tornado{
	icon_state = "76"
	},
/area/shuttle/tornado)
"pj" = (
/turf/open/shuttle/dropship/light_grey_bottom_left,
/area/shuttle/tornado)
"pp" = (
/obj/structure/phone_base{
	dir = 4;
	pixel_x = -19;
	pixel_y = 12;
	layer = 3.1;
	phone_category = "Dropship";
	name = "Tornado telephone receiver";
	phone_id = "Tornado"
	},
/obj/structure/machinery/computer/shuttle/dropship/flight/small{
	pixel_y = 16;
	pixel_x = 6
	},
/obj/structure/bed/chair/vehicle/dropship_cockpit/pilot{
	dir = 1;
	pixel_x = 6;
	pixel_y = 8
	},
/obj/structure/machinery/light/small{
	dir = 4;
	pixel_y = 15
	},
/turf/open/shuttle/dropship/medium_grey_single_wide_up_to_down,
/area/shuttle/tornado)
"pv" = (
/turf/closed/shuttle/dropship3/tornado{
	icon_state = "64"
	},
/area/shuttle/tornado)
"qx" = (
/obj/structure/bed/chair/dropship/passenger{
	dir = 4
	},
/obj/structure/machinery/camera/autoname/golden_arrow/tornado{
	dir = 4;
	pixel_x = -24
	},
/turf/open/shuttle/dropship/medium_grey_single_wide_up_to_down,
/area/shuttle/tornado)
"qA" = (
/obj/structure/shuttle/part/tornado/transparent{
	icon_state = "20"
	},
/turf/template_noop,
/area/shuttle/tornado)
"rD" = (
/turf/closed/shuttle/dropship3/tornado{
	icon_state = "97a";
	opacity = 0
	},
/area/shuttle/tornado)
"rH" = (
/obj/structure/machinery/light/double{
	dir = 4;
	pixel_y = -5
	},
/obj/structure/bed/chair/dropship/passenger{
	dir = 8
	},
/turf/open/shuttle/dropship/medium_grey_single_wide_up_to_down,
/area/shuttle/tornado)
"rS" = (
/obj/structure/shuttle/part/tornado/transparent{
	icon_state = "32"
	},
/turf/template_noop,
/area/shuttle/tornado)
"sj" = (
/obj/structure/shuttle/part/tornado/transparent{
	icon_state = "29"
	},
/turf/template_noop,
/area/shuttle/tornado)
"tw" = (
/obj/structure/shuttle/part/tornado/transparent{
	icon_state = "71"
	},
/turf/template_noop,
/area/shuttle/tornado)
"uF" = (
/turf/closed/shuttle/dropship3/tornado{
	icon_state = "48"
	},
/area/shuttle/tornado)
"uV" = (
/obj/structure/shuttle/part/tornado/transparent{
	icon_state = "28"
	},
/turf/template_noop,
/area/shuttle/tornado)
"uY" = (
/turf/closed/shuttle/dropship3/tornado{
	icon_state = "24"
	},
/area/shuttle/tornado)
"vp" = (
/obj/structure/shuttle/part/tornado/transparent/nosecone{
	icon_state = "102"
	},
/turf/template_noop,
/area/shuttle/tornado)
"vP" = (
/obj/structure/shuttle/part/tornado/transparent{
	icon_state = "39"
	},
/turf/template_noop,
/area/shuttle/tornado)
"vT" = (
/obj/structure/machinery/camera/autoname/golden_arrow/tornado{
	pixel_y = 32
	},
/turf/open/shuttle/dropship/light_grey_top_left,
/area/shuttle/tornado)
"xq" = (
/obj/structure/shuttle/part/tornado/transparent{
	icon_state = "21"
	},
/turf/template_noop,
/area/shuttle/tornado)
"xA" = (
/obj/structure/shuttle/part/tornado/transparent{
	icon_state = "66"
	},
/turf/template_noop,
/area/shuttle/tornado)
"xN" = (
/turf/closed/shuttle/dropship3/tornado{
	icon_state = "83"
	},
/area/shuttle/tornado)
"yZ" = (
/obj/structure/shuttle/part/tornado/transparent{
	icon_state = "23"
	},
/turf/template_noop,
/area/shuttle/tornado)
"zZ" = (
/obj/structure/shuttle/part/tornado/transparent{
	icon_state = "28"
	},
/obj/effect/attach_point/fuel/tornado{
	layer = 3.1;
	dir = 1
	},
/turf/template_noop,
/area/shuttle/tornado)
"Bm" = (
/turf/closed/shuttle/dropship3/tornado{
	icon_state = "104"
	},
/area/shuttle/tornado)
"BE" = (
/obj/structure/machinery/light/double{
	dir = 8;
	pixel_y = -5
	},
/turf/open/shuttle/dropship/medium_grey_single_wide_up_to_down,
/area/shuttle/tornado)
"Cw" = (
/obj/structure/machinery/light/double{
	dir = 4;
	pixel_y = -5
	},
/turf/open/shuttle/dropship/medium_grey_single_wide_up_to_down,
/area/shuttle/tornado)
"CY" = (
/obj/structure/shuttle/part/tornado/transparent{
	icon_state = "49";
	density = 0;
	layer = 4.2
	},
/turf/template_noop,
/area/shuttle/tornado)
"Dq" = (
/obj/structure/shuttle/part/tornado/transparent{
	icon_state = "17"
	},
/turf/template_noop,
/area/shuttle/tornado)
"Fd" = (
/obj/structure/shuttle/part/tornado/transparent,
/turf/template_noop,
/area/shuttle/tornado)
"Fx" = (
/obj/structure/shuttle/part/tornado/transparent{
	icon_state = "32"
	},
/obj/effect/attach_point/fuel/tornado{
	layer = 3.1;
	dir = 1
	},
/turf/template_noop,
/area/shuttle/tornado)
"Fz" = (
/turf/closed/shuttle/dropship3/tornado{
	icon_state = "89b";
	opacity = 0
	},
/area/shuttle/tornado)
"FP" = (
/obj/structure/shuttle/part/tornado/transparent{
	icon_state = "34"
	},
/turf/template_noop,
/area/shuttle/tornado)
"Ga" = (
/obj/structure/shuttle/part/tornado/gunpod_prop,
/turf/template_noop,
/area/shuttle/tornado)
"Go" = (
/obj/structure/shuttle/part/tornado/transparent{
	icon_state = "70"
	},
/turf/template_noop,
/area/shuttle/tornado)
"Ia" = (
/obj/structure/shuttle/part/tornado/transparent{
	icon_state = "35"
	},
/turf/template_noop,
/area/shuttle/tornado)
"Ig" = (
/turf/open/shuttle/dropship/light_grey_bottom_right,
/area/shuttle/tornado)
"Il" = (
/obj/structure/shuttle/part/tornado{
	icon_state = "6"
	},
/turf/template_noop,
/area/shuttle/tornado)
"JC" = (
/turf/closed/shuttle/dropship3/tornado{
	icon_state = "86a";
	opacity = 0
	},
/area/shuttle/tornado)
"JV" = (
/turf/closed/shuttle/dropship3/tornado{
	icon_state = "30"
	},
/area/shuttle/tornado)
"KG" = (
/obj/structure/machinery/light/double{
	dir = 8;
	pixel_y = -5
	},
/obj/structure/bed/chair/dropship/passenger{
	dir = 4
	},
/turf/open/shuttle/dropship/medium_grey_single_wide_up_to_down,
/area/shuttle/tornado)
"LL" = (
/obj/structure/platform_decoration{
	dir = 4
	},
/turf/open/shuttle/dropship/medium_grey_single_wide_up_to_down,
/area/shuttle/tornado)
"Mw" = (
/obj/structure/shuttle/part/tornado/transparent{
	icon_state = "16"
	},
/turf/template_noop,
/area/shuttle/tornado)
"MH" = (
/turf/open/shuttle/dropship/light_grey_top_right,
/area/shuttle/tornado)
"MK" = (
/obj/structure/platform_decoration{
	dir = 8
	},
/obj/structure/machinery/camera/autoname/golden_arrow/tornado{
	dir = 8;
	pixel_x = 24
	},
/turf/open/shuttle/dropship/medium_grey_single_wide_up_to_down,
/area/shuttle/tornado)
"MQ" = (
/turf/closed/shuttle/dropship3/tornado{
	icon_state = "31"
	},
/area/shuttle/tornado)
"MS" = (
/obj/structure/shuttle/part/tornado/transparent{
	icon_state = "74"
	},
/turf/template_noop,
/area/shuttle/tornado)
"ND" = (
/obj/structure/stairs/perspective{
	icon_state = "p_stair_full";
	can_block_movement = 0
	},
/turf/open/shuttle/dropship/light_grey_single_wide_up_to_down,
/area/shuttle/tornado)
"Og" = (
/turf/open/shuttle/dropship/light_grey_single_wide_left_to_right,
/area/shuttle/tornado)
"Om" = (
/turf/template_noop,
/area/space)
"Op" = (
/obj/docking_port/mobile/marine_dropship/tornado,
/obj/structure/bed/chair/dropship/passenger/folded{
	pixel_y = 8;
	buckling_y = 8
	},
/turf/open/shuttle/dropship/medium_grey_single_wide_up_to_down,
/area/shuttle/tornado)
"Ox" = (
/turf/closed/shuttle/dropship3/tornado{
	icon_state = "77"
	},
/area/shuttle/tornado)
"Pd" = (
/turf/closed/shuttle/dropship3/tornado{
	icon_state = "72"
	},
/area/shuttle/tornado)
"Pk" = (
/turf/closed/shuttle/dropship3/tornado{
	icon_state = "18"
	},
/area/shuttle/tornado)
"Pp" = (
/obj/structure/shuttle/part/tornado/transparent{
	icon_state = "38"
	},
/turf/template_noop,
/area/shuttle/tornado)
"PJ" = (
/obj/structure/shuttle/part/tornado{
	icon_state = "2"
	},
/turf/template_noop,
/area/shuttle/tornado)
"Qv" = (
/obj/structure/blocker/forcefield/multitile_vehicles,
/obj/structure/machinery/door/airlock/hatch/cockpit/three{
	dir = 1
	},
/turf/open/shuttle/dropship/medium_grey_single_wide_up_to_down,
/area/shuttle/tornado)
"QK" = (
/obj/effect/decal/warning_stripes{
	icon_state = "N";
	pixel_y = -1
	},
/obj/effect/decal/warning_stripes{
	icon_state = "S";
	pixel_y = 2
	},
/obj/structure/machinery/door/airlock/multi_tile/almayer/dropshiprear/ds3{
	id = "aft_door";
	name = "\improper Tornado cargo door"
	},
/turf/open/shuttle/dropship/medium_grey_single_wide_left_to_right,
/area/shuttle/tornado)
"QL" = (
/obj/structure/stairs/perspective{
	icon_state = "p_stair_full";
	can_block_movement = 0
	},
/obj/structure/platform{
	dir = 4
	},
/turf/open/shuttle/dropship/medium_grey_single_wide_up_to_down,
/area/shuttle/tornado)
"Sy" = (
/obj/structure/bed/chair/dropship/passenger/folded{
	pixel_y = 8;
	buckling_y = 8
	},
/turf/open/shuttle/dropship/medium_grey_single_wide_up_to_down,
/area/shuttle/tornado)
"To" = (
/turf/open/shuttle/dropship/medium_grey_single_wide_up_to_down,
/area/shuttle/tornado)
"TE" = (
/obj/structure/bed/chair/dropship/passenger{
	dir = 8
	},
/obj/structure/machinery/cm_vending/sorted/medical/wall_med{
	pixel_y = 26;
	pixel_x = -10
	},
/turf/open/shuttle/dropship/medium_grey_single_wide_up_to_down,
/area/shuttle/tornado)
"TJ" = (
/turf/closed/shuttle/dropship3/tornado{
	icon_state = "69"
	},
/area/shuttle/tornado)
"TU" = (
/obj/structure/shuttle/part/tornado/transparent{
	icon_state = "95a"
	},
/turf/template_noop,
/area/shuttle/tornado)
"Um" = (
/obj/structure/shuttle/part/tornado/transparent{
	icon_state = "27"
	},
/turf/template_noop,
/area/shuttle/tornado)
"UK" = (
/obj/structure/shuttle/part/tornado/transparent{
	icon_state = "26"
	},
/turf/template_noop,
/area/shuttle/tornado)
"Wj" = (
/turf/closed/shuttle/dropship3/tornado{
	icon_state = "75"
	},
/area/shuttle/tornado)
"Xd" = (
/turf/closed/shuttle/dropship3/tornado{
	icon_state = "25"
	},
/area/shuttle/tornado)
"YR" = (
/turf/open/shuttle/dropship/light_grey_single_wide_up_to_down,
/area/shuttle/tornado)

(1,1,1) = {"
Om
Om
Om
Om
Om
Om
Om
Om
iG
FP
zZ
dA
qA
Om
Om
Om
Om
Om
"}
(2,1,1) = {"
Om
Om
Om
Om
Om
tw
xA
xA
bI
Ia
sj
yZ
xq
iG
uV
dA
qA
Fd
"}
(3,1,1) = {"
Om
Om
Om
iG
Wj
Pd
do
do
dE
Pk
JV
uY
gh
dI
sj
yZ
xq
PJ
"}
(4,1,1) = {"
Om
Om
Om
dI
oh
dL
KG
eQ
qx
eQ
KG
eQ
iA
Pk
JV
uY
gZ
dG
"}
(5,1,1) = {"
bU
TU
kF
JC
Ox
vT
YR
YR
YR
YR
YR
pj
ls
LL
BE
To
QK
Om
"}
(6,1,1) = {"
Ga
rD
pp
hl
Qv
Og
lk
Sy
Op
Sy
lk
Og
ND
YR
aq
YR
es
Om
"}
(7,1,1) = {"
vp
ku
Fz
mQ
Ox
MH
YR
YR
YR
YR
YR
Ig
QL
MK
Cw
To
es
Om
"}
(8,1,1) = {"
Om
Om
Om
iG
oh
TE
rH
lS
lS
lS
rH
lS
uF
bd
MQ
Xd
Bm
ej
"}
(9,1,1) = {"
Om
Om
Om
dI
xN
kp
TJ
TJ
pv
bd
MQ
Xd
CY
iG
rS
UK
Mw
kd
"}
(10,1,1) = {"
Om
Om
Om
Om
Om
MS
Go
Go
da
Pp
Fx
UK
Mw
dI
dv
Um
Dq
Il
"}
(11,1,1) = {"
Om
Om
Om
Om
Om
Om
Om
Om
dI
vP
dv
Um
Dq
Om
Om
Om
Om
Om
"}
