//MAP CONVERTED BY dmm2tgm.py THIS HEADER COMMENT PREVENTS RECONVERSION, DO NOT REMOVE
"cf" = (
/obj/structure/surface/rack,
/obj/item/clothing/head/welding,
/obj/item/storage/toolbox/mechanical,
/obj/structure/sign/banners/twe_flag{
	pixel_y = 32
	},
/turf/open/floor/elevatorshaft,
/area/space)
"cA" = (
/obj/structure/shuttle/engine/propulsion{
	pixel_y = 0
	},
/turf/template_noop,
/area/space)
"cW" = (
/turf/closed/shuttle/elevator,
/area/space)
"dh" = (
/obj/structure/shuttle/part/dropship1/transparent/engine_right_cap,
/turf/template_noop,
/area/space)
"du" = (
/turf/open/floor/plating/wood,
/area/space)
"gD" = (
/turf/closed/wall/r_wall/elevator/freight,
/area/space)
"iB" = (
/obj/structure/surface/rack,
/obj/item/reagent_container/food/snacks/cheesewedge,
/obj/item/reagent_container/food/snacks/cheesewedge,
/obj/item/reagent_container/food/snacks/cheesewedge,
/obj/item/reagent_container/food/snacks/cheesewedge,
/obj/item/reagent_container/food/snacks/cheesewedge,
/obj/item/reagent_container/food/snacks/cheesewedge,
/obj/item/reagent_container/food/snacks/cheesewedge,
/obj/item/reagent_container/food/snacks/cheesewedge,
/obj/item/reagent_container/food/snacks/cheesewedge,
/obj/item/reagent_container/food/snacks/cheesewedge,
/obj/item/reagent_container/food/snacks/cheesewedge,
/obj/item/reagent_container/food/snacks/cheesewedge,
/obj/item/reagent_container/food/snacks/cheesewedge,
/obj/item/reagent_container/food/snacks/cheesewedge,
/obj/item/reagent_container/food/snacks/cheesewedge,
/obj/item/reagent_container/food/snacks/cheesewedge,
/obj/item/reagent_container/food/snacks/cheesewedge,
/obj/item/reagent_container/food/snacks/cheesewedge,
/obj/item/reagent_container/food/snacks/cheesewedge,
/obj/item/reagent_container/food/snacks/cheesewedge,
/obj/item/reagent_container/food/snacks/cheesewedge,
/obj/item/reagent_container/food/snacks/cheesewedge,
/obj/item/reagent_container/food/snacks/cheesewedge,
/obj/item/reagent_container/food/snacks/cheesewedge,
/obj/item/reagent_container/food/snacks/cheesewedge,
/obj/item/reagent_container/food/snacks/cheesewedge,
/obj/item/reagent_container/food/snacks/cheesewedge,
/obj/item/reagent_container/food/snacks/cheesewedge,
/obj/item/reagent_container/food/snacks/cheesewedge,
/obj/item/reagent_container/food/snacks/cheesewedge,
/obj/item/reagent_container/food/snacks/cheesewedge,
/obj/item/reagent_container/food/snacks/cheesewedge,
/obj/item/reagent_container/food/snacks/cheesewedge,
/obj/item/reagent_container/food/snacks/cheesewedge,
/obj/item/reagent_container/food/snacks/cheesewedge,
/obj/item/reagent_container/food/snacks/cheesewedge,
/obj/item/reagent_container/food/snacks/cheesewedge,
/obj/item/reagent_container/food/snacks/cheesewedge,
/obj/item/reagent_container/food/snacks/cheesewedge,
/obj/item/reagent_container/food/snacks/cheesewedge,
/obj/item/reagent_container/food/snacks/cheesewedge,
/obj/structure/machinery/conveyor{
	id = "cheese";
	dir = 8
	},
/turf/open/floor/elevatorshaft,
/area/space)
"iK" = (
/obj/structure/prop/ice_colony/ground_wire,
/obj/structure/surface/rack,
/obj/item/stack/sheet/mineral/uranium,
/obj/item/stack/sheet/mineral/uranium,
/obj/item/stack/sheet/mineral/uranium,
/obj/item/stack/sheet/mineral/uranium,
/obj/item/stack/sheet/mineral/uranium,
/obj/item/stack/sheet/mineral/uranium,
/obj/item/stack/sheet/mineral/uranium,
/obj/item/stack/sheet/mineral/uranium,
/obj/item/stack/sheet/mineral/uranium,
/obj/item/stack/sheet/mineral/uranium,
/obj/item/stack/sheet/mineral/uranium,
/obj/item/stack/sheet/mineral/uranium,
/obj/item/stack/sheet/mineral/uranium,
/obj/item/stack/sheet/mineral/uranium,
/obj/item/stack/sheet/mineral/uranium,
/obj/item/stack/sheet/mineral/uranium,
/obj/item/stack/sheet/mineral/uranium,
/obj/structure/machinery/conveyor{
	id = "uranium";
	dir = 8
	},
/turf/open/floor/elevatorshaft,
/area/space)
"jr" = (
/obj/structure/shuttle/part/dropship1/transparent/engine_left_cap,
/turf/template_noop,
/area/space)
"ki" = (
/turf/closed/shuttle/dropship{
	icon_state = "rasputin_nose";
	name = "wallace and gromit"
	},
/area/space)
"kL" = (
/obj/structure/machinery/conveyor_switch/oneway{
	pixel_x = -15;
	name = "main switch";
	id = "wallace main";
	pixel_y = -5
	},
/obj/structure/machinery/conveyor_switch/oneway{
	pixel_x = -8;
	name = "crackers switch";
	id = "crackers";
	pixel_y = -5
	},
/obj/structure/machinery/conveyor_switch/oneway{
	name = "cheese switch";
	id = "cheese";
	pixel_x = -1;
	pixel_y = -5
	},
/obj/structure/machinery/conveyor_switch/oneway{
	pixel_x = 6;
	name = "tea switch";
	id = "tea";
	pixel_y = -5
	},
/obj/structure/machinery/conveyor_switch/oneway{
	pixel_x = 13;
	name = "uranium switch";
	id = "uranium";
	pixel_y = -5
	},
/turf/open/floor/plating/wood,
/area/space)
"lH" = (
/obj/structure/machinery/computer/shuttle/dropship/flight/small{
	dir = 8
	},
/obj/structure/surface/table/woodentable/fancy,
/turf/open/floor/plating/wood,
/area/space)
"lT" = (
/turf/closed/shuttle/dropship,
/area/space)
"mD" = (
/obj/structure/machinery/door/airlock/vault/colony{
	req_one_access = null
	},
/turf/open/floor/elevatorshaft,
/area/space)
"nf" = (
/turf/closed/shuttle/dropship{
	dir = 1;
	icon_state = "diagrasputin"
	},
/area/space)
"nk" = (
/turf/closed/shuttle/dropship{
	icon_state = "rasputin12"
	},
/area/space)
"nx" = (
/turf/closed/shuttle/elevator/gears,
/area/space)
"nQ" = (
/obj/structure/surface/rack,
/obj/item/reagent_container/food/snacks/cracker,
/obj/item/reagent_container/food/snacks/cracker,
/obj/item/reagent_container/food/snacks/cracker,
/obj/item/reagent_container/food/snacks/cracker,
/obj/item/reagent_container/food/snacks/cracker,
/obj/item/reagent_container/food/snacks/cracker,
/obj/item/reagent_container/food/snacks/cracker,
/obj/item/reagent_container/food/snacks/cracker,
/obj/item/reagent_container/food/snacks/cracker,
/obj/item/reagent_container/food/snacks/cracker,
/obj/item/reagent_container/food/snacks/cracker,
/obj/item/reagent_container/food/snacks/cracker,
/obj/item/reagent_container/food/snacks/cracker,
/obj/item/reagent_container/food/snacks/cracker,
/obj/item/reagent_container/food/snacks/cracker,
/obj/item/reagent_container/food/snacks/cracker,
/obj/item/reagent_container/food/snacks/cracker,
/obj/item/reagent_container/food/snacks/cracker,
/obj/item/reagent_container/food/snacks/cracker,
/obj/item/reagent_container/food/snacks/cracker,
/obj/item/reagent_container/food/snacks/cracker,
/obj/item/reagent_container/food/snacks/cracker,
/obj/item/reagent_container/food/snacks/cracker,
/obj/item/reagent_container/food/snacks/cracker,
/obj/item/reagent_container/food/snacks/cracker,
/obj/item/reagent_container/food/snacks/cracker,
/obj/item/reagent_container/food/snacks/cracker,
/obj/item/reagent_container/food/snacks/cracker,
/obj/item/reagent_container/food/snacks/cracker,
/obj/item/reagent_container/food/snacks/cracker,
/obj/item/reagent_container/food/snacks/cracker,
/obj/item/reagent_container/food/snacks/cracker,
/obj/item/reagent_container/food/snacks/cracker,
/obj/item/reagent_container/food/snacks/cracker,
/obj/item/reagent_container/food/snacks/cracker,
/obj/item/reagent_container/food/snacks/cracker,
/obj/item/reagent_container/food/snacks/cracker,
/obj/item/reagent_container/food/snacks/cracker,
/obj/item/reagent_container/food/snacks/cracker,
/obj/item/reagent_container/food/snacks/cracker,
/obj/item/reagent_container/food/snacks/cracker,
/obj/structure/machinery/conveyor{
	id = "crackers";
	dir = 8
	},
/turf/open/floor/elevatorshaft,
/area/space)
"oO" = (
/obj/structure/shuttle/part/typhoon/transparent{
	icon_state = "38"
	},
/turf/template_noop,
/area/space)
"pP" = (
/turf/closed/wall/r_wall/elevator/arrivals,
/area/space)
"qn" = (
/obj/structure/shuttle/part/dropship1/transparent/engine_right_exhaust,
/turf/template_noop,
/area/space)
"si" = (
/obj/structure/shuttle/part/typhoon/transparent{
	icon_state = "27"
	},
/turf/template_noop,
/area/space)
"us" = (
/turf/closed/shuttle/dropship1/transparent{
	icon_state = "34"
	},
/area/space)
"vP" = (
/turf/closed/shuttle/dropship{
	icon_state = "rasputin2"
	},
/area/space)
"wE" = (
/obj/structure/shuttle/part/typhoon/transparent{
	icon_state = "40";
	density = 0;
	layer = 4.2
	},
/turf/template_noop,
/area/space)
"wP" = (
/obj/structure/shuttle/part/typhoon/transparent{
	icon_state = "17"
	},
/turf/template_noop,
/area/space)
"xe" = (
/obj/structure/plasticflaps,
/obj/structure/machinery/conveyor{
	id = "wallace main";
	dir = 1
	},
/turf/open/floor/elevatorshaft,
/area/space)
"xo" = (
/turf/closed/shuttle/elevator{
	dir = 6
	},
/area/space)
"xs" = (
/turf/closed/shuttle/elevator{
	dir = 4
	},
/area/space)
"xB" = (
/obj/structure/shuttle/part/typhoon/transparent{
	icon_state = "33"
	},
/turf/template_noop,
/area/space)
"yT" = (
/obj/structure/shuttle/part/typhoon/transparent{
	icon_state = "41";
	density = 0;
	layer = 4.2
	},
/turf/template_noop,
/area/space)
"yU" = (
/obj/structure/window/framed/colony/reinforced/hull,
/turf/open/floor/plating/wood,
/area/space)
"zj" = (
/obj/structure/surface/table/woodentable/fancy,
/obj/item/trash/ceramic_plate,
/turf/open/floor/plating/wood,
/area/space)
"zs" = (
/turf/open/floor/carpet,
/area/space)
"CT" = (
/obj/structure/shuttle/part/typhoon/transparent{
	icon_state = "26"
	},
/turf/template_noop,
/area/space)
"DT" = (
/obj/structure/shuttle/part/typhoon/transparent{
	icon_state = "16"
	},
/turf/template_noop,
/area/space)
"EN" = (
/obj/structure/shuttle/part/typhoon/transparent{
	icon_state = "39"
	},
/turf/template_noop,
/area/space)
"EY" = (
/turf/template_noop,
/area/space)
"FJ" = (
/obj/effect/attach_point/fuel/dropship1{
	dir = 1
	},
/turf/closed/shuttle/dropship1/transparent{
	icon_state = "28"
	},
/area/space)
"Gt" = (
/obj/structure/shuttle/part/dropship1/transparent/engine_left_exhaust,
/turf/template_noop,
/area/space)
"GI" = (
/obj/structure/machinery/door/airlock/external/colony{
	req_one_access = null
	},
/turf/template_noop,
/area/space)
"GM" = (
/turf/closed/shuttle/elevator{
	dir = 9
	},
/area/space)
"Hz" = (
/turf/closed/shuttle/dropship1/transparent{
	icon_state = "35"
	},
/area/space)
"Ia" = (
/obj/structure/machinery/disposal,
/turf/open/floor/plating/wood,
/area/space)
"IB" = (
/turf/closed/shuttle/elevator{
	dir = 10
	},
/area/space)
"Jm" = (
/obj/item/holder/mouse/brown/Tom,
/turf/open/floor/elevatorshaft,
/area/space)
"JU" = (
/obj/structure/bed/chair/wood/wings{
	dir = 4
	},
/turf/open/floor/carpet,
/area/space)
"Mw" = (
/obj/item/holder/mouse/white{
	name = "Harry"
	},
/turf/open/floor/elevatorshaft,
/area/space)
"Nq" = (
/obj/structure/prop/ice_colony/ground_wire,
/obj/structure/machinery/conveyor{
	id = "wallace main";
	dir = 1
	},
/turf/open/floor/elevatorshaft,
/area/space)
"NZ" = (
/obj/structure/machinery/door/airlock/external/colony{
	req_one_access = null
	},
/turf/open/floor/plating/wood,
/area/space)
"Qa" = (
/turf/open/floor/elevatorshaft,
/area/space)
"Qj" = (
/obj/structure/shuttle/part/typhoon/transparent{
	icon_state = "32"
	},
/obj/effect/attach_point/fuel/typhoon{
	layer = 3.1;
	dir = 1
	},
/turf/template_noop,
/area/space)
"Ra" = (
/obj/structure/surface/table/woodentable/fancy,
/obj/item/reagent_container/food/drinks/tea{
	pixel_y = 11
	},
/obj/item/trash/ceramic_plate{
	pixel_x = -4;
	pixel_y = -1
	},
/obj/item/newspaper{
	pixel_x = 7
	},
/obj/item/reagent_container/food/snacks/cracker{
	pixel_x = -6;
	pixel_y = 2
	},
/obj/item/reagent_container/food/snacks/cheesewedge{
	pixel_y = 6;
	pixel_x = -5
	},
/turf/open/floor/carpet,
/area/space)
"TX" = (
/obj/structure/machinery/conveyor{
	id = "wallace main";
	dir = 1
	},
/turf/open/floor/elevatorshaft,
/area/space)
"UB" = (
/turf/closed/shuttle/elevator{
	dir = 5
	},
/area/space)
"VC" = (
/obj/docking_port/mobile/marine_dropship/wallace_and_gromit,
/turf/open/floor/elevatorshaft,
/area/space)
"Wa" = (
/turf/closed/shuttle/dropship1/transparent{
	icon_state = "23"
	},
/area/space)
"Wg" = (
/turf/closed/shuttle/dropship1/transparent{
	icon_state = "29"
	},
/area/space)
"Wi" = (
/obj/structure/prop/ice_colony/ground_wire,
/turf/open/floor/elevatorshaft,
/area/space)
"WG" = (
/obj/structure/closet/secure_closet/personal/cabinet,
/turf/open/floor/plating/wood,
/area/space)
"XT" = (
/obj/structure/prop/turbine,
/obj/structure/prop/ice_colony/ground_wire,
/turf/open/floor/elevatorshaft,
/area/space)
"Zf" = (
/obj/structure/bed/sofa,
/obj/structure/sign/catclock{
	pixel_y = 32
	},
/turf/open/floor/plating/wood,
/area/space)
"ZD" = (
/obj/item/reagent_container/food/drinks/tea,
/obj/item/reagent_container/food/drinks/tea,
/obj/item/reagent_container/food/drinks/tea,
/obj/item/reagent_container/food/drinks/tea,
/obj/item/reagent_container/food/drinks/tea,
/obj/item/reagent_container/food/drinks/tea,
/obj/item/reagent_container/food/drinks/tea,
/obj/item/reagent_container/food/drinks/tea,
/obj/item/reagent_container/food/drinks/tea,
/obj/item/reagent_container/food/drinks/tea,
/obj/item/reagent_container/food/drinks/tea,
/obj/item/reagent_container/food/drinks/tea,
/obj/item/reagent_container/food/drinks/tea,
/obj/item/reagent_container/food/drinks/tea,
/obj/item/reagent_container/food/drinks/tea,
/obj/item/reagent_container/food/drinks/tea,
/obj/item/reagent_container/food/drinks/tea,
/obj/item/reagent_container/food/drinks/tea,
/obj/item/reagent_container/food/drinks/tea,
/obj/item/reagent_container/food/drinks/tea,
/obj/item/reagent_container/food/drinks/tea,
/obj/item/reagent_container/food/drinks/tea,
/obj/item/reagent_container/food/drinks/tea,
/obj/item/reagent_container/food/drinks/tea,
/obj/item/reagent_container/food/drinks/tea,
/obj/item/reagent_container/food/drinks/tea,
/obj/structure/shuttle/engine/heater{
	name = "tea heater"
	},
/obj/structure/machinery/conveyor{
	id = "tea";
	dir = 8
	},
/turf/open/floor/elevatorshaft,
/area/space)
"ZF" = (
/turf/closed/shuttle/dropship1/transparent{
	icon_state = "22"
	},
/area/space)

(1,1,1) = {"
EY
EY
EY
EY
jr
us
FJ
ZF
Gt
EY
EY
"}
(2,1,1) = {"
EY
EY
EY
EY
dh
Hz
Wg
Wa
qn
EY
EY
"}
(3,1,1) = {"
ki
lT
GI
vP
GM
cW
cW
cW
cW
IB
EY
"}
(4,1,1) = {"
nk
Zf
du
Ia
gD
cf
Qa
Qa
XT
nx
EY
"}
(5,1,1) = {"
yU
Ra
zs
WG
xs
Qa
Mw
Jm
Wi
nk
cA
"}
(6,1,1) = {"
yU
zs
zs
du
mD
VC
Qa
Qa
XT
nk
cA
"}
(7,1,1) = {"
yU
JU
zs
zj
xe
TX
TX
TX
Nq
nk
cA
"}
(8,1,1) = {"
nk
lH
du
kL
pP
nQ
iB
ZD
iK
nx
EY
"}
(9,1,1) = {"
nf
lT
NZ
vP
UB
cW
cW
cW
cW
xo
EY
"}
(10,1,1) = {"
EY
EY
EY
EY
wE
oO
Qj
CT
DT
EY
EY
"}
(11,1,1) = {"
EY
EY
EY
EY
yT
EN
xB
si
wP
EY
EY
"}
