//MAP CONVERTED BY dmm2tgm.py THIS HEADER COMMENT PREVENTS RECONVERSION, DO NOT REMOVE
"af" = (
/turf/closed/shuttle/midway/transparent{
	icon_state = "34"
	},
/area/shuttle/midway{
	base_lighting_alpha = 0
	})
"aP" = (
/obj/structure/stairs/perspective,
/obj/structure/platform{
	dir = 8;
	layer = 2.7
	},
/obj/structure/platform{
	dir = 4
	},
/turf/open/shuttle/dropship/light_grey_single_wide_up_to_down,
/area/shuttle/midway{
	base_lighting_alpha = 0
	})
"bm" = (
/obj/structure/shuttle/part/midway/transparent{
	icon_state = "21"
	},
/turf/template_noop,
/area/shuttle/midway{
	base_lighting_alpha = 0
	})
"cK" = (
/obj/effect/attach_point/crew_weapon/midway{
	attach_id = 7
	},
/turf/open/shuttle/dropship/medium_grey_single_wide_up_to_down,
/area/shuttle/midway{
	base_lighting_alpha = 0
	})
"dd" = (
/turf/open/shuttle/dropship/light_grey_bottom_right,
/area/shuttle/midway{
	base_lighting_alpha = 0
	})
"dB" = (
/obj/structure/shuttle/part/midway/transparent{
	icon_state = "7"
	},
/turf/template_noop,
/area/shuttle/midway{
	base_lighting_alpha = 0
	})
"dD" = (
/turf/closed/shuttle/midway/transparent{
	icon_state = "22"
	},
/area/shuttle/midway{
	base_lighting_alpha = 0
	})
"dE" = (
/turf/closed/shuttle/midway{
	icon_state = "36"
	},
/area/shuttle/midway{
	base_lighting_alpha = 0
	})
"eu" = (
/obj/structure/shuttle/part/midway/transparent{
	icon_state = "2"
	},
/turf/template_noop,
/area/shuttle/midway{
	base_lighting_alpha = 0
	})
"eS" = (
/obj/effect/attach_point/fuel/midway{
	pixel_x = -32;
	attach_id = 11;
	dir = 1
	},
/turf/closed/shuttle/midway/transparent{
	icon_state = "33"
	},
/area/shuttle/midway{
	base_lighting_alpha = 0
	})
"fF" = (
/obj/structure/platform{
	dir = 1
	},
/obj/structure/blocker/forcefield/multitile_vehicles,
/turf/open/shuttle/dropship/medium_grey_single_wide_up_to_down,
/area/shuttle/midway{
	base_lighting_alpha = 0
	})
"gw" = (
/obj/structure/shuttle/part/midway/transparent{
	icon_state = "46"
	},
/obj/structure/shuttle/part/midway/transparent{
	icon_state = "41"
	},
/turf/template_noop,
/area/shuttle/midway{
	base_lighting_alpha = 0
	})
"hl" = (
/turf/closed/shuttle/midway{
	icon_state = "24"
	},
/area/shuttle/midway{
	base_lighting_alpha = 0
	})
"hL" = (
/obj/structure/shuttle/part/midway/transparent{
	icon_state = "95a"
	},
/turf/template_noop,
/area/shuttle/midway{
	base_lighting_alpha = 0
	})
"hO" = (
/obj/structure/shuttle/part/midway/transparent{
	icon_state = "65"
	},
/obj/effect/attach_point/weapon/midway/right_wing,
/turf/template_noop,
/area/shuttle/midway{
	base_lighting_alpha = 0
	})
"if" = (
/turf/closed/shuttle/midway/transparent{
	icon_state = "27"
	},
/area/shuttle/midway{
	base_lighting_alpha = 0
	})
"kL" = (
/obj/structure/bed/chair/dropship/passenger{
	dir = 8
	},
/obj/structure/machinery/cm_vending/sorted/medical/wall_med{
	pixel_y = 26;
	pixel_x = -8
	},
/turf/open/shuttle/dropship/medium_grey_single_wide_up_to_down,
/area/shuttle/midway{
	base_lighting_alpha = 0
	})
"ls" = (
/turf/closed/shuttle/midway/transparent{
	icon_state = "35"
	},
/area/shuttle/midway{
	base_lighting_alpha = 0
	})
"lC" = (
/turf/closed/shuttle/midway{
	icon_state = "104"
	},
/area/shuttle/midway{
	base_lighting_alpha = 0
	})
"mh" = (
/obj/structure/shuttle/part/midway/transparent{
	icon_state = "8"
	},
/turf/template_noop,
/area/shuttle/midway{
	base_lighting_alpha = 0
	})
"mA" = (
/obj/structure/bed/chair/dropship/passenger{
	dir = 4
	},
/turf/open/shuttle/dropship/medium_grey_single_wide_up_to_down,
/area/shuttle/midway{
	base_lighting_alpha = 0
	})
"mE" = (
/obj/structure/shuttle/part/midway/transparent,
/turf/template_noop,
/area/shuttle/midway{
	base_lighting_alpha = 0
	})
"mG" = (
/obj/structure/shuttle/part/midway/transparent{
	icon_state = "41"
	},
/turf/template_noop,
/area/shuttle/midway{
	base_lighting_alpha = 0
	})
"od" = (
/turf/closed/shuttle/midway/transparent{
	icon_state = "89b"
	},
/area/shuttle/midway{
	base_lighting_alpha = 0
	})
"oy" = (
/obj/structure/bed/chair/dropship/passenger/folded{
	pixel_y = 8;
	buckling_y = 8
	},
/turf/open/shuttle/dropship/medium_grey_single_wide_up_to_down,
/area/shuttle/midway{
	base_lighting_alpha = 0
	})
"oB" = (
/obj/structure/bed/chair/dropship/passenger{
	dir = 8
	},
/obj/structure/machinery/light/double{
	dir = 4;
	pixel_y = -5
	},
/turf/open/shuttle/dropship/medium_grey_single_wide_up_to_down,
/area/shuttle/midway{
	base_lighting_alpha = 0
	})
"oG" = (
/obj/structure/shuttle/part/midway/gunpod_prop,
/turf/template_noop,
/area/shuttle/midway{
	base_lighting_alpha = 0
	})
"ro" = (
/turf/closed/shuttle/midway/transparent{
	icon_state = "80"
	},
/area/shuttle/midway{
	base_lighting_alpha = 0
	})
"rq" = (
/turf/closed/shuttle/midway{
	icon_state = "77"
	},
/area/shuttle/midway{
	base_lighting_alpha = 0
	})
"rr" = (
/turf/closed/shuttle/midway{
	icon_state = "103"
	},
/area/shuttle/midway{
	base_lighting_alpha = 0
	})
"rR" = (
/turf/closed/shuttle/midway/transparent{
	icon_state = "32"
	},
/area/shuttle/midway{
	base_lighting_alpha = 0
	})
"sl" = (
/turf/closed/shuttle/midway{
	icon_state = "31"
	},
/area/shuttle/midway{
	base_lighting_alpha = 0
	})
"ti" = (
/turf/closed/shuttle/midway/transparent{
	icon_state = "86b"
	},
/area/shuttle/midway{
	base_lighting_alpha = 0
	})
"tP" = (
/obj/structure/shuttle/part/midway/transparent{
	icon_state = "6"
	},
/turf/template_noop,
/area/shuttle/midway{
	base_lighting_alpha = 0
	})
"tT" = (
/obj/structure/bed/chair/dropship/passenger{
	dir = 4
	},
/obj/structure/machinery/light/double{
	dir = 8
	},
/turf/open/shuttle/dropship/medium_grey_single_wide_up_to_down,
/area/shuttle/midway{
	base_lighting_alpha = 0
	})
"ul" = (
/obj/structure/shuttle/part/midway/transparent{
	icon_state = "40"
	},
/turf/template_noop,
/area/shuttle/midway{
	base_lighting_alpha = 0
	})
"us" = (
/obj/effect/decal/warning_stripes{
	icon_state = "N";
	pixel_y = -1
	},
/obj/effect/decal/warning_stripes{
	icon_state = "S";
	pixel_y = 2
	},
/obj/structure/machinery/door/airlock/multi_tile/almayer/dropshiprear/ds4{
	id = "aft_door"
	},
/turf/open/shuttle/dropship/medium_grey_single_wide_left_to_right,
/area/shuttle/midway{
	base_lighting_alpha = 0
	})
"ut" = (
/obj/structure/shuttle/part/midway/transparent/nosecone{
	icon_state = "102"
	},
/turf/template_noop,
/area/shuttle/midway{
	base_lighting_alpha = 0
	})
"ux" = (
/turf/closed/shuttle/midway/transparent{
	icon_state = "89a"
	},
/area/shuttle/midway{
	base_lighting_alpha = 0
	})
"vD" = (
/obj/structure/stairs/perspective{
	dir = 1;
	icon_state = "p_stair_full";
	pixel_y = 22
	},
/obj/structure/machinery/computer/dropship_weapons/midway/small{
	pixel_y = 8;
	pixel_x = 8
	},
/obj/structure/bed/chair/vehicle/dropship_cockpit/copilot{
	dir = 1;
	pixel_x = 8;
	layer = 5
	},
/turf/open/shuttle/dropship/medium_grey_single_wide_up_to_down,
/area/shuttle/midway{
	base_lighting_alpha = 0
	})
"vN" = (
/turf/closed/shuttle/midway/transparent{
	icon_state = "86a"
	},
/area/shuttle/midway{
	base_lighting_alpha = 0
	})
"wB" = (
/turf/closed/shuttle/midway{
	icon_state = "83"
	},
/area/shuttle/midway{
	base_lighting_alpha = 0
	})
"xp" = (
/turf/closed/shuttle/midway{
	icon_state = "62"
	},
/area/shuttle/midway{
	base_lighting_alpha = 0
	})
"ym" = (
/turf/closed/shuttle/midway{
	icon_state = "69"
	},
/area/shuttle/midway{
	base_lighting_alpha = 0
	})
"yB" = (
/turf/closed/shuttle/midway{
	icon_state = "54"
	},
/area/shuttle/midway{
	base_lighting_alpha = 0
	})
"yH" = (
/obj/structure/shuttle/part/midway/transparent/nosecone{
	icon_state = "100"
	},
/turf/template_noop,
/area/shuttle/midway{
	base_lighting_alpha = 0
	})
"yN" = (
/obj/structure/shuttle/part/midway/transparent{
	icon_state = "4"
	},
/turf/template_noop,
/area/shuttle/midway{
	base_lighting_alpha = 0
	})
"yO" = (
/obj/structure/shuttle/part/midway/transparent{
	icon_state = "61"
	},
/obj/effect/attach_point/weapon/midway/left_wing,
/turf/template_noop,
/area/shuttle/midway{
	base_lighting_alpha = 0
	})
"zm" = (
/turf/closed/shuttle/midway/transparent{
	icon_state = "23"
	},
/area/shuttle/midway{
	base_lighting_alpha = 0
	})
"zG" = (
/obj/structure/machinery/light/double{
	dir = 8
	},
/turf/open/shuttle/dropship/light_grey_single_wide_up_to_down,
/area/shuttle/midway{
	base_lighting_alpha = 0
	})
"Aa" = (
/obj/structure/blocker/forcefield/multitile_vehicles,
/obj/structure/machinery/door/airlock/hatch/cockpit/four,
/turf/open/shuttle/dropship/medium_grey_single_wide_up_to_down,
/area/shuttle/midway{
	base_lighting_alpha = 0
	})
"Aw" = (
/obj/structure/shuttle/part/midway/transparent{
	icon_state = "91"
	},
/obj/effect/attach_point/electronics/midway,
/turf/template_noop,
/area/shuttle/midway{
	base_lighting_alpha = 0
	})
"Bk" = (
/turf/open/shuttle/dropship/light_grey_single_wide_left_to_right,
/area/shuttle/midway{
	base_lighting_alpha = 0
	})
"Bn" = (
/turf/closed/shuttle/midway{
	icon_state = "30"
	},
/area/shuttle/midway{
	base_lighting_alpha = 0
	})
"BI" = (
/turf/closed/shuttle/midway{
	icon_state = "47"
	},
/area/shuttle/midway{
	base_lighting_alpha = 0
	})
"BS" = (
/turf/closed/shuttle/midway/transparent{
	icon_state = "38"
	},
/area/shuttle/midway{
	base_lighting_alpha = 0
	})
"BU" = (
/obj/structure/shuttle/part/midway/transparent{
	icon_state = "20"
	},
/turf/template_noop,
/area/shuttle/midway{
	base_lighting_alpha = 0
	})
"Ci" = (
/obj/structure/vehicle_locker/movie{
	pixel_y = 20;
	layer = 2.9
	},
/turf/open/shuttle/dropship/light_grey_top_left,
/area/shuttle/midway{
	base_lighting_alpha = 0
	})
"CX" = (
/obj/structure/stairs/perspective,
/obj/structure/platform{
	dir = 4;
	layer = 2.7
	},
/obj/structure/platform{
	dir = 8
	},
/turf/open/shuttle/dropship/light_grey_single_wide_up_to_down,
/area/shuttle/midway{
	base_lighting_alpha = 0
	})
"Db" = (
/turf/closed/shuttle/midway/transparent{
	icon_state = "26"
	},
/area/shuttle/midway{
	base_lighting_alpha = 0
	})
"Dg" = (
/obj/structure/shuttle/part/midway/transparent{
	icon_state = "70"
	},
/turf/template_noop,
/area/shuttle/midway{
	base_lighting_alpha = 0
	})
"DO" = (
/obj/structure/machinery/light{
	dir = 4;
	pixel_x = 14
	},
/obj/structure/machinery/light/double{
	dir = 4
	},
/turf/open/shuttle/dropship/light_grey_single_wide_up_to_down,
/area/shuttle/midway{
	base_lighting_alpha = 0
	})
"Ed" = (
/turf/closed/shuttle/midway{
	icon_state = "25"
	},
/area/shuttle/midway{
	base_lighting_alpha = 0
	})
"Fd" = (
/turf/open/shuttle/dropship/medium_grey_single_wide_up_to_down,
/area/shuttle/midway{
	base_lighting_alpha = 0
	})
"Fu" = (
/obj/structure/shuttle/part/midway/transparent{
	icon_state = "74"
	},
/turf/template_noop,
/area/shuttle/midway{
	base_lighting_alpha = 0
	})
"Gf" = (
/obj/structure/shuttle/part/midway/transparent{
	icon_state = "99a"
	},
/turf/template_noop,
/area/shuttle/midway{
	base_lighting_alpha = 0
	})
"Gk" = (
/obj/structure/bed/chair/dropship/passenger{
	dir = 4
	},
/obj/structure/machinery/cm_vending/sorted/medical/wall_med{
	pixel_y = 26;
	pixel_x = 8
	},
/obj/structure/extinguisher_cabinet/lifeboat{
	pixel_y = 27;
	pixel_x = -4
	},
/turf/open/shuttle/dropship/medium_grey_single_wide_up_to_down,
/area/shuttle/midway{
	base_lighting_alpha = 0
	})
"Hj" = (
/turf/closed/shuttle/midway{
	icon_state = "75"
	},
/area/shuttle/midway{
	base_lighting_alpha = 0
	})
"Hz" = (
/obj/structure/shuttle/part/midway/transparent{
	icon_state = "3"
	},
/turf/template_noop,
/area/shuttle/midway{
	base_lighting_alpha = 0
	})
"Ji" = (
/turf/closed/shuttle/midway{
	icon_state = "64"
	},
/area/shuttle/midway{
	base_lighting_alpha = 0
	})
"Jn" = (
/obj/structure/machinery/camera/autoname/golden_arrow/midway{
	dir = 4;
	pixel_x = -23
	},
/turf/open/shuttle/dropship/light_grey_single_wide_up_to_down,
/area/shuttle/midway{
	base_lighting_alpha = 0
	})
"Jq" = (
/turf/closed/shuttle/midway{
	icon_state = "72"
	},
/area/shuttle/midway{
	base_lighting_alpha = 0
	})
"Ks" = (
/obj/structure/shuttle/part/midway/transparent{
	icon_state = "71"
	},
/turf/template_noop,
/area/shuttle/midway{
	base_lighting_alpha = 0
	})
"Kw" = (
/turf/template_noop,
/area/template_noop)
"Ln" = (
/obj/effect/attach_point/crew_weapon/midway{
	attach_id = 7
	},
/obj/docking_port/mobile/marine_dropship/midway,
/turf/open/shuttle/dropship/medium_grey_single_wide_up_to_down,
/area/shuttle/midway{
	base_lighting_alpha = 0
	})
"Lr" = (
/turf/closed/shuttle/midway{
	icon_state = "48"
	},
/area/shuttle/midway{
	base_lighting_alpha = 0
	})
"LZ" = (
/obj/structure/shuttle/part/midway/transparent{
	icon_state = "84"
	},
/obj/effect/attach_point/electronics/midway,
/turf/template_noop,
/area/shuttle/midway{
	base_lighting_alpha = 0
	})
"Mw" = (
/obj/structure/shuttle/part/midway/transparent{
	icon_state = "85"
	},
/obj/effect/attach_point/weapon/midway/left_fore,
/turf/template_noop,
/area/shuttle/midway{
	base_lighting_alpha = 0
	})
"NK" = (
/obj/structure/platform_decoration{
	dir = 4
	},
/obj/structure/platform_decoration{
	dir = 8
	},
/turf/open/shuttle/dropship/light_grey_single_wide_up_to_down,
/area/shuttle/midway{
	base_lighting_alpha = 0
	})
"Pc" = (
/turf/closed/shuttle/midway/transparent{
	icon_state = "78"
	},
/area/shuttle/midway{
	base_lighting_alpha = 0
	})
"PG" = (
/turf/closed/shuttle/midway/transparent{
	icon_state = "97a"
	},
/area/shuttle/midway{
	base_lighting_alpha = 0
	})
"PW" = (
/obj/structure/bed/chair/dropship/passenger{
	dir = 8
	},
/turf/open/shuttle/dropship/medium_grey_single_wide_up_to_down,
/area/shuttle/midway{
	base_lighting_alpha = 0
	})
"Qk" = (
/obj/structure/shuttle/part/midway/transparent{
	icon_state = "15"
	},
/obj/structure/shuttle/part/midway/transparent{
	icon_state = "40"
	},
/turf/template_noop,
/area/shuttle/midway{
	base_lighting_alpha = 0
	})
"SZ" = (
/obj/structure/shuttle/part/midway/transparent{
	icon_state = "5"
	},
/turf/template_noop,
/area/shuttle/midway{
	base_lighting_alpha = 0
	})
"Tf" = (
/obj/effect/attach_point/fuel/midway{
	attach_id = 10;
	dir = 1
	},
/turf/closed/shuttle/midway/transparent{
	icon_state = "28"
	},
/area/shuttle/midway{
	base_lighting_alpha = 0
	})
"TE" = (
/turf/open/shuttle/dropship/light_grey_bottom_left,
/area/shuttle/midway{
	base_lighting_alpha = 0
	})
"Uj" = (
/obj/structure/vehicle_locker/movie{
	pixel_y = 20;
	layer = 2.9
	},
/turf/open/shuttle/dropship/light_grey_top_right,
/area/shuttle/midway{
	base_lighting_alpha = 0
	})
"UI" = (
/obj/structure/shuttle/part/midway/transparent{
	icon_state = "90"
	},
/obj/effect/attach_point/weapon/midway/right_fore,
/turf/template_noop,
/area/shuttle/midway{
	base_lighting_alpha = 0
	})
"Vi" = (
/obj/structure/bed/chair/vehicle/dropship_cockpit/pilot{
	dir = 1;
	pixel_x = 6;
	pixel_y = 8
	},
/obj/structure/machinery/computer/shuttle/dropship/flight/small{
	pixel_y = 16;
	pixel_x = 6
	},
/obj/structure/phone_base{
	dir = 4;
	pixel_x = -19;
	pixel_y = 12;
	layer = 3.1;
	phone_category = "Dropship";
	name = "Midway telephone receiver";
	phone_id = "Midway"
	},
/obj/structure/machinery/light/small{
	light_color = "#C02526";
	color = "#C02526";
	dir = 4;
	pixel_y = 15;
	breakable = 0
	},
/turf/open/shuttle/dropship/medium_grey_single_wide_up_to_down,
/area/shuttle/midway{
	base_lighting_alpha = 0
	})
"Vu" = (
/turf/closed/shuttle/midway{
	icon_state = "67"
	},
/area/shuttle/midway{
	base_lighting_alpha = 0
	})
"VU" = (
/turf/closed/shuttle/midway{
	icon_state = "73"
	},
/area/shuttle/midway{
	base_lighting_alpha = 0
	})
"WF" = (
/obj/effect/decal/warning_stripes{
	icon_state = "S";
	pixel_y = 2
	},
/obj/effect/decal/warning_stripes{
	icon_state = "N";
	pixel_y = -1
	},
/turf/open/shuttle/dropship/medium_grey_single_wide_left_to_right,
/area/shuttle/midway{
	base_lighting_alpha = 0
	})
"XS" = (
/turf/open/shuttle/dropship/light_grey_single_wide_up_to_down,
/area/shuttle/midway{
	base_lighting_alpha = 0
	})
"Yr" = (
/turf/closed/shuttle/midway{
	icon_state = "81"
	},
/area/shuttle/midway{
	base_lighting_alpha = 0
	})
"Zr" = (
/obj/structure/shuttle/part/midway/transparent{
	icon_state = "66"
	},
/turf/template_noop,
/area/shuttle/midway{
	base_lighting_alpha = 0
	})
"Zu" = (
/turf/closed/shuttle/midway/transparent{
	icon_state = "29"
	},
/area/shuttle/midway{
	base_lighting_alpha = 0
	})
"ZZ" = (
/turf/closed/shuttle/midway/transparent{
	icon_state = "39"
	},
/area/shuttle/midway{
	base_lighting_alpha = 0
	})

(1,1,1) = {"
Kw
Kw
Kw
Kw
Kw
Ks
Zr
yO
Kw
ul
af
Tf
dD
BU
Kw
mE
"}
(2,1,1) = {"
Kw
Kw
Kw
LZ
Hj
Jq
Vu
xp
dE
gw
ls
Zu
zm
bm
Kw
eu
"}
(3,1,1) = {"
Kw
Kw
Kw
Mw
Yr
Gk
mA
tT
mA
BI
dE
Bn
hl
rr
dB
Hz
"}
(4,1,1) = {"
yH
hL
ti
vN
Pc
Ci
XS
TE
CX
NK
XS
Jn
zG
us
Kw
Kw
"}
(5,1,1) = {"
oG
PG
Vi
vD
Aa
Bk
oy
Bk
Ln
fF
Fd
cK
Fd
WF
Kw
Kw
"}
(6,1,1) = {"
ut
Gf
od
ux
ro
Uj
XS
dd
aP
NK
XS
XS
DO
WF
Kw
Kw
"}
(7,1,1) = {"
Kw
Kw
Kw
UI
rq
kL
PW
oB
PW
Lr
yB
sl
Ed
lC
mh
yN
"}
(8,1,1) = {"
Kw
Kw
Kw
Aw
wB
VU
ym
Ji
yB
Qk
BS
rR
Db
BU
Kw
SZ
"}
(9,1,1) = {"
Kw
Kw
Kw
Kw
Kw
Fu
Dg
hO
Kw
mG
ZZ
eS
if
bm
Kw
tP
"}
