"ab" = (/obj/structure/machinery/computer/cameras/dropship/rasputin{icon = 'icons/obj/structures/machinery/computer.dmi'; icon_state = "jas"; layer = 3.1; pixel_x = -24; pixel_y = -11},/turf/closed/shuttle/rasputin{dir = 8; icon_state = "dwall25"},/area/shuttle/rasputin)
"ac" = (/turf/closed/shuttle/rasputin{icon_state = "dwall27"},/area/shuttle/rasputin)
"ad" = (/obj/structure/shuttle/part/rasputin/corner_single{dir = 4},/turf/template_noop,/area/shuttle/rasputin)
"ae" = (/obj/structure/shuttle/part/rasputin/transparent/inner_left_weapons,/obj/effect/attach_point/electronics/rasputin,/turf/template_noop,/area/shuttle/rasputin)
"ag" = (/turf/open/shuttle/dropship,/area/shuttle/rasputin)
"aM" = (/turf/closed/shuttle/rasputin{icon_state = "dwall25"},/area/shuttle/rasputin)
"aN" = (/obj/structure/shuttle/part/rasputin/transparent/inner_right_weapons,/obj/effect/attach_point/electronics/rasputin,/turf/template_noop,/area/shuttle/rasputin)
"bj" = (/obj/structure/machinery/light{dir = 4},/obj/effect/landmark/start/marine/alpha,/obj/effect/landmark/late_join/alpha,/turf/open/shuttle/dropship{icon_state = "rasputin3"},/area/shuttle/rasputin)
"bV" = (/obj/structure/shuttle/part/rasputin/corner{dir = 1},/turf/template_noop,/area/shuttle/rasputin)
"ca" = (/obj/structure/largecrate/supply/supplies/mre,/turf/open/shuttle/dropship{icon_state = "rasputin15"},/area/shuttle/rasputin)
"cj" = (/obj/structure/shuttle/part/rasputin/transparent/window{dir = 8},/turf/open/floor/plating,/area/shuttle/rasputin)
"dp" = (/turf/closed/shuttle/rasputin{icon_state = "dwall28"},/area/shuttle/rasputin)
"ei" = (/obj/structure/shuttle/part/rasputin/corner{dir = 8},/turf/template_noop,/area/shuttle/rasputin)
"gx" = (/turf/closed/shuttle/rasputin{icon_state = "dwall13"},/area/shuttle/rasputin)
"gy" = (/turf/closed/shuttle/rasputin{icon_state = "dwall39"},/area/shuttle/rasputin)
"hX" = (/obj/structure/shuttle/part/rasputin/transparent/outer_right_weapons,/obj/effect/attach_point/weapon/rasputin/right_fore,/turf/template_noop,/area/shuttle/rasputin)
"iy" = (/turf/closed/shuttle/rasputin{icon_state = "dwall16"},/area/shuttle/rasputin)
"iP" = (/obj/structure/machinery/computer/dropship_weapons/rasputin{dir = 8; icon = 'icons/obj/structures/machinery/computer.dmi'; icon_state = "overwatch"; pixel_x = 18; pixel_y = 1},/turf/closed/shuttle/rasputin{dir = 4; icon_state = "dwall25"},/area/shuttle/rasputin)
"ji" = (/obj/effect/attach_point/computer/rasputin,/obj/item/storage/box/nade_box{pixel_x = 10; pixel_y = 11},/obj/item/storage/belt/utility/full,/obj/effect/landmark/observer_start,/turf/open/shuttle/dropship{icon_state = "rasputin15"},/area/shuttle/rasputin)
"jA" = (/obj/item/device/cotablet,/turf/open/shuttle/dropship{icon_state = "rasputin3"},/area/shuttle/rasputin)
"km" = (/obj/item/stack/sheet/plasteel{amount = 40; pixel_x = 7; pixel_y = 25},/obj/item/clothing/mask/gas,/obj/effect/landmark/start/marine/smartgunner/alpha,/obj/effect/landmark/late_join/alpha,/turf/open/shuttle/dropship{icon_state = "rasputin3"},/area/shuttle/rasputin)
"kw" = (/obj/item/storage/box/m94{pixel_x = 8; pixel_y = 11},/obj/item/tool/screwdriver,/obj/effect/landmark/start/marine/smartgunner/alpha,/obj/effect/landmark/late_join/alpha,/turf/open/shuttle/dropship{icon_state = "rasputin3"},/area/shuttle/rasputin)
"kM" = (/turf/closed/shuttle/rasputin{dir = 1; icon_state = "dwall39"},/area/shuttle/rasputin)
"lg" = (/turf/closed/shuttle/rasputin{dir = 8; icon_state = "dwall39"},/area/shuttle/rasputin)
"lp" = (/turf/closed/shuttle/rasputin{dir = 4; icon_state = "dwall28"},/area/shuttle/rasputin)
"mi" = (/obj/structure/closet/crate/secure/gear{name = "platoon sergeant gear"; req_one_access = list(12)},/obj/item/clothing/head/helmet/marine/leader,/obj/item/device/binoculars/range/designator,/obj/item/weapon/gun/rifle/m4ra,/obj/item/ammo_magazine/rifle/m4ra/ext,/obj/item/ammo_magazine/rifle/m4ra/ext,/obj/item/ammo_magazine/rifle/m4ra/ext,/obj/item/attachable/bipod,/obj/item/attachable/lasersight,/obj/item/attachable/scope/mini_iff,/obj/item/attachable/scope,/turf/open/shuttle/dropship{icon_state = "rasputin3"},/area/shuttle/rasputin)
"mQ" = (/turf/closed/shuttle/rasputin{dir = 4; icon_state = "dwall39"},/area/shuttle/rasputin)
"mU" = (/obj/structure/shuttle/part/rasputin/corner_single{dir = 8},/turf/template_noop,/area/shuttle/rasputin)
"nw" = (/turf/closed/shuttle/rasputin{dir = 4},/area/shuttle/rasputin)
"nJ" = (/turf/closed/shuttle/rasputin{dir = 8; icon_state = "dwall25"},/area/shuttle/rasputin)
"pm" = (/obj/item/prop/almayer/comp_open{pixel_x = -19; pixel_y = 27},/obj/item/clothing/head/helmet/marine/rto{pixel_x = -24; pixel_y = 27},/obj/item/clothing/head/helmet/marine/rto{pixel_x = -9; pixel_y = 13},/obj/item/clothing/accessory/storage/droppouch{pixel_x = 14; pixel_y = 25},/obj/item/stack/sheet/metal{amount = 50},/obj/item/stack/sheet/metal{amount = 50; pixel_y = 4},/turf/open/shuttle/dropship{icon_state = "rasputin3"},/area/shuttle/rasputin)
"pG" = (/obj/structure/bed/chair/vehicle{pixel_x = 8},/obj/structure/bed/chair/vehicle{pixel_x = -8},/obj/effect/landmark/start/marine/alpha,/obj/effect/landmark/late_join/alpha,/turf/open/shuttle/dropship{icon_state = "rasputin15"},/area/shuttle/rasputin)
"qH" = (/turf/open/shuttle/dropship{icon_state = "rasputin15"},/area/shuttle/rasputin)
"rf" = (/obj/structure/closet/crate/secure/gear{name = "smargunner gear"},/obj/item/weapon/gun/smartgun{pixel_y = -4},/obj/item/weapon/gun/smartgun,/obj/item/smartgun_battery,/obj/item/smartgun_battery,/obj/item/clothing/suit/storage/marine/smartgunner{pixel_x = 4},/obj/item/clothing/suit/storage/marine/smartgunner{pixel_x = -4},/obj/item/storage/belt/marine/smartgunner,/obj/item/storage/belt/marine/smartgunner,/obj/item/ammo_magazine/smartgun,/obj/item/ammo_magazine/smartgun,/obj/item/ammo_magazine/smartgun,/obj/item/ammo_magazine/smartgun,/turf/open/shuttle/dropship{icon_state = "rasputin15"},/area/shuttle/rasputin)
"rr" = (/obj/structure/shuttle/engine/propulsion,/obj/structure/shuttle/engine/heater{pixel_y = 32},/turf/open/floor/plating,/area/shuttle/rasputin)
"rB" = (/turf/template_noop,/area/space)
"rI" = (/obj/structure/closet/crate/secure/gear,/obj/item/defenses/handheld/sentry{pixel_x = -7},/obj/item/defenses/handheld/sentry{pixel_x = 7},/obj/item/defenses/handheld/sentry{pixel_x = -7},/obj/item/defenses/handheld/sentry{pixel_x = 7},/obj/item/ammo_magazine/sentry{layer = 3.01},/obj/item/ammo_magazine/sentry{layer = 3.01},/obj/item/ammo_magazine/sentry{layer = 3.01},/obj/item/ammo_magazine/sentry{layer = 3.01},/obj/item/device/sentry_computer{pixel_x = 5; pixel_y = 3},/obj/item/cell/apc{pixel_x = 7},/obj/item/device/encryptionkey/sentry_laptop{pixel_x = -8; pixel_y = 9},/obj/item/device/encryptionkey/sentry_laptop{pixel_x = -8},/turf/open/shuttle/dropship{icon_state = "rasputin15"},/area/shuttle/rasputin)
"rW" = (/obj/structure/shuttle/part/dropship1/transparent/engine_right_cap,/turf/template_noop,/area/shuttle/rasputin)
"sp" = (/obj/structure/closet/crate/secure/weyland,/obj/item/defenses/handheld/bell_tower/md_radio,/obj/item/defenses/handheld/bell_tower/md_radio,/obj/item/defenses/handheld/bell_tower/md_radio{pixel_x = -8},/obj/item/defenses/handheld/bell_tower/md_radio{pixel_x = -8},/obj/item/defenses/handheld/bell_tower/md_radio{pixel_x = 8},/obj/item/defenses/handheld/bell_tower/md_radio{pixel_x = 8},/turf/open/shuttle/dropship{icon_state = "rasputin3"},/area/shuttle/rasputin)
"ss" = (/obj/structure/platform_decoration{dir = 8},/obj/effect/decal/warning_stripes{icon_state = "N"; pixel_y = 1},/obj/item/clothing/glasses/hud/health{pixel_x = -8; pixel_y = 12},/turf/open/shuttle/dropship{icon_state = "rasputin6"},/area/shuttle/rasputin)
"sB" = (/obj/structure/bed/chair/vehicle{dir = 1; pixel_y = 17},/obj/effect/decal/warning_stripes{icon_state = "E-corner"},/obj/effect/decal/warning_stripes{icon_state = "W-corner"},/obj/structure/machinery/light{dir = 8},/obj/effect/landmark/late_join/alpha,/turf/open/shuttle/dropship{icon_state = "rasputin15"},/area/shuttle/rasputin)
"sX" = (/obj/item/prop/helmetgarb/gunoil{pixel_x = 20; pixel_y = 21},/obj/structure/bed/bedroll{dir = 4; pixel_y = 11},/obj/item/weapon/gun/rifle/m41aMK1{pixel_y = -4},/obj/item/weapon/gun/rifle/m41aMK1{pixel_y = -11},/obj/item/storage/box/m56d/m2c{pixel_y = 20},/turf/open/shuttle/dropship{icon_state = "rasputin6"},/area/shuttle/rasputin)
"tf" = (/obj/structure/bed/bedroll{dir = 5; pixel_y = 8},/obj/structure/bed/bedroll{icon_state = "bedroll"; pixel_x = 5; pixel_y = -5},/obj/effect/landmark/start/marine/medic/alpha,/obj/effect/landmark/late_join/alpha,/turf/open/shuttle/dropship{icon_state = "rasputin15"},/area/shuttle/rasputin)
"ti" = (/obj/structure/bed/chair/vehicle{pixel_x = -8},/obj/structure/bed/chair/vehicle{pixel_x = 8},/obj/structure/extinguisher_cabinet/lifeboat{pixel_x = 7; pixel_y = 29},/obj/effect/landmark/start/marine/alpha,/obj/effect/landmark/late_join/alpha,/turf/open/shuttle/dropship{icon_state = "rasputin14"},/area/shuttle/rasputin)
"tj" = (/obj/structure/bed/chair/vehicle{dir = 1; pixel_x = 8},/obj/effect/decal/warning_stripes{icon_state = "E-corner"},/obj/effect/decal/warning_stripes{icon_state = "W-corner"},/obj/effect/landmark/late_join/alpha,/turf/open/shuttle/dropship{icon_state = "rasputin15"},/area/shuttle/rasputin)
"uN" = (/obj/structure/machinery/door/airlock/hatch/cockpit/three,/turf/open/shuttle/dropship{icon_state = "rasputin15"},/area/shuttle/rasputin)
"vt" = (/obj/structure/machinery/door_control{id = "dropship_rasputin"; name = "Dropship Lockdown"; normaldoorcontrol = 3; pixel_y = -19; req_one_access_txt = "3;22"},/obj/effect/attach_point/computer/rasputin,/obj/structure/largecrate/supply/ammo/m41amk1{name = "\improper M41A magazine case (x10)"; pixel_y = 13; supplies = list(/obj/item/ammo_magazine/rifle/m41aMK1 = 10)},/obj/structure/largecrate/supply/ammo/m41amk1{name = "\improper M41A magazine case (x10)"; supplies = list(/obj/item/ammo_magazine/rifle/m41aMK1 = 10)},/obj/item/weapon/gun/rifle/m41aMK1{pixel_y = 12},/obj/item/weapon/gun/rifle/m41aMK1{pixel_y = 4},/obj/item/weapon/gun/rifle/m41aMK1{pixel_y = 8},/turf/open/shuttle/dropship{icon_state = "rasputin15"},/area/shuttle/rasputin)
"vO" = (/obj/structure/bed/chair/vehicle{pixel_x = -8},/obj/structure/bed/chair/vehicle{pixel_x = 8},/obj/structure/machinery/light{dir = 1},/obj/effect/landmark/start/marine/alpha,/obj/effect/landmark/late_join/alpha,/turf/open/shuttle/dropship{icon_state = "rasputin15"},/area/shuttle/rasputin)
"wo" = (/turf/closed/shuttle/rasputin{dir = 4; icon_state = "dwall37"},/area/shuttle/rasputin)
"wr" = (/obj/structure/machinery/cm_vending/sorted/medical/wall_med{pixel_x = -30},/obj/structure/bed/chair/vehicle{dir = 4; layer = 3.1; pixel_x = -6; pixel_y = 17},/obj/structure/bed/chair/vehicle{dir = 4; layer = 3.1; pixel_x = -6},/obj/effect/landmark/start/marine/alpha,/obj/effect/landmark/late_join/alpha,/turf/open/shuttle/dropship{icon_state = "rasputin15"},/area/shuttle/rasputin)
"wI" = (/obj/effect/attach_point/fuel/rasputin,/turf/closed/shuttle/rasputin{icon_state = "dwall37"},/area/shuttle/rasputin)
"xl" = (/obj/structure/bed/bedroll{dir = 1; pixel_y = 27},/obj/structure/bed/bedroll{dir = 1; pixel_y = 11},/obj/structure/bed/bedroll{dir = 1; pixel_y = -5},/obj/effect/landmark/start/marine/alpha,/obj/effect/landmark/late_join/alpha,/turf/open/shuttle/dropship{icon_state = "rasputin3"},/area/shuttle/rasputin)
"yf" = (/obj/structure/machinery/door/airlock/dropship_hatch/three{id = "port_door"},/turf/open/shuttle/dropship{icon_state = "rasputin15"},/area/shuttle/rasputin)
"yx" = (/turf/open/shuttle/dropship{icon_state = "rasputin7"},/area/shuttle/rasputin)
"yM" = (/obj/structure/bed/chair/vehicle{dir = 1; pixel_x = -8},/obj/structure/bed/chair/vehicle{dir = 1; pixel_x = 8},/obj/effect/landmark/start/marine/alpha,/obj/effect/landmark/late_join/alpha,/turf/open/shuttle/dropship{icon_state = "rasputin15"},/area/shuttle/rasputin)
"yP" = (/obj/structure/shuttle/part/rasputin/transparent/outer_left_weapons,/obj/effect/attach_point/weapon/rasputin/left_fore,/turf/template_noop,/area/shuttle/rasputin)
"BY" = (/obj/structure/bed/bedroll{dir = 1; pixel_y = 26},/obj/structure/machinery/cm_vending/sorted/medical/no_access/crate{anchored = 0; needs_power = 0; use_power = 0},/turf/open/shuttle/dropship{icon_state = "rasputin15"},/area/shuttle/rasputin)
"Eg" = (/obj/structure/platform_decoration{dir = 4},/obj/effect/decal/warning_stripes{icon_state = "N"; pixel_y = 1},/obj/structure/bed/bedroll{dir = 4; pixel_y = -1},/obj/effect/landmark/start/marine/tl/alpha,/obj/effect/landmark/late_join/alpha,/turf/open/shuttle/dropship{icon_state = "rasputin7"},/area/shuttle/rasputin)
"Ii" = (/obj/structure/machinery/camera/autoname/golden_arrow/rasputin{dir = 8; icon_state = "autocam_editor"; pixel_x = 17},/obj/structure/bed/chair/vehicle{dir = 8; layer = 3.1; pixel_x = 6; pixel_y = 17},/obj/structure/bed/chair/vehicle{dir = 8; layer = 3.1; pixel_x = 6},/obj/effect/landmark/start/marine/alpha,/obj/effect/landmark/late_join/alpha,/turf/open/shuttle/dropship{icon_state = "rasputin15"},/area/shuttle/rasputin)
"Iv" = (/turf/closed/shuttle/rasputin{dir = 4; icon_state = "dwall38"},/area/shuttle/rasputin)
"IB" = (/obj/structure/shuttle/part/rasputin/corner{dir = 4},/turf/template_noop,/area/shuttle/rasputin)
"II" = (/obj/structure/machinery/door/airlock/dropship_hatch/three{dir = 1; id = "starboard_door"},/turf/open/shuttle/dropship{icon_state = "rasputin15"},/area/shuttle/rasputin)
"Jr" = (/turf/closed/shuttle/rasputin{icon_state = "dwall15"},/area/shuttle/rasputin)
"JX" = (/turf/closed/shuttle/rasputin{dir = 1; icon_state = "dwall38"},/area/shuttle/rasputin)
"Kd" = (/turf/closed/shuttle/rasputin{icon_state = "dwall10"},/area/shuttle/rasputin)
"Kh" = (/obj/docking_port/mobile/marine_dropship/rasputin,/obj/item/device/motiondetector{pixel_x = -15; pixel_y = 12},/obj/item/device/motiondetector{pixel_x = -7; pixel_y = 4},/turf/open/shuttle/dropship{icon_state = "rasputin15"},/area/shuttle/rasputin)
"KE" = (/obj/structure/shuttle/part/rasputin/corner,/turf/template_noop,/area/shuttle/rasputin)
"Md" = (/obj/structure/platform{dir = 8; layer = 2.7},/obj/structure/stairs/perspective,/turf/open/shuttle/dropship{icon_state = "rasputin3"},/area/shuttle/rasputin)
"Mw" = (/obj/structure/bed/bedroll{dir = 4; pixel_x = -25; pixel_y = 12},/obj/effect/landmark/start/marine/medic/alpha,/obj/effect/landmark/late_join/alpha,/turf/open/shuttle/dropship{icon_state = "rasputin15"},/area/shuttle/rasputin)
"Mx" = (/turf/closed/shuttle/rasputin{dir = 1; icon_state = "dwall25"},/area/shuttle/rasputin)
"MQ" = (/obj/structure/shuttle/part/rasputin/transparent/window,/turf/open/floor/plating,/area/shuttle/rasputin)
"NO" = (/obj/structure/machinery/door/airlock/multi_tile/almayer/dropshiprear/ds3{id = "aft_door"},/turf/open/shuttle/dropship{icon_state = "rasputin15"},/area/shuttle/rasputin)
"NQ" = (/obj/structure/shuttle/part/dropship1/transparent/engine_left_cap,/turf/template_noop,/area/shuttle/rasputin)
"Oj" = (/turf/closed/shuttle/rasputin{dir = 4; icon_state = "dwall35"},/area/shuttle/rasputin)
"OA" = (/obj/structure/shuttle/part/rasputin/tail{dir = 1},/turf/template_noop,/area/shuttle/rasputin)
"OD" = (/turf/closed/shuttle/rasputin{icon_state = "dwall9"},/area/shuttle/rasputin)
"OS" = (/obj/effect/attach_point/fuel/rasputin{pixel_x = -32},/turf/closed/shuttle/rasputin{dir = 1; icon_state = "dwall37"},/area/shuttle/rasputin)
"Pl" = (/obj/structure/shuttle/part/rasputin/engine,/turf/template_noop,/area/shuttle/rasputin)
"Qj" = (/turf/closed/shuttle/rasputin{icon_state = "dwall38"},/area/shuttle/rasputin)
"Rc" = (/obj/structure/machinery/door_control{id = "dropship_rasputin"; name = "Dropship Lockdown"; normaldoorcontrol = 3; pixel_y = -19; req_one_access_txt = "3;22"},/obj/effect/attach_point/computer/rasputin,/obj/structure/machinery/cm_vending/clothing/medic/crate{anchored = 0; needs_power = 0; use_power = 0},/obj/item/prop/almayer/box{desc = "A blackbox"; name = "ALMAYER BLACKBOX"; pixel_x = -2; pixel_y = 5},/turf/open/shuttle/dropship{icon_state = "rasputin15"},/area/shuttle/rasputin)
"Rt" = (/turf/closed/shuttle/rasputin{icon_state = "dwall24"},/area/shuttle/rasputin)
"Rv" = (/obj/structure/machinery/camera/autoname/golden_arrow/rasputin{dir = 4; icon_state = "autocam_editor"; pixel_x = -17},/turf/open/shuttle/dropship{icon_state = "rasputin3"},/area/shuttle/rasputin)
"Rx" = (/turf/closed/shuttle/rasputin{dir = 8; icon_state = "dwall37"},/area/shuttle/rasputin)
"RO" = (/obj/structure/shuttle/part/rasputin/tail{dir = 6},/turf/template_noop,/area/shuttle/rasputin)
"RY" = (/obj/structure/machinery/cm_vending/sorted/medical/wall_med{pixel_x = 30},/obj/structure/closet/crate/secure/gear,/obj/item/weapon/gun/rifle/m41aMK1,/obj/item/weapon/gun/rifle/m41aMK1,/obj/item/weapon/gun/rifle/m41aMK1,/obj/item/weapon/gun/rifle/m41aMK1,/obj/item/weapon/gun/rifle/m41aMK1,/obj/item/ammo_magazine/shotgun/buckshot/special,/obj/item/weapon/gun/shotgun/pump/special,/obj/item/ammo_magazine/shotgun/buckshot/special,/obj/item/weapon/gun/shotgun/pump/special,/turf/open/shuttle/dropship{icon_state = "rasputin3"},/area/shuttle/rasputin)
"Sx" = (/turf/open/shuttle/dropship{icon_state = "rasputin3"},/area/shuttle/rasputin)
"ST" = (/obj/structure/bed/bedroll{dir = 1; pixel_y = 10},/obj/structure/bed/bedroll{dir = 1; pixel_y = -5},/obj/effect/landmark/start/marine/alpha,/obj/effect/landmark/late_join/alpha,/turf/open/shuttle/dropship{icon_state = "rasputin15"},/area/shuttle/rasputin)
"Tu" = (/obj/structure/bed/chair/vehicle{pixel_x = 8},/obj/structure/bed/chair/vehicle{pixel_x = -8},/obj/structure/machinery/light{dir = 1},/obj/effect/landmark/start/marine/alpha,/obj/effect/landmark/late_join/alpha,/turf/open/shuttle/dropship{icon_state = "rasputin15"},/area/shuttle/rasputin)
"TL" = (/obj/structure/shuttle/part/rasputin/engine{dir = 1},/turf/template_noop,/area/shuttle/rasputin)
"Ve" = (/turf/closed/shuttle/rasputin{icon_state = "dwall7"},/area/shuttle/rasputin)
"Vm" = (/obj/structure/machinery/computer/shuttle/dropship/flight{icon = 'icons/obj/structures/machinery/computer.dmi'; icon_state = "syndishuttle1"; layer = 3.1; pixel_y = 7},/obj/effect/decal/warning_stripes{icon_state = "S-corner"},/obj/structure/blocker/invisible_wall,/turf/open/shuttle/dropship{icon_state = "rasputin15"},/area/shuttle/rasputin)
"Vp" = (/turf/closed/shuttle/rasputin{dir = 1; icon_state = "dwall35"},/area/shuttle/rasputin)
"Wk" = (/turf/closed/shuttle/rasputin{dir = 8},/area/shuttle/rasputin)
"Ww" = (/obj/structure/machinery/light{dir = 8},/obj/effect/landmark/start/marine/leader/alpha,/obj/effect/landmark/late_join/alpha,/turf/open/shuttle/dropship{icon_state = "rasputin3"},/area/shuttle/rasputin)
"Wy" = (/turf/closed/shuttle/rasputin{icon_state = "dwall18"},/area/shuttle/rasputin)
"WE" = (/turf/closed/shuttle/rasputin{icon_state = "dwall20"},/area/shuttle/rasputin)
"WZ" = (/obj/structure/shuttle/part/rasputin/transparent/window{dir = 4},/turf/open/floor/plating,/area/shuttle/rasputin)
"Ym" = (/obj/item/prop/helmetgarb/trimmed_wire{pixel_x = 10},/obj/item/prop/helmetgarb/compass{pixel_x = 8; pixel_y = 7},/turf/open/shuttle/dropship{icon_state = "rasputin3"},/area/shuttle/rasputin)
"Yt" = (/obj/structure/platform{dir = 1},/obj/effect/decal/warning_stripes{icon_state = "N"; pixel_y = 1},/obj/structure/machinery/cm_vending/sorted/uniform_supply/squad_prep/crate{anchored = 0; needs_power = 0; use_power = 0},/obj/structure/machinery/cm_vending/sorted/cargo_guns/squad/crate{anchored = 0; layer = 3.02; needs_power = 0; pixel_y = 9; use_power = 0},/turf/open/shuttle/dropship{icon_state = "floor8"},/area/shuttle/rasputin)
"YX" = (/turf/closed/shuttle/rasputin{dir = 8; icon_state = "dwall38"},/area/shuttle/rasputin)
"Zh" = (/turf/closed/shuttle/rasputin{dir = 4; icon_state = "dwall25"},/area/shuttle/rasputin)
"Zp" = (/obj/structure/platform{dir = 4; layer = 2.7},/obj/structure/stairs/perspective,/obj/effect/landmark/start/marine/tl/alpha,/obj/effect/landmark/late_join/alpha,/turf/open/shuttle/dropship{icon_state = "rasputin3"},/area/shuttle/rasputin)
"Zx" = (/turf/closed/shuttle/rasputin{icon_state = "dwall35"},/area/shuttle/rasputin)
"Zz" = (/obj/structure/bed/chair/vehicle{pixel_x = -8},/obj/structure/bed/chair/vehicle{pixel_x = 8},/obj/item/dartboard{pixel_y = 27},/obj/item/weapon/gun/flamer{current_mag = null},/obj/item/ammo_magazine/flamer_tank{pixel_x = -6},/obj/item/ammo_magazine/flamer_tank{pixel_x = 6},/turf/open/shuttle/dropship{icon_state = "rasputin14"},/area/shuttle/rasputin)

(1,1,1) = {"
rBrBrBrBadMQmUrBrBrBrB
rBrBrBaecjVmWZaNrBrBrB
rByPbVacZhsBabaceihXrB
bVMxgyRtiPtjnJRtkMMxei
WkRtlgaMlpuNdpaMmQRtnw
nJaMZhvOtispZzTunJaMZh
ODrrODwrsXagyxIiODrrOD
rBrByfrIjAyMpmSTIIrBrB
rBrByftfYmpGkmrfIIrBrB
rBrBJrRcSxKhkwvtJrrBrB
rBrBKEWyZpjiMdiyIBrBrB
rBNQrWWEssYtEgWENQrWrB
rBQjIvWERvcaRYWEYXJXrB
rBwIwoWEWwMwbjWERxOSrB
rBZxOjWEmiBYxlWEZxVprB
rBPlTLWENOqHqHWEPlTLrB
rBrBrBWErBrBrBWErBrBrB
rBOAVegxrBrBrBKdVeROrB
"}
