//MAP CONVERTED BY dmm2tgm.py THIS HEADER COMMENT PREVENTS RECONVERSION, DO NOT REMOVE
"a" = (
/turf/closed/shuttle/ert{
	icon_state = "upp4"
	},
/area/shuttle/ert)
"b" = (
/obj/structure/barricade/handrail/strata{
	dir = 4
	},
/obj/effect/decal/warning_stripes{
	icon_state = "NW-out";
	pixel_y = 2
	},
/turf/open/floor/strata/multi_tiles/west,
/area/shuttle/ert)
"c" = (
/obj/structure/barricade/handrail/strata{
	dir = 4
	},
/obj/effect/decal/warning_stripes{
	icon_state = "W";
	layer = 3.3
	},
/turf/open/floor/plating/plating_catwalk/strata,
/area/shuttle/ert)
"e" = (
/obj/docking_port/mobile/emergency_response/ert3,
/turf/closed/shuttle/ert{
	icon_state = "leftengine_1";
	opacity = 0
	},
/area/shuttle/ert)
"f" = (
/obj/effect/decal/warning_stripes{
	icon_state = "S"
	},
/obj/structure/barricade/handrail/strata{
	dir = 4;
	can_buckle = 1
	},
/turf/open/floor/plating/plating_catwalk/strata,
/area/shuttle/ert)
"g" = (
/turf/closed/shuttle/ert{
	icon_state = "upp5"
	},
/area/shuttle/ert)
"i" = (
/turf/open/floor/strata/multi_tiles/west,
/area/shuttle/ert)
"j" = (
/turf/closed/shuttle/ert{
	icon_state = "upp_leftengine"
	},
/area/shuttle/ert)
"k" = (
/obj/effect/attach_point/crew_weapon/midway{
	attach_id = 9;
	ship_tag = "dropship_upp"
	},
/turf/open/floor/strata/multi_tiles/southwest,
/area/shuttle/ert)
"l" = (
/turf/closed/shuttle/ert{
	icon_state = "leftengine_2";
	opacity = 0
	},
/area/shuttle/ert)
"m" = (
/turf/closed/shuttle/ert{
	icon_state = "upp23"
	},
/area/shuttle/ert)
"o" = (
/obj/effect/decal/warning_stripes{
	icon_state = "W";
	layer = 3.3
	},
/obj/structure/bed/chair/vehicle{
	pixel_x = 9;
	dir = 8
	},
/turf/open/floor/plating/plating_catwalk/strata,
/area/shuttle/ert)
"p" = (
/turf/closed/shuttle/ert{
	icon_state = "upp_rightengine"
	},
/area/shuttle/ert)
"q" = (
/turf/closed/shuttle/ert{
	icon_state = "upp22"
	},
/area/shuttle/ert)
"r" = (
/turf/closed/shuttle/ert{
	icon_state = "rightengine_3";
	opacity = 0
	},
/area/shuttle/ert)
"s" = (
/obj/structure/barricade/handrail/strata{
	dir = 8
	},
/obj/effect/decal/warning_stripes{
	icon_state = "E"
	},
/turf/open/floor/plating/plating_catwalk/strata,
/area/shuttle/ert)
"t" = (
/obj/effect/decal/warning_stripes{
	icon_state = "S"
	},
/turf/open/floor/strata/multi_tiles/west,
/area/shuttle/ert)
"u" = (
/turf/closed/shuttle/ert{
	icon_state = "upp8"
	},
/area/shuttle/ert)
"v" = (
/turf/closed/shuttle/ert{
	icon_state = "upp21"
	},
/area/shuttle/ert)
"w" = (
/turf/open/floor/strata/floor3/east,
/area/shuttle/ert)
"x" = (
/turf/closed/shuttle/ert{
	icon_state = "upp3"
	},
/area/shuttle/ert)
"y" = (
/turf/closed/shuttle/ert{
	icon_state = "upp9"
	},
/area/shuttle/ert)
"z" = (
/turf/closed/shuttle/ert{
	icon_state = "upp20"
	},
/area/shuttle/ert)
"A" = (
/turf/closed/shuttle/ert{
	icon_state = "upp1"
	},
/area/shuttle/ert)
"B" = (
/obj/structure/barricade/handrail/strata{
	layer = 3.5
	},
/turf/open/floor/strata/floor3/east,
/area/shuttle/ert)
"C" = (
/obj/effect/decal/warning_stripes{
	icon_state = "W";
	layer = 3.3
	},
/obj/structure/gun_rack/type71,
/turf/open/floor/plating/plating_catwalk/strata,
/area/shuttle/ert)
"D" = (
/obj/effect/decal/warning_stripes{
	icon_state = "N";
	pixel_y = 1
	},
/turf/open/floor/strata/floor3/east,
/area/shuttle/ert)
"E" = (
/turf/closed/shuttle/ert{
	icon_state = "upp25"
	},
/area/shuttle/ert)
"F" = (
/turf/closed/shuttle/ert{
	icon_state = "rightengine_1";
	opacity = 0
	},
/area/shuttle/ert)
"H" = (
/obj/structure/largecrate/random/barrel/red{
	stuff = list(/obj/item/clothing/under/marine/veteran/UPP,/obj/item/clothing/gloves/marine,/obj/item/clothing/gloves/marine/brown,/obj/item/clothing/gloves/marine/joe,/obj/item/clothing/shoes/marine/joe,/obj/item/clothing/shoes/marine/upp/guard,/obj/item/clothing/shoes/marine/upp);
	anchored = 1
	},
/turf/open/floor/plating/plating_catwalk/strata,
/area/shuttle/ert)
"I" = (
/turf/closed/shuttle/ert{
	icon_state = "upp27";
	opacity = 0
	},
/area/shuttle/ert)
"J" = (
/obj/structure/largecrate/supply/ammo/type71{
	parts_type = /obj/item/stack/sheet/metal;
	pixel_x = 1;
	anchored = 1
	},
/obj/structure/largecrate/random/case{
	stuff = list(/obj/item/weapon/shield/riot/metal,/obj/item/weapon/classic_baton);
	parts_type = /obj/item/stack/sheet/metal;
	pixel_y = 11;
	pixel_x = 3;
	anchored = 1
	},
/turf/open/floor/plating/plating_catwalk/strata,
/area/shuttle/ert)
"K" = (
/turf/template_noop,
/area/template_noop)
"L" = (
/obj/structure/barricade/handrail/strata{
	dir = 8;
	can_buckle = 1
	},
/turf/open/floor/plating/plating_catwalk/strata,
/area/shuttle/ert)
"M" = (
/obj/structure/barricade/handrail/strata{
	dir = 4;
	can_buckle = 1
	},
/turf/open/floor/plating/plating_catwalk/strata,
/area/shuttle/ert)
"O" = (
/obj/structure/barricade/handrail/strata{
	dir = 8
	},
/obj/effect/decal/warning_stripes{
	icon_state = "NE-out";
	pixel_y = 1
	},
/turf/open/floor/strata/multi_tiles/west,
/area/shuttle/ert)
"P" = (
/turf/closed/shuttle/ert{
	icon_state = "leftengine_3";
	opacity = 0
	},
/area/shuttle/ert)
"Q" = (
/turf/closed/shuttle/ert{
	icon_state = "upp16"
	},
/area/shuttle/ert)
"T" = (
/obj/effect/decal/warning_stripes{
	icon_state = "S"
	},
/obj/structure/barricade/handrail/strata{
	dir = 8;
	can_buckle = 1
	},
/turf/open/floor/plating/plating_catwalk/strata,
/area/shuttle/ert)
"U" = (
/obj/effect/decal/warning_stripes{
	icon_state = "N";
	pixel_y = 1
	},
/turf/open/floor/plating/plating_catwalk/strata,
/area/shuttle/ert)
"V" = (
/turf/closed/shuttle/ert{
	icon_state = "rightengine_2";
	opacity = 0
	},
/area/shuttle/ert)
"W" = (
/obj/structure/bed/chair/dropship/pilot{
	dir = 1;
	layer = 6
	},
/turf/open/floor/strata/multi_tiles/southwest,
/area/shuttle/ert)
"X" = (
/obj/structure/blocker/invisible_wall,
/obj/structure/machinery/computer/shuttle/ert,
/turf/open/shuttle/dropship/medium_grey_single_wide_up_to_down,
/area/shuttle/ert)
"Y" = (
/obj/structure/machinery/door/airlock/multi_tile/almayer/dropshiprear/upp{
	id = "aft_door"
	},
/turf/open/floor/strata/floor3/east,
/area/shuttle/ert)
"Z" = (
/obj/effect/decal/warning_stripes{
	icon_state = "E"
	},
/obj/structure/bed/chair/vehicle{
	dir = 4;
	pixel_x = -9
	},
/turf/open/floor/plating/plating_catwalk/strata,
/area/shuttle/ert)

(1,1,1) = {"
K
z
a
Q
a
a
a
a
a
j
P
l
e
"}
(2,1,1) = {"
K
v
C
U
B
Z
Z
Z
Z
u
a
a
A
"}
(3,1,1) = {"
z
q
s
O
i
i
i
i
i
L
L
T
Y
"}
(4,1,1) = {"
I
X
W
D
w
k
w
w
k
i
i
t
w
"}
(5,1,1) = {"
E
m
c
b
i
i
i
i
i
M
M
f
w
"}
(6,1,1) = {"
K
v
J
H
B
o
o
o
o
y
g
g
x
"}
(7,1,1) = {"
K
E
g
g
g
g
g
g
g
p
r
V
F
"}
