//MAP CONVERTED BY dmm2tgm.py THIS HEADER COMMENT PREVENTS RECONVERSION, DO NOT REMOVE
"a" = (
/turf/open/floor/plating/plating_catwalk,
/area/shuttle/vehicle_elevator)
"o" = (
/obj/effect/decal/cleanable/dirt,
/obj/docking_port/mobile/shipmap_elevator/two,
/turf/open/floor/plating/plating_catwalk,
/area/shuttle/vehicle_elevator)
"u" = (
/obj/effect/decal/cleanable/dirt,
/turf/open/floor/almayer{
	icon_state = "plate"
	},
/area/shuttle/vehicle_elevator)
"A" = (
/turf/open/floor/almayer{
	icon_state = "plate"
	},
/area/shuttle/vehicle_elevator)
"T" = (
/obj/effect/decal/cleanable/blood/oil,
/turf/open/floor/plating/plating_catwalk,
/area/shuttle/vehicle_elevator)
"Z" = (
/obj/effect/decal/cleanable/dirt,
/turf/open/floor/plating/plating_catwalk,
/area/shuttle/vehicle_elevator)

(1,1,1) = {"
a
a
a
a
o
"}
(2,1,1) = {"
a
A
u
A
T
"}
(3,1,1) = {"
a
A
u
A
Z
"}
(4,1,1) = {"
T
u
A
A
Z
"}
(5,1,1) = {"
a
u
A
A
Z
"}
(6,1,1) = {"
a
A
A
A
Z
"}
(7,1,1) = {"
a
a
a
Z
Z
"}
