//MAP CONVERTED BY dmm2tgm.py THIS HEADER COMMENT PREVENTS RECONVERSION, DO NOT REMOVE
"a" = (
/turf/open/floor/plating/plating_catwalk,
/area/golden_arrow/hangar_shuttle)
"j" = (
/obj/docking_port/mobile/trijent_elevator/shipmap_elevator/hangar,
/turf/open/floor/plating/plating_catwalk,
/area/golden_arrow/hangar_shuttle)
"Z" = (
/obj/structure/machinery/computer/shuttle/elevator_controller/console{
	pixel_y = 16;
	layer = 4
	},
/turf/open/floor/plating/plating_catwalk,
/area/golden_arrow/hangar_shuttle)

(1,1,1) = {"
Z
a
j
"}
(2,1,1) = {"
a
a
a
"}
