//MAP CONVERTED BY dmm2tgm.py THIS HEADER COMMENT PREVENTS RECONVERSION, DO NOT REMOVE
"a" = (
/turf/open/floor/plating/plating_catwalk,
/area/shuttle/vehicle_elevator)
"e" = (
/obj/effect/decal/cleanable/dirt,
/obj/docking_port/mobile/shipmap_elevator{
	elevator_network = "one"
	},
/obj/merge_conflict_marker{
	name = "---Merge Conflict Marker---";
	
	desc = "A best-effort merge was performed. You must resolve this conflict yourself (manually) and remove this object once complete."
	},
/obj/effect/decal/cleanable/dirt,
/obj/docking_port/mobile/shipmap_elevator{
	elevator_network = "ArrowVehicleOne"
	},
/turf/open/floor/plating/plating_catwalk,
/area/shuttle/vehicle_elevator)
"f" = (
/obj/structure/machinery/computer/shuttle/elevator_controller{
	shuttleId = "garrow_vehicle_elevator_one"
	},
/turf/open/floor/almayer{
	icon_state = "plate"
	},
/area/shuttle/vehicle_elevator)
"u" = (
/obj/effect/decal/cleanable/dirt,
/turf/open/floor/almayer{
	icon_state = "plate"
	},
/area/shuttle/vehicle_elevator)
"A" = (
/turf/open/floor/almayer{
	icon_state = "plate"
	},
/area/shuttle/vehicle_elevator)
"K" = (
/obj/effect/decal/cleanable/dirt,
/turf/open/floor/plating/plating_catwalk,
/area/shuttle/vehicle_elevator)
"T" = (
/obj/effect/decal/cleanable/blood/oil,
/turf/open/floor/plating/plating_catwalk,
/area/shuttle/vehicle_elevator)

(1,1,1) = {"
K
a
a
a
e
"}
(2,1,1) = {"
T
u
A
A
a
"}
(3,1,1) = {"
a
A
A
A
K
"}
(4,1,1) = {"
a
A
f
u
a
"}
(5,1,1) = {"
a
u
u
u
a
"}
(6,1,1) = {"
a
A
u
u
a
"}
(7,1,1) = {"
a
a
a
a
a
"}
