//MAP CONVERTED BY dmm2tgm.py THIS HEADER COMMENT PREVENTS RECONVERSION, DO NOT REMOVE
"a" = (
/turf/closed/shuttle/elevator,
/area/shuttle/torch_elevator/elevator)
"j" = (
/obj/structure/machinery/door/airlock/multi_tile/secure{
	id = "elevator"
	},
/turf/open/shuttle/elevator/grating,
/area/shuttle/torch_elevator/elevator)
"k" = (
/turf/closed/shuttle/elevator/gears,
/area/shuttle/torch_elevator/elevator)
"s" = (
/obj/structure/machinery/computer/shuttle/elevator_controller/torch,
/turf/closed/shuttle/elevator{
	dir = 4
	},
/area/shuttle/torch_elevator/elevator)
"t" = (
/obj/docking_port/mobile/torch_elevator,
/turf/closed/shuttle/elevator{
	dir = 10
	},
/area/shuttle/torch_elevator/elevator)
"z" = (
/turf/closed/shuttle/elevator{
	dir = 1
	},
/area/shuttle/torch_elevator/elevator)
"F" = (
/turf/closed/shuttle/elevator{
	dir = 9
	},
/area/shuttle/torch_elevator/elevator)
"I" = (
/turf/open/shuttle/elevator,
/area/shuttle/torch_elevator/elevator)
"L" = (
/turf/closed/shuttle/elevator{
	dir = 8
	},
/area/shuttle/torch_elevator/elevator)
"M" = (
/turf/open/shuttle/elevator/grating,
/area/shuttle/torch_elevator/elevator)
"O" = (
/turf/closed/shuttle/elevator{
	dir = 6
	},
/area/shuttle/torch_elevator/elevator)
"Y" = (
/turf/closed/shuttle/elevator{
	dir = 5
	},
/area/shuttle/torch_elevator/elevator)

(1,1,1) = {"
F
a
a
a
t
"}
(2,1,1) = {"
k
I
M
I
L
"}
(3,1,1) = {"
k
M
M
M
j
"}
(4,1,1) = {"
s
M
I
M
M
"}
(5,1,1) = {"
Y
z
z
z
O
"}
