//MAP CONVERTED BY dmm2tgm.py THIS HEADER COMMENT PREVENTS RECONVERSION, DO NOT REMOVE
"c" = (
/obj/effect/decal/cleanable/dirt,
/turf/open/shuttle/escapepod/floor1/east,
/area/shuttle/trijent_shuttle/elevator)
"d" = (
/turf/closed/shuttle/elevator{
	dir = 8
	},
/area/shuttle/trijent_shuttle/elevator)
"e" = (
/obj/effect/decal/warning_stripes{
	icon_state = "E";
	dir = 1;
	pixel_x = 1
	},
/obj/effect/decal/warning_stripes{
	icon_state = "W";
	dir = 1
	},
/obj/effect/decal/cleanable/dirt,
/turf/open/shuttle/escapepod/floor4,
/area/shuttle/trijent_shuttle/elevator)
"h" = (
/obj/docking_port/mobile/trijent_elevator,
/turf/closed/shuttle/elevator{
	dir = 10
	},
/area/shuttle/trijent_shuttle/elevator)
"j" = (
/obj/structure/machinery/door/poddoor/almayer/locked{
	dir = 4;
	id = "east"
	},
/turf/open/floor/corsat/marked,
/area/shuttle/trijent_shuttle/elevator)
"k" = (
/obj/structure/machinery/computer/shuttle/elevator_controller,
/turf/closed/shuttle/elevator/button/freight,
/area/shuttle/trijent_shuttle/elevator)
"l" = (
/obj/effect/decal/warning_stripes{
	icon_state = "W";
	dir = 1
	},
/obj/effect/decal/warning_stripes{
	icon_state = "E";
	dir = 1;
	pixel_x = 2
	},
/obj/effect/decal/cleanable/dirt,
/turf/open/shuttle/escapepod/floor4,
/area/shuttle/trijent_shuttle/elevator)
"n" = (
/obj/structure/machinery/power/apc/upgraded/power/north,
/obj/effect/decal/warning_stripes{
	icon_state = "S";
	pixel_y = -1
	},
/obj/effect/decal/cleanable/dirt,
/turf/open/shuttle/escapepod/floor4,
/area/shuttle/trijent_shuttle/elevator)
"o" = (
/obj/effect/decal/warning_stripes{
	icon_state = "E";
	dir = 1;
	pixel_x = 1
	},
/obj/effect/decal/warning_stripes{
	icon_state = "NW-out";
	pixel_y = 1
	},
/turf/open/shuttle/escapepod/floor4,
/area/shuttle/trijent_shuttle/elevator)
"q" = (
/turf/closed/shuttle/elevator/freight,
/area/shuttle/trijent_shuttle/elevator)
"r" = (
/obj/effect/decal/warning_stripes{
	icon_state = "W";
	dir = 1
	},
/obj/effect/decal/warning_stripes{
	icon_state = "E";
	dir = 1;
	pixel_x = 2
	},
/turf/open/shuttle/escapepod/floor4,
/area/shuttle/trijent_shuttle/elevator)
"s" = (
/turf/closed/shuttle/elevator{
	dir = 4
	},
/area/shuttle/trijent_shuttle/elevator)
"t" = (
/obj/effect/decal/warning_stripes{
	icon_state = "W";
	dir = 1
	},
/obj/effect/decal/warning_stripes{
	icon_state = "NE-out";
	pixel_x = 2;
	pixel_y = 1
	},
/obj/effect/decal/cleanable/dirt,
/turf/open/shuttle/escapepod/floor4,
/area/shuttle/trijent_shuttle/elevator)
"u" = (
/obj/structure/sign/safety/elevator{
	pixel_y = -4
	},
/turf/closed/shuttle/elevator{
	dir = 8
	},
/area/shuttle/trijent_shuttle/elevator)
"A" = (
/turf/closed/shuttle/elevator{
	dir = 9
	},
/area/shuttle/trijent_shuttle/elevator)
"C" = (
/obj/effect/decal/warning_stripes{
	icon_state = "E";
	dir = 1;
	pixel_x = 1
	},
/obj/effect/decal/warning_stripes{
	icon_state = "W";
	dir = 1
	},
/turf/open/shuttle/escapepod/floor4,
/area/shuttle/trijent_shuttle/elevator)
"I" = (
/obj/effect/decal/warning_stripes{
	icon_state = "S";
	pixel_y = -1
	},
/turf/open/shuttle/escapepod/floor4,
/area/shuttle/trijent_shuttle/elevator)
"J" = (
/obj/structure/machinery/door/poddoor/almayer/locked{
	dir = 4;
	id = "west"
	},
/turf/open/floor/corsat/marked,
/area/shuttle/trijent_shuttle/elevator)
"O" = (
/obj/effect/decal/warning_stripes{
	icon_state = "N";
	pixel_y = 1
	},
/obj/effect/decal/cleanable/dirt,
/turf/open/shuttle/escapepod/floor4,
/area/shuttle/trijent_shuttle/elevator)
"P" = (
/obj/effect/decal/warning_stripes{
	icon_state = "S";
	pixel_y = -1
	},
/obj/effect/decal/cleanable/dirt,
/turf/open/shuttle/escapepod/floor4,
/area/shuttle/trijent_shuttle/elevator)
"R" = (
/obj/effect/decal/warning_stripes{
	icon_state = "W";
	dir = 1
	},
/obj/effect/decal/warning_stripes{
	icon_state = "SE-out";
	pixel_x = 2;
	pixel_y = -1
	},
/obj/structure/machinery/door_control/brbutton{
	pixel_y = 29;
	id = "west"
	},
/turf/open/shuttle/escapepod/floor4,
/area/shuttle/trijent_shuttle/elevator)
"S" = (
/turf/closed/shuttle/elevator{
	dir = 5
	},
/area/shuttle/trijent_shuttle/elevator)
"T" = (
/obj/effect/decal/warning_stripes{
	icon_state = "E";
	dir = 1;
	pixel_x = 1
	},
/obj/effect/decal/warning_stripes{
	icon_state = "SW-out";
	pixel_y = -1
	},
/obj/effect/decal/cleanable/dirt,
/obj/structure/machinery/door_control/brbutton{
	pixel_y = 29;
	id = "east"
	},
/turf/open/shuttle/escapepod/floor4,
/area/shuttle/trijent_shuttle/elevator)
"V" = (
/turf/closed/shuttle/elevator{
	dir = 6
	},
/area/shuttle/trijent_shuttle/elevator)
"Y" = (
/turf/open/shuttle/escapepod/floor1/east,
/area/shuttle/trijent_shuttle/elevator)

(1,1,1) = {"
A
J
J
J
J
h
"}
(2,1,1) = {"
d
R
r
l
t
s
"}
(3,1,1) = {"
k
I
Y
c
O
s
"}
(4,1,1) = {"
q
n
Y
Y
O
s
"}
(5,1,1) = {"
u
P
c
Y
O
s
"}
(6,1,1) = {"
d
T
e
C
o
s
"}
(7,1,1) = {"
S
j
j
j
j
V
"}
