//MAP CONVERTED BY dmm2tgm.py THIS HEADER COMMENT PREVENTS RECONVERSION, DO NOT REMOVE
"az" = (
/turf/open/floor/whitebluefull,
/area/lv624/lazarus/medbay)
"bE" = (
/obj/effect/landmark/crap_item,
/obj/structure/barricade/wooden,
/turf/open/floor/white,
/area/lv624/lazarus/medbay)
"cR" = (
/obj/structure/machinery/iv_drip,
/obj/structure/barricade/wooden,
/turf/open/floor/whiteblue/southeast,
/area/lv624/lazarus/medbay)
"cZ" = (
/obj/effect/landmark/crap_item,
/obj/effect/decal/cleanable/blood,
/turf/open/floor/damaged5/west,
/area/lv624/lazarus/medbay)
"dS" = (
/turf/open/floor/platingdmg1,
/area/lv624/lazarus/medbay)
"ef" = (
/obj/item/reagent_container/food/drinks/cans/waterbottle{
	pixel_x = 2
	},
/turf/open/floor/white,
/area/lv624/lazarus/medbay)
"eL" = (
/obj/structure/machinery/light{
	dir = 1
	},
/turf/open/floor/whiteblue/northeast,
/area/lv624/lazarus/medbay)
"eM" = (
/obj/effect/decal/cleanable/blood/drip,
/turf/open/floor/plating/panelscorched,
/area/lv624/lazarus/medbay)
"hn" = (
/obj/structure/machinery/sleep_console,
/obj/structure/extinguisher_cabinet{
	pixel_y = 30
	},
/turf/open/floor/whitebluefull,
/area/lv624/lazarus/medbay)
"hU" = (
/obj/structure/girder,
/turf/open/floor/platingdmg1,
/area/lv624/lazarus/medbay)
"il" = (
/obj/effect/landmark/corpsespawner/doctor,
/obj/effect/decal/cleanable/blood,
/turf/open/floor/white,
/area/lv624/lazarus/medbay)
"iN" = (
/obj/structure/window_frame/colony,
/turf/open/floor/plating/platingdmg3,
/area/lv624/lazarus/medbay)
"jP" = (
/obj/structure/filingcabinet,
/obj/structure/machinery/light,
/turf/open/floor/damaged5/west,
/area/lv624/lazarus/medbay)
"jY" = (
/obj/structure/flora/jungle/planttop1,
/turf/open/gm/grass/grass1,
/area/lv624/ground/jungle/north_jungle)
"ke" = (
/turf/open/floor/whiteblue/north,
/area/lv624/lazarus/medbay)
"kg" = (
/obj/structure/flora/jungle/plantbot1,
/turf/open/gm/grass/grass1,
/area/lv624/ground/colony/south_medbay_road)
"km" = (
/obj/item/tool/kitchen/utensil/fork,
/turf/open/floor/platingdmg1,
/area/lv624/lazarus/medbay)
"kD" = (
/obj/structure/flora/jungle/planttop1,
/turf/open/gm/grass/grass1,
/area/lv624/ground/colony/south_medbay_road)
"mm" = (
/obj/structure/surface/table,
/obj/item/stack/medical/bruise_pack{
	pixel_x = 3;
	pixel_y = 3
	},
/obj/item/clothing/mask/surgical,
/obj/structure/machinery/light{
	dir = 1
	},
/obj/item/storage/belt/medical/full,
/turf/open/floor/white,
/area/lv624/lazarus/medbay)
"mV" = (
/obj/effect/decal/cleanable/blood,
/obj/effect/landmark/corpsespawner/doctor,
/turf/open/floor/plating/platingdmg3,
/area/lv624/lazarus/medbay)
"nG" = (
/obj/structure/fence,
/turf/open/gm/dirtgrassborder/north,
/area/lv624/ground/colony/south_medbay_road)
"ob" = (
/obj/structure/machinery/medical_pod/sleeper,
/turf/open/floor/whitebluefull,
/area/lv624/lazarus/medbay)
"og" = (
/turf/open/gm/dirt,
/area/lv624/ground/colony/south_medbay_road)
"ow" = (
/obj/structure/bed/chair/office/dark{
	dir = 4
	},
/turf/open/floor/damaged5/west,
/area/lv624/lazarus/medbay)
"oB" = (
/obj/structure/surface/table,
/obj/item/storage/box/masks{
	pixel_x = -4
	},
/obj/item/storage/box/syringes{
	pixel_x = 5;
	pixel_y = 4
	},
/turf/open/floor/white,
/area/lv624/lazarus/medbay)
"oY" = (
/obj/structure/machinery/cm_vending/sorted/medical/no_access,
/turf/open/floor/whitebluefull,
/area/lv624/lazarus/medbay)
"pj" = (
/obj/structure/surface/table,
/obj/item/clothing/glasses/hud/health,
/obj/effect/landmark/crap_item,
/obj/item/reagent_container/spray/cleaner,
/turf/open/floor/white,
/area/lv624/lazarus/medbay)
"pL" = (
/turf/open/floor/damaged5/west,
/area/lv624/lazarus/medbay)
"rD" = (
/obj/item/reagent_container/hypospray,
/turf/open/floor/white,
/area/lv624/lazarus/medbay)
"rZ" = (
/obj/structure/flora/bush/ausbushes/var3/fernybush,
/turf/open/gm/grass/grass1,
/area/lv624/ground/jungle/north_west_jungle)
"se" = (
/obj/structure/flora/bush/ausbushes/genericbush,
/turf/open/gm/grass/grass1,
/area/lv624/ground/jungle/north_west_jungle)
"td" = (
/obj/structure/window_frame/colony,
/obj/item/shard,
/turf/open/floor/white,
/area/lv624/lazarus/medbay)
"ti" = (
/obj/structure/machinery/light,
/turf/open/floor/plating/platingdmg3,
/area/lv624/lazarus/medbay)
"tj" = (
/obj/structure/flora/pottedplant{
	icon_state = "pottedplant_10"
	},
/turf/open/floor/plating/platingdmg3,
/area/lv624/lazarus/medbay)
"tL" = (
/obj/structure/machinery/power/apc/no_power/north,
/turf/open/floor/white,
/area/lv624/lazarus/medbay)
"tQ" = (
/obj/structure/closet/wardrobe,
/obj/structure/machinery/light{
	dir = 8
	},
/turf/open/floor/plating/platingdmg3,
/area/lv624/lazarus/medbay)
"uy" = (
/obj/structure/machinery/bioprinter,
/turf/open/floor/whitebluefull,
/area/lv624/lazarus/medbay)
"uX" = (
/obj/structure/surface/table/reinforced,
/obj/item/storage/surgical_tray,
/obj/item/reagent_container/spray/cleaner{
	desc = "Someone has crossed out the Space from Space Cleaner and written in Surgery. 'Do not remove under punishment of death!!!' is scrawled on the back.";
	name = "Surgery Cleaner"
	},
/turf/open/floor/whitebluefull,
/area/lv624/lazarus/medbay)
"vE" = (
/obj/structure/surface/table,
/turf/open/floor/plating/platingdmg3,
/area/lv624/lazarus/medbay)
"xe" = (
/obj/structure/fence,
/turf/open/gm/dirtgrassborder/west,
/area/lv624/ground/colony/south_medbay_road)
"xh" = (
/obj/structure/machinery/door/airlock/multi_tile/almayer/medidoor/colony{
	dir = 2;
	name = "\improper Medical Bay"
	},
/turf/open/floor/white,
/area/lv624/lazarus/medbay)
"xK" = (
/obj/structure/barricade/wooden,
/turf/open/floor/white,
/area/lv624/lazarus/medbay)
"xM" = (
/turf/open/gm/dirtgrassborder/north,
/area/lv624/ground/colony/south_medbay_road)
"ym" = (
/obj/structure/flora/jungle/plantbot1,
/turf/open/gm/grass/grass1,
/area/lv624/ground/jungle/north_jungle)
"ys" = (
/turf/open/floor/plating/platingdmg3,
/area/lv624/lazarus/medbay)
"yU" = (
/obj/structure/girder,
/turf/closed/wall,
/area/lv624/lazarus/medbay)
"zh" = (
/obj/structure/surface/table,
/obj/structure/machinery/light{
	dir = 4
	},
/obj/structure/phone_base/colony_net/rotary{
	phone_category = "Lazarus Landing";
	phone_id = "Medbay"
	},
/turf/open/floor/plating/platingdmg3,
/area/lv624/lazarus/medbay)
"zj" = (
/obj/effect/landmark/crap_item,
/turf/open/gm/dirt,
/area/lv624/ground/colony/south_medbay_road)
"zv" = (
/obj/structure/machinery/body_scanconsole,
/turf/open/floor/whitebluefull,
/area/lv624/lazarus/medbay)
"zS" = (
/obj/structure/flora/bush/ausbushes/lavendergrass,
/turf/open/gm/grass/grass1,
/area/lv624/ground/jungle/north_west_jungle)
"Be" = (
/obj/structure/fence,
/turf/open/gm/dirtgrassborder/grassdirt_corner/north_west,
/area/lv624/ground/colony/south_medbay_road)
"Bn" = (
/turf/open/gm/grass/grass1,
/area/lv624/ground/colony/south_medbay_road)
"Ca" = (
/turf/open/floor/plating/panelscorched,
/area/lv624/lazarus/medbay)
"CO" = (
/obj/effect/landmark/crap_item,
/turf/open/floor/plating/platingdmg3,
/area/lv624/lazarus/medbay)
"Dd" = (
/obj/structure/window_frame/colony,
/obj/item/shard,
/turf/open/floor/plating/platingdmg3,
/area/lv624/lazarus/medbay)
"DX" = (
/obj/structure/machinery/medical_pod/bodyscanner,
/obj/item/device/radio/intercom{
	freerange = 1;
	frequency = 1469;
	name = "General Listening Channel";
	pixel_y = 28
	},
/turf/open/floor/whitebluefull,
/area/lv624/lazarus/medbay)
"EP" = (
/obj/structure/surface/table,
/obj/item/stack/medical/bruise_pack{
	pixel_x = 3;
	pixel_y = 3
	},
/turf/open/floor/plating/platingdmg3,
/area/lv624/lazarus/medbay)
"Fk" = (
/turf/closed/wall,
/area/lv624/lazarus/medbay)
"Fx" = (
/obj/effect/decal/cleanable/blood,
/turf/open/floor/damaged5/west,
/area/lv624/lazarus/medbay)
"FC" = (
/obj/effect/decal/cleanable/blood/drip,
/turf/open/floor/plating/platingdmg3,
/area/lv624/lazarus/medbay)
"FO" = (
/turf/open/floor/damaged3/west,
/area/lv624/lazarus/medbay)
"FV" = (
/obj/structure/surface/table,
/obj/item/paper_bin{
	pixel_y = 4
	},
/obj/item/tool/pen,
/turf/open/floor/plating/platingdmg3,
/area/lv624/lazarus/medbay)
"Ha" = (
/obj/structure/flora/bush/ausbushes/var3/fernybush,
/turf/open/gm/grass/grass1,
/area/lv624/ground/jungle/north_jungle)
"HK" = (
/obj/structure/machinery/optable,
/obj/item/tank/anesthetic,
/turf/open/floor/whitebluefull,
/area/lv624/lazarus/medbay)
"JE" = (
/turf/open/gm/grass/grass1,
/area/lv624/ground/jungle/north_west_jungle)
"Km" = (
/obj/structure/flora/bush/ausbushes/reedbush,
/turf/open/gm/grass/grass1,
/area/lv624/ground/jungle/north_west_jungle)
"Kx" = (
/obj/structure/flora/pottedplant{
	icon_state = "pottedplant_10"
	},
/turf/open/floor/whitebluefull,
/area/lv624/lazarus/medbay)
"LH" = (
/obj/structure/surface/table,
/obj/effect/landmark/item_pool_spawner/survivor_ammo/buckshot,
/turf/open/floor/plating/platingdmg3,
/area/lv624/lazarus/medbay)
"LP" = (
/obj/effect/landmark/corpsespawner/doctor,
/obj/effect/decal/cleanable/blood,
/obj/item/weapon/gun/pistol/holdout,
/turf/open/floor/whiteblue/east,
/area/lv624/lazarus/medbay)
"MA" = (
/obj/item/stack/medical/ointment,
/obj/structure/machinery/light{
	dir = 1
	},
/turf/open/floor/plating/platingdmg3,
/area/lv624/lazarus/medbay)
"NT" = (
/obj/item/storage/firstaid,
/turf/open/floor/white,
/area/lv624/lazarus/medbay)
"OM" = (
/obj/effect/landmark/crap_item,
/turf/open/floor/white,
/area/lv624/lazarus/medbay)
"Pd" = (
/obj/item/trash/cigbutt,
/turf/open/gm/dirt,
/area/lv624/ground/colony/south_medbay_road)
"Pm" = (
/obj/structure/machinery/light{
	dir = 1
	},
/turf/open/floor/platingdmg1,
/area/lv624/lazarus/medbay)
"Qd" = (
/turf/open/floor,
/area/lv624/lazarus/medbay)
"QA" = (
/obj/effect/decal/cleanable/blood/drip,
/turf/open/floor/platingdmg1,
/area/lv624/lazarus/medbay)
"Ri" = (
/obj/item/stack/sheet/metal,
/turf/open/floor/plating/platingdmg3,
/area/lv624/lazarus/medbay)
"Ru" = (
/obj/structure/surface/table,
/obj/item/reagent_container/spray,
/obj/effect/landmark/item_pool_spawner/survivor_ammo/buckshot,
/turf/open/floor/plating/platingdmg3,
/area/lv624/lazarus/medbay)
"RJ" = (
/obj/item/device/radio/intercom{
	freerange = 1;
	frequency = 1469;
	name = "General Listening Channel";
	pixel_y = 28
	},
/turf/open/floor/platingdmg1,
/area/lv624/lazarus/medbay)
"SK" = (
/obj/item/storage/firstaid/toxin,
/obj/structure/barricade/wooden,
/turf/open/floor/white,
/area/lv624/lazarus/medbay)
"Tw" = (
/obj/item/device/radio/intercom{
	freerange = 1;
	frequency = 1469;
	name = "General Listening Channel";
	pixel_y = 28
	},
/turf/open/floor/plating/platingdmg3,
/area/lv624/lazarus/medbay)
"TL" = (
/obj/structure/machinery/door/airlock/multi_tile/almayer/medidoor/colony,
/turf/open/floor/white,
/area/lv624/lazarus/medbay)
"VY" = (
/turf/open/floor/white,
/area/lv624/lazarus/medbay)
"WT" = (
/turf/open/floor/whitebluecorner/east,
/area/lv624/lazarus/medbay)
"Xm" = (
/obj/item/stack/sheet/metal,
/obj/effect/decal/cleanable/blood,
/obj/effect/landmark/corpsespawner/engineer,
/turf/open/floor/plating/platingdmg3,
/area/lv624/lazarus/medbay)
"XA" = (
/turf/open/gm/grass/grass1,
/area/lv624/ground/jungle/north_jungle)
"XD" = (
/obj/structure/barricade/wooden,
/turf/open/floor/damaged3/west,
/area/lv624/lazarus/medbay)
"XJ" = (
/turf/closed/wall/r_wall,
/area/lv624/lazarus/medbay)
"XP" = (
/obj/structure/girder,
/turf/open/floor/plating/platingdmg3,
/area/lv624/lazarus/medbay)
"XR" = (
/obj/item/clothing/under/colonist,
/obj/effect/decal/cleanable/blood/drip,
/turf/open/floor/platingdmg1,
/area/lv624/lazarus/medbay)
"XY" = (
/obj/effect/landmark/crap_item,
/turf/open/floor/plating/panelscorched,
/area/lv624/lazarus/medbay)
"Yi" = (
/obj/item/stack/sheet/metal,
/obj/effect/decal/cleanable/blood/drip,
/turf/open/floor/plating/platingdmg3,
/area/lv624/lazarus/medbay)

(1,1,1) = {"
XA
XA
XA
XA
XA
XA
XA
XA
XA
JE
JE
zS
JE
JE
Km
JE
JE
"}
(2,1,1) = {"
XA
XA
XA
XA
XA
XA
XA
XA
XA
XA
JE
JE
JE
JE
JE
JE
JE
"}
(3,1,1) = {"
XA
XA
XA
Ha
XA
XJ
Dd
Dd
Yi
Ri
Fk
JE
JE
rZ
JE
JE
se
"}
(4,1,1) = {"
XA
XA
XJ
XJ
XJ
XJ
tj
Ri
Xm
tj
Fk
td
td
Fk
Be
xe
xe
"}
(5,1,1) = {"
XA
XA
XJ
pj
oB
Fk
Fk
Tw
dS
dS
tQ
Ru
LH
iN
xM
og
og
"}
(6,1,1) = {"
XA
XA
XJ
mm
VY
SK
hU
MA
dS
ys
XR
FC
ys
ys
xM
og
og
"}
(7,1,1) = {"
XA
XJ
XJ
tL
VY
bE
TL
ys
CO
mV
ys
ys
ti
Fk
XP
og
og
"}
(8,1,1) = {"
XA
XJ
ob
VY
rD
xK
VY
VY
VY
dS
km
ys
XY
Ca
td
og
og
"}
(9,1,1) = {"
XA
XJ
hn
VY
VY
oY
Fk
ke
pL
az
pL
il
eM
eM
TL
og
og
"}
(10,1,1) = {"
XA
XJ
DX
VY
VY
uy
yU
dS
dS
az
QA
FO
Ca
pL
VY
og
Pd
"}
(11,1,1) = {"
XA
XJ
zv
WT
OM
xK
TL
dS
VY
NT
il
ef
Ca
pL
td
og
og
"}
(12,1,1) = {"
XA
XJ
XJ
ke
VY
XD
VY
Fx
VY
FO
pL
pL
jP
yU
Ca
og
og
"}
(13,1,1) = {"
XA
XA
XJ
eL
LP
cR
XP
Pm
pL
pL
cZ
ow
vE
Ri
xM
og
og
"}
(14,1,1) = {"
XA
XA
XJ
uX
HK
Fk
Fk
RJ
pL
pL
zh
EP
FV
iN
xM
og
og
"}
(15,1,1) = {"
XA
XA
XJ
XJ
XJ
XJ
pL
dS
dS
Kx
XP
Dd
Dd
Fk
nG
og
og
"}
(16,1,1) = {"
XA
XA
XA
XA
XA
XJ
XJ
VY
xh
XJ
XJ
Bn
Bn
Bn
nG
og
og
"}
(17,1,1) = {"
XA
XA
jY
ym
XA
XA
XJ
Qd
Qd
XJ
Bn
kD
kg
Bn
nG
og
zj
"}
