//MAP CONVERTED BY dmm2tgm.py THIS HEADER COMMENT PREVENTS RECONVERSION, DO NOT REMOVE
"ac" = (
/turf/open/gm/grass/grass1,
/area/lv624/ground/jungle/north_jungle)
"ae" = (
/turf/closed/wall/r_wall,
/area/lv624/lazarus/medbay)
"af" = (
/turf/closed/wall,
/area/lv624/lazarus/medbay)
"ag" = (
/obj/structure/flora/bush/ausbushes/var3/fernybush,
/turf/open/gm/grass/grass1,
/area/lv624/ground/jungle/north_jungle)
"al" = (
/obj/structure/flora/jungle/planttop1,
/turf/open/gm/grass/grass1,
/area/lv624/ground/jungle/north_jungle)
"au" = (
/obj/structure/flora/jungle/plantbot1,
/turf/open/gm/grass/grass1,
/area/lv624/ground/jungle/north_jungle)
"aX" = (
/turf/open/floor,
/area/lv624/lazarus/medbay)
"br" = (
/obj/effect/landmark/corpsespawner/colonist/random/burst,
/obj/effect/decal/cleanable/blood,
/obj/structure/machinery/power/apc/no_power/north,
/turf/open/floor/whiteblue/north,
/area/lv624/lazarus/medbay)
"bw" = (
/obj/structure/fence,
/turf/open/gm/dirtgrassborder/grassdirt_corner/north_west,
/area/lv624/ground/colony/south_medbay_road)
"bE" = (
/obj/structure/fence,
/turf/open/gm/dirtgrassborder/west,
/area/lv624/ground/colony/south_medbay_road)
"bF" = (
/turf/open/gm/dirt,
/area/lv624/ground/colony/south_medbay_road)
"bI" = (
/obj/item/trash/cigbutt,
/turf/open/gm/dirt,
/area/lv624/ground/colony/south_medbay_road)
"bK" = (
/obj/effect/landmark/crap_item,
/turf/open/gm/dirt,
/area/lv624/ground/colony/south_medbay_road)
"bO" = (
/obj/structure/machinery/bioprinter,
/turf/open/floor/whitebluefull,
/area/lv624/lazarus/medbay)
"ct" = (
/obj/structure/surface/table,
/obj/item/stack/medical/bruise_pack{
	pixel_x = 3;
	pixel_y = 3
	},
/turf/open/floor/whiteblue/east,
/area/lv624/lazarus/medbay)
"fj" = (
/obj/item/reagent_container/food/drinks/cans/waterbottle{
	pixel_x = 2
	},
/turf/open/floor/white,
/area/lv624/lazarus/medbay)
"fY" = (
/obj/structure/machinery/cm_vending/sorted/medical/no_access,
/turf/open/floor/whiteblue,
/area/lv624/lazarus/medbay)
"hv" = (
/obj/structure/machinery/door/airlock/multi_tile/almayer/medidoor/colony,
/turf/open/floor/white,
/area/lv624/lazarus/medbay)
"hW" = (
/obj/item/frame/table,
/obj/effect/decal/cleanable/blood/xeno,
/turf/open/floor/whitebluefull,
/area/lv624/lazarus/medbay)
"kL" = (
/obj/structure/surface/table,
/turf/open/floor/whiteblue,
/area/lv624/lazarus/medbay)
"kP" = (
/obj/structure/machinery/medical_pod/sleeper,
/turf/open/floor/whitebluefull,
/area/lv624/lazarus/medbay)
"ll" = (
/obj/structure/bed,
/obj/item/bedsheet/medical,
/turf/open/floor/whitebluefull,
/area/lv624/lazarus/medbay)
"lI" = (
/obj/effect/landmark/corpsespawner/doctor,
/obj/effect/decal/cleanable/blood,
/turf/open/floor/white,
/area/lv624/lazarus/medbay)
"mg" = (
/obj/structure/machinery/iv_drip,
/turf/open/floor/whiteblue/southeast,
/area/lv624/lazarus/medbay)
"mK" = (
/turf/open/floor/whiteblue/west,
/area/lv624/lazarus/medbay)
"nk" = (
/obj/structure/machinery/cm_vending/sorted/medical/blood,
/obj/structure/machinery/light,
/turf/open/floor/whiteblue,
/area/lv624/lazarus/medbay)
"nW" = (
/obj/structure/machinery/cm_vending/sorted/medical/no_access,
/turf/open/floor/whitebluefull,
/area/lv624/lazarus/medbay)
"op" = (
/obj/effect/decal/cleanable/blood/xeno,
/turf/open/floor/white,
/area/lv624/lazarus/medbay)
"os" = (
/obj/structure/surface/table,
/obj/item/reagent_container/spray,
/obj/effect/landmark/item_pool_spawner/survivor_ammo/buckshot,
/turf/open/floor/whiteblue/west,
/area/lv624/lazarus/medbay)
"pg" = (
/turf/open/floor/white,
/area/lv624/lazarus/medbay)
"qs" = (
/obj/item/device/radio/intercom{
	freerange = 1;
	frequency = 1469;
	name = "General Listening Channel";
	pixel_y = 28
	},
/turf/open/floor/whiteblue/north,
/area/lv624/lazarus/medbay)
"qK" = (
/obj/structure/flora/bush/ausbushes/reedbush,
/turf/open/gm/grass/grass1,
/area/lv624/ground/jungle/north_west_jungle)
"sr" = (
/obj/item/storage/firstaid,
/turf/open/floor/white,
/area/lv624/lazarus/medbay)
"sB" = (
/obj/structure/filingcabinet,
/obj/structure/machinery/light,
/turf/open/floor/whiteblue,
/area/lv624/lazarus/medbay)
"sK" = (
/obj/item/reagent_container/spray/cleaner{
	desc = "Someone has crossed out the Space from Space Cleaner and written in Surgery. 'Do not remove under punishment of death!!!' is scrawled on the back.";
	name = "Surgery Cleaner"
	},
/turf/open/floor/whiteblue/east,
/area/lv624/lazarus/medbay)
"tv" = (
/obj/item/tool/kitchen/utensil/fork,
/turf/open/floor/white,
/area/lv624/lazarus/medbay)
"tE" = (
/obj/structure/flora/pottedplant{
	icon_state = "pottedplant_10"
	},
/turf/open/floor/whitebluefull,
/area/lv624/lazarus/medbay)
"vQ" = (
/turf/open/floor/whiteblue/southeast,
/area/lv624/lazarus/medbay)
"we" = (
/obj/structure/flora/bush/ausbushes/lavendergrass,
/turf/open/gm/grass/grass1,
/area/lv624/ground/jungle/north_west_jungle)
"wz" = (
/obj/structure/fence,
/turf/open/gm/dirtgrassborder/north,
/area/lv624/ground/colony/south_medbay_road)
"xi" = (
/obj/effect/decal/cleanable/blood/drip,
/turf/open/floor/whitebluecorner/north,
/area/lv624/lazarus/medbay)
"yj" = (
/obj/structure/surface/table,
/obj/item/storage/box/masks{
	pixel_x = -4
	},
/obj/item/storage/box/syringes{
	pixel_x = 5;
	pixel_y = 4
	},
/turf/open/floor/whitebluefull,
/area/lv624/lazarus/medbay)
"zE" = (
/turf/open/gm/grass/grass1,
/area/lv624/ground/jungle/north_west_jungle)
"zL" = (
/obj/structure/flora/jungle/planttop1,
/turf/open/gm/grass/grass1,
/area/lv624/ground/colony/south_medbay_road)
"BF" = (
/obj/structure/machinery/medical_pod/bodyscanner,
/obj/item/device/radio/intercom{
	freerange = 1;
	frequency = 1469;
	name = "General Listening Channel";
	pixel_y = 28
	},
/turf/open/floor/whitebluefull,
/area/lv624/lazarus/medbay)
"Cu" = (
/obj/structure/window/framed/colony,
/turf/open/floor/white,
/area/lv624/lazarus/medbay)
"CR" = (
/obj/structure/machinery/light{
	dir = 1
	},
/turf/open/floor/whiteblue/north,
/area/lv624/lazarus/medbay)
"Es" = (
/obj/structure/flora/bush/ausbushes/genericbush,
/turf/open/gm/grass/grass1,
/area/lv624/ground/jungle/north_west_jungle)
"Ey" = (
/obj/structure/closet/wardrobe,
/obj/structure/machinery/light{
	dir = 8
	},
/turf/open/floor/whiteblue/west,
/area/lv624/lazarus/medbay)
"EG" = (
/obj/item/trash/plate,
/turf/open/floor/white,
/area/lv624/lazarus/medbay)
"EL" = (
/obj/structure/bed/chair/office/dark{
	dir = 4
	},
/turf/open/floor/white,
/area/lv624/lazarus/medbay)
"ES" = (
/turf/open/gm/dirtgrassborder/north,
/area/lv624/ground/colony/south_medbay_road)
"Fd" = (
/turf/open/floor/whitebluecorner/east,
/area/lv624/lazarus/medbay)
"FX" = (
/turf/open/floor/whitebluecorner,
/area/lv624/lazarus/medbay)
"Gc" = (
/obj/structure/machinery/door/airlock/multi_tile/almayer/medidoor/colony{
	dir = 2;
	name = "\improper Medical Bay"
	},
/turf/open/floor/white,
/area/lv624/lazarus/medbay)
"Hm" = (
/obj/structure/machinery/optable,
/obj/item/tank/anesthetic,
/obj/effect/decal/cleanable/blood,
/obj/effect/landmark/corpsespawner/scientist,
/turf/open/floor/whitebluefull,
/area/lv624/lazarus/medbay)
"Hs" = (
/turf/open/floor/whiteblue/north,
/area/lv624/lazarus/medbay)
"It" = (
/obj/item/reagent_container/hypospray,
/turf/open/floor/white,
/area/lv624/lazarus/medbay)
"IC" = (
/obj/structure/machinery/body_scanconsole,
/turf/open/floor/whitebluefull,
/area/lv624/lazarus/medbay)
"Jg" = (
/obj/effect/decal/cleanable/blood/xeno,
/turf/open/floor/whiteblue/southwest,
/area/lv624/lazarus/medbay)
"JN" = (
/obj/effect/landmark/crap_item,
/turf/open/floor/whitebluecorner/west,
/area/lv624/lazarus/medbay)
"Kg" = (
/obj/effect/landmark/crap_item,
/turf/open/floor/white,
/area/lv624/lazarus/medbay)
"Ll" = (
/obj/structure/surface/table,
/obj/item/reagent_container/food/drinks/cans/waterbottle,
/obj/item/tool/kitchen/utensil/knife{
	pixel_x = 8;
	pixel_y = 6
	},
/turf/open/floor/whitebluefull,
/area/lv624/lazarus/medbay)
"LK" = (
/obj/item/tool/crowbar,
/turf/open/floor/whiteblue/north,
/area/lv624/lazarus/medbay)
"LQ" = (
/obj/structure/flora/bush/ausbushes/var3/fernybush,
/turf/open/gm/grass/grass1,
/area/lv624/ground/jungle/north_west_jungle)
"Mc" = (
/obj/structure/machinery/sleep_console,
/obj/structure/extinguisher_cabinet{
	pixel_y = 30
	},
/turf/open/floor/whitebluefull,
/area/lv624/lazarus/medbay)
"Mo" = (
/obj/effect/decal/cleanable/blood/drip,
/turf/open/floor/white,
/area/lv624/lazarus/medbay)
"MW" = (
/obj/structure/machinery/light{
	dir = 1
	},
/obj/effect/decal/cleanable/blood,
/obj/item/storage/surgical_tray,
/turf/open/floor/whiteblue/northeast,
/area/lv624/lazarus/medbay)
"Np" = (
/obj/structure/flora/jungle/plantbot1,
/turf/open/gm/grass/grass1,
/area/lv624/ground/colony/south_medbay_road)
"Nw" = (
/obj/item/stack/medical/ointment,
/obj/structure/machinery/light{
	dir = 1
	},
/turf/open/floor/whiteblue/north,
/area/lv624/lazarus/medbay)
"Oa" = (
/turf/open/floor/whitebluecorner/west,
/area/lv624/lazarus/medbay)
"Pe" = (
/turf/open/gm/grass/grass1,
/area/lv624/ground/colony/south_medbay_road)
"PW" = (
/obj/structure/surface/table,
/obj/item/clothing/glasses/hud/health,
/obj/effect/landmark/crap_item,
/obj/item/reagent_container/spray/cleaner,
/turf/open/floor/whitebluefull,
/area/lv624/lazarus/medbay)
"RF" = (
/obj/structure/surface/table,
/obj/structure/machinery/light{
	dir = 4
	},
/obj/structure/phone_base/colony_net/rotary{
	phone_category = "Lazarus Landing";
	phone_id = "Medbay"
	},
/turf/open/floor/white,
/area/lv624/lazarus/medbay)
"Ts" = (
/obj/item/storage/firstaid/toxin,
/turf/open/floor/whiteblue/southwest,
/area/lv624/lazarus/medbay)
"TW" = (
/obj/structure/surface/table,
/obj/item/paper_bin{
	pixel_y = 4
	},
/obj/item/tool/pen,
/turf/open/floor/white,
/area/lv624/lazarus/medbay)
"Uh" = (
/obj/item/clothing/under/colonist,
/turf/open/floor/white,
/area/lv624/lazarus/medbay)
"Vm" = (
/obj/structure/bed,
/obj/effect/decal/cleanable/blood,
/obj/effect/landmark/corpsespawner/engineer,
/turf/open/floor/whitebluefull,
/area/lv624/lazarus/medbay)
"Wc" = (
/obj/structure/surface/table,
/obj/item/stack/medical/bruise_pack{
	pixel_x = 3;
	pixel_y = 3
	},
/obj/item/clothing/mask/surgical,
/obj/structure/machinery/light{
	dir = 1
	},
/obj/item/storage/belt/medical/full,
/turf/open/floor/whiteblue/north,
/area/lv624/lazarus/medbay)
"Ww" = (
/obj/structure/surface/table,
/obj/effect/landmark/item_pool_spawner/survivor_ammo/buckshot,
/turf/open/floor/whiteblue/west,
/area/lv624/lazarus/medbay)
"WD" = (
/obj/structure/window_frame/colony,
/turf/open/floor/white,
/area/lv624/lazarus/medbay)
"WW" = (
/obj/item/bedsheet/medical,
/turf/open/floor/white,
/area/lv624/lazarus/medbay)
"Xq" = (
/obj/structure/machinery/vending/coffee,
/turf/open/floor/whiteblue/north,
/area/lv624/lazarus/medbay)
"XS" = (
/obj/structure/machinery/vending/snack,
/turf/open/floor/whiteblue/north,
/area/lv624/lazarus/medbay)
"Zd" = (
/obj/structure/surface/table/reinforced,
/turf/open/floor/whitebluefull,
/area/lv624/lazarus/medbay)

(1,1,1) = {"
ac
ac
ac
ac
ac
ac
ac
ac
ac
zE
zE
we
zE
zE
qK
zE
zE
"}
(2,1,1) = {"
ac
ac
ac
ac
ac
ac
ac
ac
ac
ac
zE
zE
zE
zE
zE
zE
zE
"}
(3,1,1) = {"
ac
ac
ac
ag
ac
ae
Cu
Cu
WD
Cu
af
zE
zE
LQ
zE
zE
Es
"}
(4,1,1) = {"
ac
ac
ae
ae
ae
ae
tE
ll
Vm
tE
af
Cu
Cu
af
bw
bE
bE
"}
(5,1,1) = {"
ac
ac
ae
PW
yj
af
af
qs
WW
Oa
Ey
os
Ww
Cu
ES
bF
bF
"}
(6,1,1) = {"
ac
ac
ae
Wc
mK
Ts
af
Nw
pg
pg
Uh
pg
fY
Cu
ES
bF
bF
"}
(7,1,1) = {"
ac
ae
ae
br
pg
Kg
hv
pg
Kg
pg
pg
pg
nk
af
af
bF
bF
"}
(8,1,1) = {"
ac
ae
kP
xi
It
pg
pg
pg
pg
pg
tv
EG
JN
Jg
WD
bF
bF
"}
(9,1,1) = {"
ac
ae
Mc
Mo
Mo
nW
af
Xq
pg
hW
LK
lI
pg
pg
hv
bF
bF
"}
(10,1,1) = {"
ac
ae
BF
pg
pg
bO
af
XS
pg
Ll
Hs
pg
pg
pg
pg
bF
bI
"}
(11,1,1) = {"
ac
ae
IC
Fd
Kg
pg
hv
pg
pg
sr
pg
fj
FX
vQ
Cu
bF
bF
"}
(12,1,1) = {"
ac
ae
ae
Hs
Mo
op
pg
pg
pg
pg
pg
pg
sB
af
af
bF
bF
"}
(13,1,1) = {"
ac
ac
ae
MW
sK
mg
af
CR
pg
pg
Kg
EL
kL
Cu
ES
bF
bF
"}
(14,1,1) = {"
ac
ac
ae
Zd
Hm
af
af
qs
pg
FX
RF
ct
TW
Cu
ES
bF
bF
"}
(15,1,1) = {"
ac
ac
ae
ae
ae
ae
tE
pg
pg
tE
af
Cu
Cu
af
wz
bF
bF
"}
(16,1,1) = {"
ac
ac
ac
ac
ac
ae
ae
pg
Gc
ae
ae
Pe
Pe
Pe
wz
bF
bF
"}
(17,1,1) = {"
ac
ac
al
au
ac
ac
ae
aX
aX
ae
Pe
zL
Np
Pe
wz
bF
bK
"}
