//MAP CONVERTED BY dmm2tgm.py THIS HEADER COMMENT PREVENTS RECONVERSION, DO NOT REMOVE
"ak" = (
/obj/item/stack/sheet/metal,
/obj/effect/spawner/random/claymore/lowchance,
/turf/open/floor/platingdmg1,
/area/lv624/lazarus/hydroponics)
"ax" = (
/obj/structure/window_frame/colony,
/turf/open/floor/platingdmg1,
/area/lv624/lazarus/hydroponics)
"aR" = (
/obj/item/reagent_container/glass/fertilizer{
	pixel_x = 6;
	pixel_y = 2
	},
/obj/item/reagent_container/glass/fertilizer,
/obj/item/stack/sheet/metal,
/obj/effect/spawner/random/claymore/midchance,
/turf/open/floor/platingdmg1,
/area/lv624/lazarus/hydroponics)
"by" = (
/obj/item/clothing/shoes/marine/civilian{
	armor_bio = 15;
	armor_bomb = 5;
	armor_bullet = 15;
	armor_energy = 5;
	armor_internaldamage = 5;
	armor_laser = 5;
	armor_melee = 15;
	desc = "The height of fashion, but these look to be woven with protective fiber. This pair seems heavily damaged, especially around the soles...";
	name = "scuffed shoes";
	pixel_x = -14;
	pixel_y = -10;
	slowdown = 0.5
	},
/turf/open/floor/green/northwest,
/area/lv624/lazarus/hydroponics)
"bM" = (
/obj/structure/fence,
/turf/open/gm/dirtgrassborder/north,
/area/lv624/ground/colony/north_nexus_road)
"bV" = (
/turf/open/floor/plating/panelscorched,
/area/lv624/lazarus/hydroponics)
"ch" = (
/obj/item/reagent_container/spray/plantbgone{
	pixel_x = 4;
	pixel_y = 6
	},
/obj/effect/landmark/crap_item,
/obj/item/stack/sheet/metal,
/obj/effect/spawner/random/claymore/midchance{
	dir = 1
	},
/turf/open/floor/platingdmg1,
/area/lv624/lazarus/hydroponics)
"ck" = (
/obj/effect/decal/cleanable/blood/xeno,
/turf/open/floor/plating,
/area/lv624/lazarus/hydroponics)
"cM" = (
/obj/effect/decal/cleanable/blood,
/obj/item/ammo_magazine/rifle/nsg23{
	current_rounds = 2
	},
/obj/effect/spawner/gibspawner/human,
/obj/item/clothing/under/marine/veteran/pmc{
	pixel_x = 6;
	pixel_y = 8
	},
/turf/open/floor/plating/panelscorched,
/area/lv624/lazarus/hydroponics)
"cX" = (
/obj/item/clothing/gloves/marine/veteran/pmc{
	armor_bio = 10;
	armor_bomb = 10;
	armor_bullet = 15;
	armor_energy = 15;
	armor_internaldamage = 15;
	armor_laser = 15;
	armor_melee = 15;
	armor_rad = 10;
	name = "damaged WY PMC gloves"
	},
/turf/open/floor/platingdmg1,
/area/lv624/lazarus/hydroponics)
"cY" = (
/obj/effect/landmark/crap_item,
/turf/open/floor/plating/panelscorched,
/area/lv624/lazarus/hydroponics)
"dl" = (
/obj/structure/machinery/portable_atmospherics/hydroponics,
/turf/open/floor/plating/panelscorched,
/area/lv624/lazarus/hydroponics)
"eF" = (
/turf/open/floor/green/northwest,
/area/lv624/lazarus/hydroponics)
"eU" = (
/turf/open/gm/dirtgrassborder/grassdirt_corner2/north_east,
/area/lv624/ground/colony/north_nexus_road)
"fk" = (
/turf/open/gm/dirtgrassborder/grassdirt_corner2/north_west,
/area/lv624/ground/colony/south_medbay_road)
"fJ" = (
/obj/effect/decal/cleanable/blood/xeno,
/turf/open/floor/plating/platingdmg3,
/area/lv624/lazarus/hydroponics)
"hu" = (
/obj/item/stack/sheet/metal,
/obj/effect/spawner/random/claymore/midchance{
	dir = 1
	},
/turf/open/floor/plating/panelscorched,
/area/lv624/lazarus/hydroponics)
"hI" = (
/turf/open/floor/plating/platingdmg3,
/area/lv624/lazarus/hydroponics)
"iG" = (
/obj/structure/machinery/portable_atmospherics/hydroponics,
/turf/open/floor/plating/platingdmg3,
/area/lv624/lazarus/hydroponics)
"iZ" = (
/obj/effect/decal/cleanable/blood/xeno,
/turf/open/floor/platingdmg1,
/area/lv624/lazarus/hydroponics)
"jg" = (
/obj/structure/flora/bush/ausbushes/var3/sparsegrass,
/turf/open/gm/grass/grass1,
/area/lv624/ground/jungle/north_jungle)
"kg" = (
/obj/structure/window/framed/colony/reinforced,
/turf/open/floor,
/area/lv624/lazarus/hydroponics)
"kh" = (
/obj/structure/girder,
/turf/open/floor,
/area/lv624/lazarus/hydroponics)
"kk" = (
/obj/structure/girder,
/turf/open/floor/platingdmg1,
/area/lv624/lazarus/hydroponics)
"kW" = (
/obj/structure/barricade/deployable{
	damage_state = 1;
	dir = 1;
	health = 245;
	icon_state = "folding_1"
	},
/obj/item/weapon/gun/pistol/vp78{
	current_mag = null;
	name = "dented VP78 pistol";
	pixel_x = -5;
	pixel_y = -4
	},
/obj/item/ammo_magazine/pistol/vp78{
	current_rounds = 4;
	name = "scratched VP78 magazine (9mm)";
	pixel_x = 6
	},
/turf/open/floor/plating/platingdmg3,
/area/lv624/lazarus/hydroponics)
"ls" = (
/obj/item/stack/sheet/metal,
/turf/open/floor/platingdmg1,
/area/lv624/lazarus/hydroponics)
"lM" = (
/obj/item/stack/sheet/metal,
/obj/effect/decal/cleanable/blood/tracks/footprints{
	dir = 1
	},
/turf/open/floor/plating/panelscorched,
/area/lv624/lazarus/hydroponics)
"lP" = (
/obj/item/stack/sheet/metal,
/obj/effect/spawner/random/claymore/midchance{
	dir = 4
	},
/turf/open/floor/plating,
/area/lv624/lazarus/hydroponics)
"lQ" = (
/obj/effect/landmark/crap_item,
/turf/open/floor/green/northwest,
/area/lv624/lazarus/hydroponics)
"mE" = (
/obj/item/tool/hatchet{
	pixel_x = 6;
	pixel_y = 4
	},
/obj/structure/machinery/portable_atmospherics/hydroponics,
/turf/open/floor/plating/platingdmg3,
/area/lv624/lazarus/hydroponics)
"mI" = (
/obj/effect/decal/cleanable/blood/tracks/footprints{
	dir = 1
	},
/turf/open/floor/plating/panelscorched,
/area/lv624/lazarus/hydroponics)
"nJ" = (
/obj/item/stack/sheet/metal,
/turf/open/floor,
/area/lv624/lazarus/hydroponics)
"nL" = (
/obj/item/tool/weldingtool/simple,
/obj/item/stack/sheet/wood,
/turf/open/floor/green/northwest,
/area/lv624/lazarus/hydroponics)
"og" = (
/turf/open/gm/dirt,
/area/lv624/ground/colony/south_medbay_road)
"op" = (
/obj/item/clothing/gloves/botanic_leather,
/obj/item/stack/sheet/metal,
/turf/open/floor/plating/panelscorched,
/area/lv624/lazarus/hydroponics)
"ou" = (
/turf/open/gm/dirt,
/area/lv624/ground/colony/north_nexus_road)
"qU" = (
/obj/structure/surface/rack,
/obj/item/tool/crowbar,
/obj/item/reagent_container/glass/bucket{
	pixel_y = -3
	},
/obj/item/reagent_container/glass/bucket,
/turf/open/floor/platingdmg1,
/area/lv624/lazarus/hydroponics)
"qZ" = (
/obj/item/storage/firstaid,
/obj/item/explosive/grenade/high_explosive/pmc{
	pixel_x = 6
	},
/turf/open/floor/plating/platingdmg3,
/area/lv624/lazarus/hydroponics)
"rO" = (
/turf/open/floor/platingdmg1,
/area/lv624/lazarus/hydroponics)
"rW" = (
/obj/item/device/analyzer/plant_analyzer,
/obj/effect/landmark/crap_item,
/turf/open/floor/platingdmg1,
/area/lv624/lazarus/hydroponics)
"se" = (
/obj/structure/fence,
/turf/open/gm/dirtgrassborder/north,
/area/lv624/ground/colony/south_medbay_road)
"sL" = (
/obj/effect/decal/cleanable/blood/tracks/footprints{
	dir = 1
	},
/turf/open/floor/platingdmg1,
/area/lv624/lazarus/hydroponics)
"vP" = (
/obj/structure/closet/crate/hydroponics/prespawned,
/turf/open/floor/platingdmg1,
/area/lv624/lazarus/hydroponics)
"xm" = (
/obj/item/stack/sheet/metal,
/obj/effect/spawner/random/claymore/lowchance,
/turf/open/floor/plating,
/area/lv624/lazarus/hydroponics)
"xA" = (
/obj/item/reagent_container/glass/bucket,
/turf/open/floor/plating/platingdmg3,
/area/lv624/lazarus/hydroponics)
"yb" = (
/obj/effect/decal/cleanable/blood/xeno,
/turf/open/floor/plating/panelscorched,
/area/lv624/lazarus/hydroponics)
"yr" = (
/obj/item/device/analyzer/plant_analyzer,
/obj/effect/spawner/random/claymore,
/turf/open/floor/green/northwest,
/area/lv624/lazarus/hydroponics)
"zj" = (
/obj/item/stack/folding_barricade,
/obj/item/ammo_magazine/rifle/nsg23{
	current_rounds = 17
	},
/obj/effect/spawner/gibspawner/human,
/obj/item/clothing/head/helmet/marine/veteran/pmc,
/turf/open/floor/plating,
/area/lv624/lazarus/hydroponics)
"zS" = (
/obj/structure/window_frame/colony,
/obj/item/shard,
/turf/open/floor,
/area/lv624/lazarus/hydroponics)
"Ag" = (
/obj/structure/barricade/deployable{
	damage_state = 2;
	dir = 8;
	health = 140;
	icon_state = "folding_2"
	},
/obj/item/weapon/gun/rifle/nsg23,
/obj/item/ammo_magazine/rifle/nsg23,
/turf/open/floor/plating/panelscorched,
/area/lv624/lazarus/hydroponics)
"Aj" = (
/obj/item/ammo_magazine/rifle/nsg23,
/obj/item/stack/sheet/wood,
/turf/open/floor/plating/panelscorched,
/area/lv624/lazarus/hydroponics)
"AQ" = (
/obj/effect/landmark/crap_item,
/obj/item/reagent_container/glass/watertank,
/turf/open/floor/platingdmg1,
/area/lv624/lazarus/hydroponics)
"BD" = (
/obj/effect/decal/cleanable/blood,
/obj/item/clothing/under/marine/veteran/pmc{
	pixel_x = -7;
	pixel_y = 9
	},
/turf/open/floor/plating/panelscorched,
/area/lv624/lazarus/hydroponics)
"BF" = (
/obj/structure/surface/rack,
/obj/item/tool/shovel/spade,
/obj/item/tool/hatchet{
	pixel_x = 6;
	pixel_y = 4
	},
/obj/item/tool/hatchet{
	pixel_x = 6;
	pixel_y = 4
	},
/obj/item/tool/minihoe{
	pixel_y = -2
	},
/turf/open/floor/plating/platingdmg3,
/area/lv624/lazarus/hydroponics)
"BL" = (
/obj/structure/flora/bush/ausbushes/genericbush,
/turf/open/gm/grass/grass1,
/area/lv624/ground/jungle/north_jungle)
"CX" = (
/obj/structure/girder,
/turf/open/floor/green/northwest,
/area/lv624/lazarus/hydroponics)
"Dr" = (
/obj/item/stack/sheet/metal,
/obj/effect/spawner/random/claymore/midchance{
	dir = 4
	},
/turf/open/floor/green/northwest,
/area/lv624/lazarus/hydroponics)
"Fk" = (
/obj/item/clothing/head/helmet/marine/veteran/pmc{
	pixel_x = -13;
	pixel_y = 11
	},
/turf/open/floor/plating,
/area/lv624/lazarus/hydroponics)
"FD" = (
/obj/structure/window_frame/colony,
/turf/open/floor/green/northwest,
/area/lv624/lazarus/hydroponics)
"It" = (
/obj/item/stack/sheet/metal,
/turf/open/floor/green/northwest,
/area/lv624/lazarus/hydroponics)
"IN" = (
/obj/item/stack/sheet/metal,
/turf/open/floor/plating/platingdmg3,
/area/lv624/lazarus/hydroponics)
"Jw" = (
/obj/item/stack/sheet/metal,
/obj/item/robot_parts/leg/l_leg,
/turf/open/floor/plating/panelscorched,
/area/lv624/lazarus/hydroponics)
"JE" = (
/turf/open/floor,
/area/lv624/lazarus/hydroponics)
"Km" = (
/turf/open/gm/grass/grass1,
/area/lv624/ground/colony/south_medbay_road)
"Lw" = (
/obj/effect/decal/cleanable/blood,
/obj/item/weapon/gun/smg/fp9000,
/obj/item/ammo_magazine/smg/fp9000{
	pixel_x = 1
	},
/obj/item/ammo_magazine/smg/fp9000{
	pixel_x = -3
	},
/obj/structure/barricade/wooden{
	dir = 8
	},
/turf/open/floor/plating/panelscorched,
/area/lv624/lazarus/hydroponics)
"Mk" = (
/obj/item/stack/sheet/metal,
/obj/effect/spawner/random/claymore/midchance,
/turf/open/floor/plating/platingdmg3,
/area/lv624/lazarus/hydroponics)
"Mm" = (
/obj/effect/landmark/crap_item,
/turf/open/gm/grass/grass1,
/area/lv624/ground/colony/south_medbay_road)
"ME" = (
/obj/effect/decal/cleanable/blood,
/obj/structure/barricade/wooden{
	dir = 4
	},
/turf/open/floor/plating/platingdmg3,
/area/lv624/lazarus/hydroponics)
"MW" = (
/obj/item/tool/crowbar,
/obj/effect/spawner/random/claymore/midchance{
	dir = 4
	},
/turf/open/floor/platingdmg1,
/area/lv624/lazarus/hydroponics)
"Ne" = (
/obj/item/stack/sheet/metal,
/obj/effect/spawner/random/claymore/lowchance{
	dir = 8
	},
/turf/open/floor/platingdmg1,
/area/lv624/lazarus/hydroponics)
"Np" = (
/obj/item/clothing/suit/storage/marine/veteran/pmc/light/synth{
	desc = "A serious modification of the standard Armat Systems M3 armor. This variant was designed for PMC Support Units in the field, with every armor insert removed. It's designed with the idea of a high speed lifesaver in mind. This set seems damaged...";
	name = "damaged M4 Synthetic PMC armor";
	pixel_x = -5;
	pixel_y = -5
	},
/obj/effect/spawner/gibspawner/robot,
/obj/item/limb/head/synth{
	desc = "This appears to be the head of a synthetic, though it it is so destroyed there is no way in hell anyone is going to bring it back to even basic functionality.";
	name = "shattered synthetic head";
	pixel_x = 9;
	pixel_y = 3;
	icon_state = "scandinavian_head_m"
	},
/obj/item/robot_parts/arm/l_arm,
/turf/open/floor/green/northwest,
/area/lv624/lazarus/hydroponics)
"NG" = (
/obj/item/stack/sheet/metal,
/obj/item/explosive/mine/pmc/active{
	dir = 1
	},
/turf/open/floor/platingdmg1,
/area/lv624/lazarus/hydroponics)
"NO" = (
/obj/effect/landmark/crap_item,
/turf/open/floor/plating,
/area/lv624/lazarus/hydroponics)
"OI" = (
/obj/item/reagent_container/glass/fertilizer,
/obj/item/stack/sheet/metal,
/turf/open/floor/plating,
/area/lv624/lazarus/hydroponics)
"OS" = (
/obj/effect/landmark/crap_item,
/turf/open/floor/platingdmg1,
/area/lv624/lazarus/hydroponics)
"Py" = (
/obj/item/stack/sheet/metal,
/obj/effect/spawner/random/claymore/lowchance{
	dir = 4
	},
/turf/open/floor/platingdmg1,
/area/lv624/lazarus/hydroponics)
"Qd" = (
/obj/item/stack/folding_barricade,
/obj/item/ammo_magazine/smg/fp9000,
/obj/item/ammo_magazine/smg/fp9000,
/obj/item/ammo_magazine/smg/fp9000,
/obj/item/clothing/gloves/marine/veteran/pmc{
	armor_bio = 10;
	armor_bomb = 10;
	armor_bullet = 15;
	armor_energy = 15;
	armor_internaldamage = 15;
	armor_laser = 15;
	armor_melee = 15;
	armor_rad = 10;
	name = "damaged WY PMC gloves";
	pixel_y = 9
	},
/turf/open/floor/plating,
/area/lv624/lazarus/hydroponics)
"QV" = (
/obj/item/tool/extinguisher,
/obj/effect/decal/cleanable/blood/tracks/footprints{
	dir = 1
	},
/turf/open/floor/platingdmg1,
/area/lv624/lazarus/hydroponics)
"RD" = (
/obj/item/tool/minihoe{
	pixel_x = 1;
	pixel_y = -1
	},
/turf/open/floor/green/northwest,
/area/lv624/lazarus/hydroponics)
"RR" = (
/obj/structure/barricade/deployable{
	damage_state = 3;
	health = 50;
	icon_state = "folding_3"
	},
/obj/item/ammo_magazine/rifle/nsg23,
/obj/item/ammo_magazine/rifle/nsg23,
/obj/item/ammo_magazine/rifle/nsg23,
/turf/open/floor/plating/panelscorched,
/area/lv624/lazarus/hydroponics)
"Tj" = (
/obj/item/stack/sheet/wood{
	amount = 16
	},
/obj/item/ammo_magazine/rifle/nsg23{
	current_rounds = 13
	},
/obj/effect/spawner/gibspawner/human,
/obj/item/clothing/head/helmet/marine/veteran/pmc{
	pixel_x = -6;
	pixel_y = 8
	},
/turf/open/floor/plating/platingdmg3,
/area/lv624/lazarus/hydroponics)
"Vc" = (
/obj/structure/barricade/deployable{
	damage_state = 3;
	dir = 1;
	health = 45;
	icon_state = "folding_3"
	},
/obj/effect/decal/cleanable/blood,
/obj/item/weapon/gun/smg/fp9000,
/obj/item/clothing/under/marine/veteran/pmc/leader{
	pixel_x = -7
	},
/turf/open/floor/plating/panelscorched,
/area/lv624/lazarus/hydroponics)
"Wg" = (
/turf/open/floor/plating,
/area/lv624/lazarus/hydroponics)
"XA" = (
/turf/open/gm/grass/grass1,
/area/lv624/ground/jungle/north_jungle)
"XJ" = (
/obj/structure/flora/bush/ausbushes/ausbush,
/turf/open/gm/grass/grass1,
/area/lv624/ground/jungle/north_jungle)
"XM" = (
/obj/structure/surface/rack,
/obj/item/clothing/suit/apron,
/obj/item/tool/shovel,
/obj/item/clothing/gloves/botanic_leather,
/turf/open/floor/platingdmg1,
/area/lv624/lazarus/hydroponics)

(1,1,1) = {"
XA
XA
XA
jg
XA
kg
JE
JE
zS
Km
Km
Km
Mm
se
"}
(2,1,1) = {"
XA
BL
XA
XA
XA
kh
JE
JE
nJ
Km
Km
Km
Km
se
"}
(3,1,1) = {"
XA
XA
XA
BL
rO
kk
ls
Wg
Dr
CX
Km
Km
Km
se
"}
(4,1,1) = {"
XJ
CX
FD
hI
Ne
Wg
MW
iZ
eF
kk
Wg
ls
eF
se
"}
(5,1,1) = {"
XA
Py
rO
hI
iZ
Wg
rO
Wg
Wg
vP
vP
qU
kk
fk
"}
(6,1,1) = {"
XA
ls
Wg
Wg
lQ
xA
hI
eF
Wg
Wg
lP
XM
kk
og
"}
(7,1,1) = {"
eF
eF
fJ
Wg
It
dl
Ag
Lw
iG
eF
fJ
BF
eF
eF
"}
(8,1,1) = {"
rO
Wg
cX
hI
hu
Vc
zj
Aj
cM
dl
Wg
Mk
RD
eF
"}
(9,1,1) = {"
sL
QV
sL
mI
lM
mI
qZ
Qd
RR
cY
Wg
hI
ls
eF
"}
(10,1,1) = {"
by
eF
bV
dl
Fk
BD
kW
Tj
iG
yr
hI
Wg
iZ
eF
"}
(11,1,1) = {"
eF
eF
yb
eF
Wg
hI
mE
ME
nL
eF
Wg
xm
rO
rO
"}
(12,1,1) = {"
eF
NG
AQ
bV
Np
Wg
hI
Wg
hI
hI
IN
OI
CX
CX
"}
(13,1,1) = {"
XA
ax
rW
Jw
fJ
hI
NO
Wg
hI
IN
ck
aR
rO
ou
"}
(14,1,1) = {"
XA
FD
op
ch
OS
Wg
Wg
Wg
iZ
Wg
IN
ls
FD
eU
"}
(15,1,1) = {"
XA
eF
eF
ls
rO
eF
eF
rO
ak
eF
eF
rO
CX
bM
"}
(16,1,1) = {"
XA
XA
XA
XA
eF
eF
eF
eF
FD
CX
XA
XA
XA
bM
"}
