//MAP CONVERTED BY dmm2tgm.py THIS HEADER COMMENT PREVENTS RECONVERSION, DO NOT REMOVE
"ai" = (
/obj/structure/closet/crate/hydroponics/prespawned,
/turf/open/floor/platingdmg1,
/area/lv624/lazarus/hydroponics)
"aL" = (
/obj/structure/window_frame/colony,
/turf/open/floor/platingdmg1,
/area/lv624/lazarus/hydroponics)
"bg" = (
/obj/item/stack/sheet/metal,
/obj/item/robot_parts/leg/l_leg,
/turf/open/floor/plating/panelscorched,
/area/lv624/lazarus/hydroponics)
"bM" = (
/obj/structure/fence,
/turf/open/gm/dirtgrassborder/north,
/area/lv624/ground/colony/north_nexus_road)
"ck" = (
/obj/effect/decal/cleanable/blood/xeno,
/turf/open/floor/plating,
/area/lv624/lazarus/hydroponics)
"dM" = (
/obj/item/clothing/suit/storage/marine/veteran/pmc/light/synth{
	desc = "A serious modification of the standard Armat Systems M3 armor. This variant was designed for PMC Support Units in the field, with every armor insert removed. It's designed with the idea of a high speed lifesaver in mind. This set seems damaged...";
	name = "damaged M4 Synthetic PMC armor";
	pixel_x = -5;
	pixel_y = -5
	},
/obj/effect/spawner/gibspawner/robot,
/obj/item/limb/head/synth{
	desc = "This appears to be the head of a synthetic, though it it is so destroyed there is no way in hell anyone is going to bring it back to even basic functionality.";
	name = "shattered synthetic head";
	pixel_x = 9;
	pixel_y = 3;
	icon_state = "scandinavian_head_m"
	},
/obj/item/robot_parts/arm/l_arm,
/turf/open/floor/green/northwest,
/area/lv624/lazarus/hydroponics)
"ez" = (
/obj/item/clothing/gloves/botanic_leather,
/obj/item/stack/sheet/metal,
/turf/open/floor/plating/panelscorched,
/area/lv624/lazarus/hydroponics)
"eU" = (
/turf/open/gm/dirtgrassborder/grassdirt_corner2/north_east,
/area/lv624/ground/colony/north_nexus_road)
"fk" = (
/turf/open/gm/dirtgrassborder/grassdirt_corner2/north_west,
/area/lv624/ground/colony/south_medbay_road)
"gb" = (
/turf/open/floor/plating/platingdmg3,
/area/lv624/lazarus/hydroponics)
"gf" = (
/obj/item/stack/sheet/metal,
/turf/open/floor/plating/platingdmg3,
/area/lv624/lazarus/hydroponics)
"go" = (
/obj/structure/barricade/deployable{
	damage_state = 2;
	dir = 8;
	health = 140;
	icon_state = "folding_2"
	},
/obj/item/weapon/gun/rifle/nsg23/no_lock,
/obj/item/ammo_magazine/rifle/nsg23,
/turf/open/floor/plating/panelscorched,
/area/lv624/lazarus/hydroponics)
"jg" = (
/obj/structure/flora/bush/ausbushes/var3/sparsegrass,
/turf/open/gm/grass/grass1,
/area/lv624/ground/jungle/north_jungle)
"jj" = (
/obj/item/ammo_magazine/rifle/nsg23/extended,
/obj/item/stack/sheet/wood,
/turf/open/floor/plating/panelscorched,
/area/lv624/lazarus/hydroponics)
"kg" = (
/obj/structure/window/framed/colony/reinforced,
/turf/open/floor,
/area/lv624/lazarus/hydroponics)
"kh" = (
/obj/structure/girder,
/turf/open/floor,
/area/lv624/lazarus/hydroponics)
"kq" = (
/obj/item/stack/sheet/metal,
/obj/effect/spawner/random/claymore/midchance{
	dir = 1
	},
/turf/open/floor/plating/panelscorched,
/area/lv624/lazarus/hydroponics)
"lk" = (
/obj/structure/window_frame/colony,
/turf/open/floor/green/northwest,
/area/lv624/lazarus/hydroponics)
"lH" = (
/obj/item/stack/sheet/metal,
/obj/effect/spawner/random/claymore/lowchance,
/turf/open/floor/platingdmg1,
/area/lv624/lazarus/hydroponics)
"lP" = (
/obj/item/stack/sheet/metal,
/obj/effect/spawner/random/claymore/midchance{
	dir = 4
	},
/turf/open/floor/plating,
/area/lv624/lazarus/hydroponics)
"nJ" = (
/obj/item/stack/sheet/metal,
/turf/open/floor,
/area/lv624/lazarus/hydroponics)
"og" = (
/turf/open/gm/dirt,
/area/lv624/ground/colony/south_medbay_road)
"om" = (
/obj/structure/barricade/deployable{
	damage_state = 3;
	health = 50;
	icon_state = "folding_3"
	},
/obj/item/ammo_magazine/rifle/nsg23,
/obj/item/ammo_magazine/rifle/nsg23,
/obj/item/ammo_magazine/rifle/nsg23,
/turf/open/floor/plating/panelscorched,
/area/lv624/lazarus/hydroponics)
"ou" = (
/turf/open/gm/dirt,
/area/lv624/ground/colony/north_nexus_road)
"pJ" = (
/turf/open/floor/green/northwest,
/area/lv624/lazarus/hydroponics)
"qH" = (
/obj/item/reagent_container/spray/plantbgone{
	pixel_x = 4;
	pixel_y = 6
	},
/obj/effect/landmark/crap_item,
/obj/item/stack/sheet/metal,
/obj/effect/spawner/random/claymore/midchance{
	dir = 1
	},
/turf/open/floor/platingdmg1,
/area/lv624/lazarus/hydroponics)
"qJ" = (
/obj/effect/landmark/crap_item,
/turf/open/floor/platingdmg1,
/area/lv624/lazarus/hydroponics)
"qM" = (
/obj/structure/girder,
/turf/open/floor/platingdmg1,
/area/lv624/lazarus/hydroponics)
"qP" = (
/obj/effect/decal/cleanable/blood,
/obj/item/weapon/gun/smg/fp9000,
/obj/item/ammo_magazine/smg/fp9000{
	pixel_x = 1
	},
/obj/item/ammo_magazine/smg/fp9000{
	pixel_x = -3
	},
/obj/structure/barricade/wooden{
	dir = 8
	},
/turf/open/floor/plating/panelscorched,
/area/lv624/lazarus/hydroponics)
"rf" = (
/obj/effect/decal/cleanable/blood/tracks/footprints{
	dir = 1
	},
/turf/open/floor/plating/panelscorched,
/area/lv624/lazarus/hydroponics)
"ry" = (
/obj/item/stack/sheet/metal,
/obj/effect/spawner/random/claymore/lowchance{
	dir = 4
	},
/turf/open/floor/platingdmg1,
/area/lv624/lazarus/hydroponics)
"se" = (
/obj/structure/fence,
/turf/open/gm/dirtgrassborder/north,
/area/lv624/ground/colony/south_medbay_road)
"tB" = (
/obj/effect/decal/cleanable/blood/xeno,
/turf/open/floor/platingdmg1,
/area/lv624/lazarus/hydroponics)
"uo" = (
/obj/item/stack/sheet/metal,
/obj/effect/spawner/random/claymore/midchance{
	dir = 4
	},
/turf/open/floor/green/northwest,
/area/lv624/lazarus/hydroponics)
"uR" = (
/obj/effect/landmark/crap_item,
/turf/open/floor/plating/panelscorched,
/area/lv624/lazarus/hydroponics)
"uZ" = (
/obj/effect/decal/cleanable/blood,
/obj/item/ammo_magazine/rifle/nsg23{
	current_rounds = 2
	},
/obj/effect/spawner/gibspawner/human,
/obj/item/clothing/under/marine/veteran/pmc{
	pixel_x = 6;
	pixel_y = 8
	},
/turf/open/floor/plating/panelscorched,
/area/lv624/lazarus/hydroponics)
"xm" = (
/obj/item/stack/sheet/metal,
/obj/effect/spawner/random/claymore/lowchance,
/turf/open/floor/plating,
/area/lv624/lazarus/hydroponics)
"xr" = (
/obj/item/storage/firstaid,
/obj/item/explosive/grenade/high_explosive/pmc{
	pixel_x = 6
	},
/turf/open/floor/plating/platingdmg3,
/area/lv624/lazarus/hydroponics)
"yy" = (
/obj/item/stack/sheet/wood{
	amount = 16
	},
/obj/item/ammo_magazine/rifle/nsg23{
	current_rounds = 13
	},
/obj/effect/spawner/gibspawner/human,
/obj/item/clothing/head/helmet/marine/veteran/pmc{
	pixel_x = -6;
	pixel_y = 8
	},
/turf/open/floor/plating/platingdmg3,
/area/lv624/lazarus/hydroponics)
"zj" = (
/obj/item/stack/folding_barricade,
/obj/item/ammo_magazine/rifle/nsg23{
	current_rounds = 17
	},
/obj/effect/spawner/gibspawner/human,
/obj/item/clothing/head/helmet/marine/veteran/pmc/leader,
/turf/open/floor/plating,
/area/lv624/lazarus/hydroponics)
"zS" = (
/obj/structure/window_frame/colony,
/obj/item/shard,
/turf/open/floor,
/area/lv624/lazarus/hydroponics)
"Ao" = (
/obj/item/reagent_container/glass/bucket,
/turf/open/floor/plating/platingdmg3,
/area/lv624/lazarus/hydroponics)
"BE" = (
/obj/effect/landmark/crap_item,
/turf/open/floor/green/northwest,
/area/lv624/lazarus/hydroponics)
"BL" = (
/obj/structure/flora/bush/ausbushes/genericbush,
/turf/open/gm/grass/grass1,
/area/lv624/ground/jungle/north_jungle)
"Dg" = (
/obj/effect/decal/cleanable/blood,
/obj/item/clothing/under/marine/veteran/pmc{
	pixel_x = -7;
	pixel_y = 9
	},
/turf/open/floor/plating/panelscorched,
/area/lv624/lazarus/hydroponics)
"Dl" = (
/obj/item/tool/crowbar,
/obj/effect/spawner/random/claymore/midchance{
	dir = 4
	},
/turf/open/floor/platingdmg1,
/area/lv624/lazarus/hydroponics)
"Ds" = (
/obj/item/stack/sheet/metal,
/obj/effect/decal/cleanable/blood/tracks/footprints{
	dir = 1
	},
/turf/open/floor/plating/panelscorched,
/area/lv624/lazarus/hydroponics)
"Ey" = (
/turf/open/floor/plating/panelscorched,
/area/lv624/lazarus/hydroponics)
"EA" = (
/obj/effect/decal/cleanable/blood/tracks/footprints{
	dir = 1
	},
/turf/open/floor/platingdmg1,
/area/lv624/lazarus/hydroponics)
"Fg" = (
/obj/structure/barricade/deployable{
	damage_state = 3;
	dir = 1;
	health = 45;
	icon_state = "folding_3"
	},
/obj/effect/decal/cleanable/blood,
/obj/item/weapon/gun/smg/fp9000,
/obj/item/clothing/under/marine/veteran/pmc/leader{
	pixel_x = -7
	},
/turf/open/floor/plating/panelscorched,
/area/lv624/lazarus/hydroponics)
"Fk" = (
/obj/item/clothing/head/helmet/marine/veteran/pmc{
	pixel_x = -13;
	pixel_y = 11
	},
/turf/open/floor/plating,
/area/lv624/lazarus/hydroponics)
"HI" = (
/obj/item/tool/hatchet{
	pixel_x = 6;
	pixel_y = 4
	},
/obj/structure/machinery/portable_atmospherics/hydroponics,
/turf/open/floor/plating/platingdmg3,
/area/lv624/lazarus/hydroponics)
"Ie" = (
/obj/item/clothing/gloves/marine/veteran/pmc{
	armor_bio = 10;
	armor_bomb = 10;
	armor_bullet = 15;
	armor_energy = 15;
	armor_internaldamage = 15;
	armor_laser = 15;
	armor_melee = 15;
	armor_rad = 10;
	name = "damaged WY PMC gloves"
	},
/turf/open/floor/platingdmg1,
/area/lv624/lazarus/hydroponics)
"JE" = (
/turf/open/floor,
/area/lv624/lazarus/hydroponics)
"Km" = (
/turf/open/gm/grass/grass1,
/area/lv624/ground/colony/south_medbay_road)
"Kt" = (
/obj/item/device/analyzer/plant_analyzer,
/obj/effect/landmark/crap_item,
/turf/open/floor/platingdmg1,
/area/lv624/lazarus/hydroponics)
"KO" = (
/obj/structure/machinery/portable_atmospherics/hydroponics,
/turf/open/floor/plating/platingdmg3,
/area/lv624/lazarus/hydroponics)
"KV" = (
/obj/effect/landmark/crap_item,
/obj/item/reagent_container/glass/watertank,
/turf/open/floor/platingdmg1,
/area/lv624/lazarus/hydroponics)
"LG" = (
/obj/structure/girder,
/turf/open/floor/green/northwest,
/area/lv624/lazarus/hydroponics)
"LU" = (
/obj/structure/surface/rack,
/obj/item/clothing/suit/apron,
/obj/item/tool/shovel,
/obj/item/clothing/gloves/botanic_leather,
/turf/open/floor/platingdmg1,
/area/lv624/lazarus/hydroponics)
"Mm" = (
/obj/effect/landmark/crap_item,
/turf/open/gm/grass/grass1,
/area/lv624/ground/colony/south_medbay_road)
"MY" = (
/obj/structure/barricade/deployable{
	damage_state = 1;
	dir = 1;
	health = 245;
	icon_state = "folding_1"
	},
/obj/effect/landmark/corpsespawner/wy/manager,
/obj/item/weapon/gun/pistol/vp78{
	current_mag = null;
	name = "dented VP78 pistol";
	pixel_x = -5;
	pixel_y = -4
	},
/obj/item/ammo_magazine/pistol/vp78{
	current_rounds = 4;
	name = "scratched VP78 magazine (9mm)";
	pixel_x = 6
	},
/turf/open/floor/plating/platingdmg3,
/area/lv624/lazarus/hydroponics)
"Nl" = (
/turf/open/floor/platingdmg1,
/area/lv624/lazarus/hydroponics)
"NO" = (
/obj/effect/landmark/crap_item,
/turf/open/floor/plating,
/area/lv624/lazarus/hydroponics)
"Ox" = (
/obj/structure/surface/rack,
/obj/item/tool/crowbar,
/obj/item/reagent_container/glass/bucket{
	pixel_y = -3
	},
/obj/item/reagent_container/glass/bucket,
/turf/open/floor/platingdmg1,
/area/lv624/lazarus/hydroponics)
"OG" = (
/obj/item/tool/minihoe{
	pixel_x = 1;
	pixel_y = -1
	},
/turf/open/floor/green/northwest,
/area/lv624/lazarus/hydroponics)
"OI" = (
/obj/item/reagent_container/glass/fertilizer,
/obj/item/stack/sheet/metal,
/turf/open/floor/plating,
/area/lv624/lazarus/hydroponics)
"Pd" = (
/obj/item/device/analyzer/plant_analyzer,
/obj/effect/spawner/random/claymore,
/turf/open/floor/green/northwest,
/area/lv624/lazarus/hydroponics)
"Qd" = (
/obj/item/stack/folding_barricade,
/obj/item/ammo_magazine/smg/fp9000,
/obj/item/ammo_magazine/smg/fp9000,
/obj/item/ammo_magazine/smg/fp9000,
/obj/item/clothing/gloves/marine/veteran/pmc{
	armor_bio = 10;
	armor_bomb = 10;
	armor_bullet = 15;
	armor_energy = 15;
	armor_internaldamage = 15;
	armor_laser = 15;
	armor_melee = 15;
	armor_rad = 10;
	name = "damaged WY PMC gloves";
	pixel_y = 9
	},
/turf/open/floor/plating,
/area/lv624/lazarus/hydroponics)
"Rm" = (
/obj/effect/decal/cleanable/blood,
/obj/structure/barricade/wooden{
	dir = 4
	},
/obj/item/weapon/gun/rifle/nsg23/no_lock,
/turf/open/floor/plating/platingdmg3,
/area/lv624/lazarus/hydroponics)
"Rw" = (
/obj/item/tool/extinguisher,
/obj/effect/decal/cleanable/blood/tracks/footprints{
	dir = 1
	},
/turf/open/floor/platingdmg1,
/area/lv624/lazarus/hydroponics)
"RM" = (
/obj/item/tool/weldingtool/simple,
/obj/item/stack/sheet/wood,
/turf/open/floor/green/northwest,
/area/lv624/lazarus/hydroponics)
"RS" = (
/obj/structure/surface/rack,
/obj/item/tool/shovel/spade,
/obj/item/tool/hatchet{
	pixel_x = 6;
	pixel_y = 4
	},
/obj/item/tool/hatchet{
	pixel_x = 6;
	pixel_y = 4
	},
/obj/item/tool/minihoe{
	pixel_y = -2
	},
/turf/open/floor/plating/platingdmg3,
/area/lv624/lazarus/hydroponics)
"RY" = (
/obj/item/stack/sheet/metal,
/turf/open/floor/green/northwest,
/area/lv624/lazarus/hydroponics)
"Sw" = (
/obj/item/stack/sheet/metal,
/turf/open/floor/platingdmg1,
/area/lv624/lazarus/hydroponics)
"SZ" = (
/obj/item/reagent_container/glass/fertilizer{
	pixel_x = 6;
	pixel_y = 2
	},
/obj/item/reagent_container/glass/fertilizer,
/obj/item/stack/sheet/metal,
/obj/effect/spawner/random/claymore/midchance,
/turf/open/floor/platingdmg1,
/area/lv624/lazarus/hydroponics)
"Up" = (
/obj/item/stack/sheet/metal,
/obj/item/explosive/mine/pmc/active{
	dir = 1
	},
/turf/open/floor/platingdmg1,
/area/lv624/lazarus/hydroponics)
"UE" = (
/obj/effect/decal/cleanable/blood/xeno,
/turf/open/floor/plating/panelscorched,
/area/lv624/lazarus/hydroponics)
"VT" = (
/obj/structure/machinery/portable_atmospherics/hydroponics,
/turf/open/floor/plating/panelscorched,
/area/lv624/lazarus/hydroponics)
"Wg" = (
/turf/open/floor/plating,
/area/lv624/lazarus/hydroponics)
"Wi" = (
/obj/effect/decal/cleanable/blood/xeno,
/turf/open/floor/plating/platingdmg3,
/area/lv624/lazarus/hydroponics)
"Wr" = (
/obj/item/clothing/shoes/veteran/pmc{
	armor_bio = 15;
	armor_bomb = 5;
	armor_bullet = 15;
	armor_energy = 5;
	armor_internaldamage = 5;
	armor_laser = 5;
	armor_melee = 15;
	desc = "The height of fashion, but these look to be woven with protective fiber. This pair seems heavily damaged, especially around the soles...";
	name = "scuffed shoes";
	pixel_x = -14;
	pixel_y = -10;
	slowdown = 0.5
	},
/turf/open/floor/green/northwest,
/area/lv624/lazarus/hydroponics)
"Xm" = (
/obj/item/stack/sheet/metal,
/obj/effect/spawner/random/claymore/lowchance{
	dir = 8
	},
/turf/open/floor/platingdmg1,
/area/lv624/lazarus/hydroponics)
"XA" = (
/turf/open/gm/grass/grass1,
/area/lv624/ground/jungle/north_jungle)
"XJ" = (
/obj/structure/flora/bush/ausbushes/ausbush,
/turf/open/gm/grass/grass1,
/area/lv624/ground/jungle/north_jungle)
"ZB" = (
/obj/item/stack/sheet/metal,
/obj/effect/spawner/random/claymore/midchance,
/turf/open/floor/plating/platingdmg3,
/area/lv624/lazarus/hydroponics)

(1,1,1) = {"
XA
XA
XA
jg
XA
kg
JE
JE
zS
Km
Km
Km
Mm
se
"}
(2,1,1) = {"
XA
BL
XA
XA
XA
kh
JE
JE
nJ
Km
Km
Km
Km
se
"}
(3,1,1) = {"
XA
XA
XA
BL
Nl
qM
Sw
Wg
uo
LG
Km
Km
Km
se
"}
(4,1,1) = {"
XJ
LG
lk
gb
Xm
Wg
Dl
tB
pJ
qM
Wg
Sw
pJ
se
"}
(5,1,1) = {"
XA
ry
Nl
gb
tB
Wg
Nl
Wg
Wg
ai
ai
Ox
qM
fk
"}
(6,1,1) = {"
XA
Sw
Wg
Wg
BE
Ao
gb
pJ
Wg
Wg
lP
LU
qM
og
"}
(7,1,1) = {"
pJ
pJ
Wi
Wg
RY
VT
go
qP
KO
pJ
Wi
RS
pJ
pJ
"}
(8,1,1) = {"
Nl
Wg
Ie
gb
kq
Fg
zj
jj
uZ
VT
Wg
ZB
OG
pJ
"}
(9,1,1) = {"
EA
Rw
EA
rf
Ds
rf
xr
Qd
om
uR
Wg
gb
Sw
pJ
"}
(10,1,1) = {"
Wr
pJ
Ey
VT
Fk
Dg
MY
yy
KO
Pd
gb
Wg
tB
pJ
"}
(11,1,1) = {"
pJ
pJ
UE
pJ
Wg
gb
HI
Rm
RM
pJ
Wg
xm
Nl
Nl
"}
(12,1,1) = {"
pJ
Up
KV
Ey
dM
Wg
gb
Wg
gb
gb
gf
OI
LG
LG
"}
(13,1,1) = {"
XA
aL
Kt
bg
Wi
gb
NO
Wg
gb
gf
ck
SZ
Nl
ou
"}
(14,1,1) = {"
XA
lk
ez
qH
qJ
Wg
Wg
Wg
tB
Wg
gf
Sw
lk
eU
"}
(15,1,1) = {"
XA
pJ
pJ
Sw
Nl
pJ
pJ
Nl
lH
pJ
pJ
Nl
LG
bM
"}
(16,1,1) = {"
XA
XA
XA
XA
pJ
pJ
pJ
pJ
lk
LG
XA
XA
XA
bM
"}
