//MAP CONVERTED BY dmm2tgm.py THIS HEADER COMMENT PREVENTS RECONVERSION, DO NOT REMOVE
"a" = (
/obj/item/tool/pickaxe,
/turf/open/floor/dark,
/area/lv624/ground/barrens/north_east_barrens/ceiling)
"c" = (
/obj/structure/surface/table/reinforced/prison,
/obj/item/weapon/gun/smg/nailgun,
/obj/item/weapon/gun/smg/nailgun,
/obj/item/ammo_box/magazine/nailgun,
/obj/item/ammo_box/magazine/nailgun,
/turf/open/floor/dark,
/area/lv624/ground/barrens/north_east_barrens/ceiling)
"f" = (
/obj/structure/surface/rack,
/obj/item/stack/sheet/mineral/gold{
	amount = 2
	},
/obj/item/stack/sheet/mineral/gold{
	amount = 2;
	pixel_x = 8
	},
/obj/item/stack/sheet/mineral/platinum{
	pixel_x = 4
	},
/turf/open/floor/vault2/west,
/area/lv624/ground/barrens/north_east_barrens/ceiling)
"g" = (
/obj/structure/machinery/light{
	dir = 4
	},
/obj/structure/surface/rack,
/obj/item/ammo_magazine/smg/mac15{
	pixel_x = 1
	},
/obj/item/ammo_magazine/smg/mac15{
	pixel_x = -3
	},
/obj/item/ammo_magazine/smg/mac15{
	pixel_x = -7
	},
/obj/item/ammo_magazine/smg/mac15{
	pixel_x = 6
	},
/turf/open/floor/vault2/west,
/area/lv624/ground/barrens/north_east_barrens/ceiling)
"h" = (
/obj/structure/closet/crate,
/obj/item/ammo_magazine/rifle/mar40,
/obj/item/ammo_magazine/rifle/mar40,
/obj/item/ammo_magazine/rifle/mar40,
/obj/item/ammo_magazine/rifle/mar40,
/obj/item/ammo_magazine/rifle/mar40,
/obj/item/ammo_magazine/rifle/mar40/extended,
/obj/item/ammo_magazine/rifle/mar40/extended,
/obj/item/ammo_magazine/smg/fp9000,
/obj/item/ammo_magazine/smg/fp9000,
/obj/item/ammo_magazine/smg/fp9000,
/obj/item/ammo_magazine/smg/fp9000,
/turf/open/floor/dark,
/area/lv624/ground/barrens/north_east_barrens/ceiling)
"j" = (
/turf/closed/wall,
/area/lv624/ground/barrens/north_east_barrens/ceiling)
"k" = (
/turf/open/floor/dark,
/area/lv624/ground/barrens/north_east_barrens/ceiling)
"l" = (
/obj/structure/machinery/door/airlock/almayer/secure/colony{
	dir = 1;
	icon_state = "door_locked";
	locked = 1;
	name = "\improper Armory Vault";
	req_access_txt = "100"
	},
/turf/open/floor/dark,
/area/lv624/ground/barrens/north_east_barrens/ceiling)
"m" = (
/obj/structure/surface/rack,
/obj/item/weapon/gun/rifle/mar40{
	pixel_y = -3
	},
/obj/item/weapon/gun/rifle/mar40{
	pixel_y = 6
	},
/obj/effect/landmark/crap_item,
/turf/open/floor/vault2/west,
/area/lv624/ground/barrens/north_east_barrens/ceiling)
"o" = (
/obj/structure/surface/rack,
/obj/item/weapon/gun/rifle/lmg,
/turf/open/floor/vault2/west,
/area/lv624/ground/barrens/north_east_barrens/ceiling)
"p" = (
/turf/open/gm/dirt,
/area/lv624/ground/barrens/north_east_barrens)
"q" = (
/obj/structure/closet/crate,
/obj/item/ammo_magazine/rifle/mar40,
/obj/item/ammo_magazine/rifle/mar40,
/obj/item/ammo_magazine/rifle/mar40,
/obj/item/ammo_magazine/rifle/mar40,
/obj/item/ammo_magazine/rifle/mar40,
/obj/item/ammo_magazine/rifle/mar40/extended,
/obj/item/ammo_magazine/rifle/mar40/extended,
/turf/open/floor/dark,
/area/lv624/ground/barrens/north_east_barrens/ceiling)
"r" = (
/obj/item/tool/shovel,
/turf/open/floor/dark,
/area/lv624/ground/barrens/north_east_barrens/ceiling)
"u" = (
/obj/effect/landmark/crap_item,
/turf/open/floor/dark,
/area/lv624/ground/barrens/north_east_barrens/ceiling)
"w" = (
/obj/structure/surface/rack,
/obj/item/weapon/gun/smg/mp27{
	pixel_y = -4
	},
/obj/item/weapon/gun/smg/mp27{
	pixel_y = 6
	},
/turf/open/floor/vault2/west,
/area/lv624/ground/barrens/north_east_barrens/ceiling)
"A" = (
/obj/structure/surface/rack,
/obj/item/weapon/gun/smg/fp9000,
/turf/open/floor/vault2/west,
/area/lv624/ground/barrens/north_east_barrens/ceiling)
"C" = (
/obj/structure/surface/rack,
/obj/item/stack/sheet/mineral/diamond{
	amount = 2
	},
/turf/open/floor/vault2/west,
/area/lv624/ground/barrens/north_east_barrens/ceiling)
"E" = (
/obj/structure/surface/rack,
/obj/item/weapon/gun/rifle/mar40{
	pixel_y = 6
	},
/obj/item/weapon/gun/rifle/mar40{
	pixel_y = -3
	},
/turf/open/floor/vault2/west,
/area/lv624/ground/barrens/north_east_barrens/ceiling)
"H" = (
/obj/structure/surface/rack,
/obj/item/ammo_magazine/smg/mp27,
/obj/item/ammo_magazine/smg/mp27{
	pixel_x = -8
	},
/obj/item/ammo_magazine/smg/mp27{
	pixel_x = -4
	},
/obj/item/ammo_magazine/smg/mp27,
/obj/item/ammo_magazine/smg/mp27{
	pixel_x = 4
	},
/obj/item/ammo_magazine/smg/mp27{
	pixel_x = 7
	},
/obj/structure/machinery/light{
	dir = 8
	},
/turf/open/floor/vault2/west,
/area/lv624/ground/barrens/north_east_barrens/ceiling)
"J" = (
/obj/structure/machinery/door/airlock/almayer/secure/colony{
	icon_state = "door_locked";
	locked = 1;
	name = "\improper Armory Vault";
	req_access_txt = "100"
	},
/turf/open/floor/dark,
/area/lv624/ground/barrens/north_east_barrens/ceiling)
"K" = (
/obj/effect/landmark/crap_item,
/turf/open/gm/dirt,
/area/lv624/ground/barrens/north_east_barrens)
"L" = (
/obj/structure/surface/table/reinforced/prison,
/obj/item/explosive/grenade/high_explosive/stick,
/obj/item/explosive/grenade/high_explosive/stick{
	pixel_x = 6
	},
/obj/item/explosive/grenade/high_explosive/stick{
	pixel_x = -6
	},
/turf/open/floor/vault2/west,
/area/lv624/ground/barrens/north_east_barrens/ceiling)
"M" = (
/obj/structure/surface/rack,
/obj/item/stack/sheet/mineral/gold{
	amount = 2
	},
/obj/item/stack/sheet/mineral/platinum{
	pixel_x = 6
	},
/obj/structure/machinery/light{
	dir = 4
	},
/turf/open/floor/vault2/west,
/area/lv624/ground/barrens/north_east_barrens/ceiling)
"S" = (
/obj/structure/surface/rack,
/obj/item/weapon/gun/smg/mac15,
/obj/item/weapon/gun/smg/mac15{
	pixel_y = 6
	},
/turf/open/floor/vault2/west,
/area/lv624/ground/barrens/north_east_barrens/ceiling)
"W" = (
/obj/structure/surface/rack,
/obj/item/stack/sheet/mineral/diamond{
	amount = 2
	},
/obj/structure/machinery/light{
	dir = 4
	},
/turf/open/floor/vault2/west,
/area/lv624/ground/barrens/north_east_barrens/ceiling)
"X" = (
/obj/effect/alien/weeds/node,
/turf/open/gm/dirt,
/area/lv624/ground/barrens/north_east_barrens)
"Y" = (
/obj/structure/machinery/light{
	dir = 8
	},
/turf/open/floor/dark,
/area/lv624/ground/barrens/north_east_barrens/ceiling)

(1,1,1) = {"
X
p
K
K
p
p
X
p
"}
(2,1,1) = {"
p
p
p
X
p
p
K
p
"}
(3,1,1) = {"
j
j
J
j
j
j
j
j
"}
(4,1,1) = {"
j
c
r
Y
j
H
w
j
"}
(5,1,1) = {"
j
k
k
k
l
u
k
j
"}
(6,1,1) = {"
j
m
k
f
j
k
a
j
"}
(7,1,1) = {"
j
E
k
A
j
k
k
j
"}
(8,1,1) = {"
j
q
k
h
j
o
M
j
"}
(9,1,1) = {"
j
S
u
C
j
j
j
j
"}
(10,1,1) = {"
j
g
L
W
j
X
K
p
"}
(11,1,1) = {"
j
j
j
j
j
p
p
p
"}
