//MAP CONVERTED BY dmm2tgm.py THIS HEADER COMMENT PREVENTS RECONVERSION, DO NOT REMOVE
"b" = (
/obj/effect/landmark/crap_item,
/turf/open/floor/dark,
/area/lv624/ground/barrens/north_east_barrens/ceiling)
"c" = (
/obj/structure/machinery/door/airlock/almayer/secure/colony{
	icon_state = "door_locked";
	locked = 1;
	name = "Mining Storage";
	req_access_txt = "100"
	},
/turf/open/floor/dark,
/area/lv624/ground/barrens/north_east_barrens/ceiling)
"f" = (
/turf/closed/wall,
/area/lv624/ground/barrens/north_east_barrens/ceiling)
"g" = (
/obj/structure/machinery/light{
	dir = 8
	},
/obj/effect/landmark/crap_item,
/turf/open/floor/dark,
/area/lv624/ground/barrens/north_east_barrens/ceiling)
"h" = (
/obj/structure/closet/crate,
/obj/item/ammo_magazine/rifle/mar40,
/obj/item/ammo_magazine/rifle/mar40,
/obj/item/ammo_magazine/rifle/mar40,
/obj/item/ammo_magazine/rifle/mar40,
/obj/item/ammo_magazine/rifle/mar40,
/obj/item/ammo_magazine/rifle/mar40/extended,
/obj/item/ammo_magazine/rifle/mar40/extended,
/obj/item/ammo_magazine/smg/fp9000,
/obj/item/ammo_magazine/smg/fp9000,
/obj/item/ammo_magazine/smg/fp9000,
/obj/item/ammo_magazine/smg/fp9000,
/turf/open/floor/dark,
/area/lv624/ground/barrens/north_east_barrens/ceiling)
"k" = (
/obj/structure/surface/rack,
/obj/item/tool/shovel,
/turf/open/floor/dark,
/area/lv624/ground/barrens/north_east_barrens/ceiling)
"l" = (
/obj/effect/landmark/crap_item,
/obj/effect/alien/weeds/node,
/turf/open/gm/dirt,
/area/lv624/ground/barrens/north_east_barrens)
"n" = (
/obj/structure/surface/rack,
/obj/item/stack/sheet/metal{
	amount = 50;
	pixel_x = 4;
	pixel_y = 4
	},
/obj/item/stack/sheet/metal{
	amount = 30
	},
/turf/open/floor/vault2/west,
/area/lv624/ground/barrens/north_east_barrens/ceiling)
"r" = (
/obj/effect/landmark/crap_item,
/turf/open/gm/dirt,
/area/lv624/ground/barrens/north_east_barrens)
"u" = (
/obj/structure/surface/rack,
/obj/item/weapon/gun/rifle/mar40{
	pixel_y = 6
	},
/obj/item/weapon/gun/rifle/mar40{
	pixel_y = -3
	},
/turf/open/floor/vault2/west,
/area/lv624/ground/barrens/north_east_barrens/ceiling)
"w" = (
/obj/structure/largecrate/supply,
/turf/open/floor/vault2/west,
/area/lv624/ground/barrens/north_east_barrens/ceiling)
"x" = (
/obj/structure/machinery/light{
	dir = 4
	},
/obj/structure/surface/rack,
/obj/item/stack/sheet/mineral/platinum,
/obj/item/stack/sheet/mineral/iron{
	amount = 5
	},
/turf/open/floor/dark,
/area/lv624/ground/barrens/north_east_barrens/ceiling)
"A" = (
/obj/structure/surface/rack,
/obj/item/stack/sheet/mineral/silver{
	amount = 20
	},
/obj/effect/landmark/crap_item,
/turf/open/floor/vault2/west,
/area/lv624/ground/barrens/north_east_barrens/ceiling)
"B" = (
/turf/open/floor/dark,
/area/lv624/ground/barrens/north_east_barrens/ceiling)
"E" = (
/obj/structure/surface/rack,
/obj/item/weapon/gun/rifle/lmg,
/turf/open/floor/vault2/west,
/area/lv624/ground/barrens/north_east_barrens/ceiling)
"F" = (
/obj/structure/machinery/light{
	dir = 4
	},
/obj/structure/largecrate/supply,
/turf/open/floor/dark,
/area/lv624/ground/barrens/north_east_barrens/ceiling)
"J" = (
/obj/structure/surface/rack,
/obj/item/stack/sheet/mineral/diamond{
	amount = 2
	},
/turf/open/floor/dark,
/area/lv624/ground/barrens/north_east_barrens/ceiling)
"K" = (
/obj/structure/surface/rack,
/obj/item/stack/sheet/mineral/platinum{
	pixel_x = -6
	},
/turf/open/floor/dark,
/area/lv624/ground/barrens/north_east_barrens/ceiling)
"L" = (
/obj/structure/surface/rack,
/obj/item/weapon/gun/rifle/mar40{
	pixel_y = -3
	},
/obj/item/weapon/gun/rifle/mar40{
	pixel_y = 6
	},
/obj/effect/landmark/crap_item,
/turf/open/floor/vault2/west,
/area/lv624/ground/barrens/north_east_barrens/ceiling)
"N" = (
/obj/effect/alien/weeds/node,
/turf/open/gm/dirt,
/area/lv624/ground/barrens/north_east_barrens)
"O" = (
/turf/open/gm/dirt,
/area/lv624/ground/barrens/north_east_barrens)
"P" = (
/obj/structure/surface/rack,
/obj/item/stack/sheet/mineral/sandstone{
	amount = 50
	},
/obj/item/stack/sheet/mineral/sandstone{
	amount = 50
	},
/turf/open/floor/dark,
/area/lv624/ground/barrens/north_east_barrens/ceiling)
"Q" = (
/obj/structure/surface/rack,
/obj/item/stack/sheet/mineral/iron{
	amount = 5
	},
/obj/item/tool/pickaxe/diamond,
/turf/open/floor/dark,
/area/lv624/ground/barrens/north_east_barrens/ceiling)
"T" = (
/obj/structure/surface/rack,
/obj/item/tool/pickaxe,
/turf/open/floor/dark,
/area/lv624/ground/barrens/north_east_barrens/ceiling)
"W" = (
/obj/structure/closet/crate,
/obj/item/ammo_magazine/rifle/mar40,
/obj/item/ammo_magazine/rifle/mar40,
/obj/item/ammo_magazine/rifle/mar40,
/obj/item/ammo_magazine/rifle/mar40,
/obj/item/ammo_magazine/rifle/mar40,
/obj/item/ammo_magazine/rifle/mar40/extended,
/obj/item/ammo_magazine/rifle/mar40/extended,
/turf/open/floor/dark,
/area/lv624/ground/barrens/north_east_barrens/ceiling)

(1,1,1) = {"
O
O
O
O
O
O
N
O
"}
(2,1,1) = {"
N
O
O
l
O
O
O
r
"}
(3,1,1) = {"
f
f
c
f
f
f
f
O
"}
(4,1,1) = {"
f
L
B
g
B
E
f
O
"}
(5,1,1) = {"
f
u
B
K
B
A
f
N
"}
(6,1,1) = {"
f
n
B
Q
B
w
f
O
"}
(7,1,1) = {"
f
W
B
h
B
T
f
O
"}
(8,1,1) = {"
f
k
b
J
B
P
f
O
"}
(9,1,1) = {"
f
x
B
B
B
F
f
O
"}
(10,1,1) = {"
f
f
f
f
f
f
f
r
"}
(11,1,1) = {"
O
N
r
O
O
N
O
O
"}
