//MAP CONVERTED BY dmm2tgm.py THIS HEADER COMMENT PREVENTS RECONVERSION, DO NOT REMOVE
"ab" = (
/turf/closed/wall/solaris/rock,
/area/bigredv2/caves)
"an" = (
/obj/effect/decal/cleanable/dirt,
/turf/open/mars,
/area/bigredv2/caves_north)
"at" = (
/obj/structure/blocker/forcefield/multitile_vehicles,
/turf/open/floor/plating,
/area/bigredv2/caves_north)
"au" = (
/obj/effect/decal/cleanable/dirt,
/obj/effect/decal/cleanable/blood,
/obj/structure/blocker/forcefield/multitile_vehicles,
/turf/open/mars,
/area/bigredv2/caves_north)
"aw" = (
/turf/closed/shuttle/ert{
	icon_state = "wy20"
	},
/area/bigredv2/caves_north)
"ax" = (
/turf/closed/shuttle/ert{
	icon_state = "wy27"
	},
/area/bigredv2/caves_north)
"ay" = (
/turf/closed/shuttle/ert{
	icon_state = "wy25"
	},
/area/bigredv2/caves_north)
"aA" = (
/obj/item/stack/sheet/metal,
/turf/open/floor/platingdmg1,
/area/bigredv2/outside/general_offices)
"aB" = (
/turf/closed/wall/solaris,
/area/bigredv2/outside/general_offices)
"aD" = (
/turf/closed/shuttle/ert{
	icon_state = "wy22"
	},
/area/bigredv2/outside/general_offices)
"aF" = (
/turf/closed/shuttle/ert{
	icon_state = "wy23"
	},
/area/bigredv2/outside/general_offices)
"aG" = (
/turf/closed/shuttle/ert{
	icon_state = "wy21"
	},
/area/bigredv2/outside/general_offices)
"aH" = (
/turf/closed/shuttle/ert{
	icon_state = "wy25"
	},
/area/bigredv2/outside/general_offices)
"aI" = (
/turf/closed/wall/solaris/reinforced,
/area/bigredv2/outside/general_offices)
"aK" = (
/turf/open/floor,
/area/bigredv2/outside/general_offices)
"aP" = (
/turf/closed/shuttle/ert{
	icon_state = "wy18"
	},
/area/bigredv2/outside/general_offices)
"aQ" = (
/obj/effect/decal/cleanable/dirt,
/obj/structure/blocker/forcefield/multitile_vehicles,
/turf/open/mars,
/area/bigredv2/caves_north)
"aV" = (
/turf/closed/shuttle/ert{
	icon_state = "wy19"
	},
/area/bigredv2/outside/general_offices)
"aZ" = (
/obj/structure/window_frame/solaris,
/obj/item/shard,
/turf/open/floor/plating,
/area/bigredv2/outside/general_offices)
"bf" = (
/turf/open/floor/plating,
/area/bigredv2/outside/general_offices)
"bp" = (
/obj/structure/surface/table,
/obj/structure/bedsheetbin,
/turf/open/floor/plating,
/area/bigredv2/outside/general_offices)
"br" = (
/turf/closed/shuttle/ert{
	icon_state = "wy16"
	},
/area/bigredv2/outside/general_offices)
"bw" = (
/turf/closed/shuttle/ert{
	icon_state = "wy17"
	},
/area/bigredv2/outside/general_offices)
"bA" = (
/obj/structure/surface/table,
/turf/open/floor,
/area/bigredv2/outside/general_offices)
"bE" = (
/turf/closed/shuttle/ert{
	icon_state = "wy14"
	},
/area/bigredv2/outside/general_offices)
"bG" = (
/turf/closed/shuttle/ert{
	icon_state = "wy15"
	},
/area/bigredv2/outside/general_offices)
"bM" = (
/turf/closed/shuttle/ert{
	icon_state = "wy12"
	},
/area/bigredv2/outside/general_offices)
"bN" = (
/turf/closed/shuttle/ert{
	icon_state = "wy13"
	},
/area/bigredv2/outside/general_offices)
"bV" = (
/obj/structure/surface/rack,
/obj/effect/spawner/random/tool,
/obj/effect/spawner/random/tool,
/obj/effect/spawner/random/tool,
/turf/open/floor,
/area/bigredv2/outside/general_offices)
"ca" = (
/turf/closed/shuttle/ert{
	icon_state = "wy4"
	},
/area/bigredv2/outside/general_offices)
"cf" = (
/turf/closed/shuttle/ert{
	icon_state = "wy5"
	},
/area/bigredv2/outside/general_offices)
"cl" = (
/obj/structure/surface/rack,
/obj/effect/spawner/random/tool,
/obj/effect/spawner/random/tool,
/turf/open/floor,
/area/bigredv2/outside/general_offices)
"cn" = (
/turf/closed/shuttle/ert{
	icon_state = "wy_leftengine"
	},
/area/bigredv2/outside/general_offices)
"co" = (
/turf/closed/shuttle/ert{
	icon_state = "wy8"
	},
/area/bigredv2/outside/general_offices)
"cp" = (
/turf/closed/shuttle/ert{
	icon_state = "wy9"
	},
/area/bigredv2/outside/general_offices)
"cq" = (
/turf/closed/shuttle/ert{
	icon_state = "wy_rightengine"
	},
/area/bigredv2/outside/general_offices)
"cs" = (
/turf/closed/shuttle/ert{
	icon_state = "leftengine_3";
	opacity = 0
	},
/area/bigredv2/outside/general_offices)
"cv" = (
/turf/closed/shuttle/ert{
	icon_state = "rightengine_3";
	opacity = 0
	},
/area/bigredv2/outside/general_offices)
"cA" = (
/obj/structure/machinery/door/airlock/multi_tile/almayer/generic{
	name = "\improper Dormitories Tool Storage"
	},
/turf/open/floor,
/area/bigredv2/outside/general_offices)
"cC" = (
/turf/closed/shuttle/ert{
	icon_state = "leftengine_2";
	opacity = 0
	},
/area/bigredv2/outside/general_offices)
"cD" = (
/turf/closed/shuttle/ert{
	icon_state = "rightengine_2";
	opacity = 0
	},
/area/bigredv2/outside/general_offices)
"cE" = (
/obj/structure/machinery/light{
	dir = 1
	},
/turf/open/floor,
/area/bigredv2/outside/general_offices)
"cF" = (
/obj/effect/decal/cleanable/dirt,
/turf/open/floor/plating,
/area/bigredv2/outside/general_offices)
"cG" = (
/turf/closed/shuttle/ert{
	icon_state = "leftengine_1";
	opacity = 0
	},
/area/bigredv2/outside/general_offices)
"cH" = (
/turf/closed/shuttle/ert{
	icon_state = "wy1"
	},
/area/bigredv2/outside/general_offices)
"cI" = (
/obj/effect/decal/cleanable/dirt,
/obj/effect/spawner/gibspawner/human,
/turf/open/mars,
/area/bigredv2/caves_north)
"cJ" = (
/turf/closed/shuttle/ert{
	icon_state = "wy2"
	},
/area/bigredv2/outside/general_offices)
"cK" = (
/turf/closed/shuttle/ert{
	icon_state = "wy3"
	},
/area/bigredv2/outside/general_offices)
"cL" = (
/turf/closed/shuttle/ert{
	icon_state = "rightengine_1";
	opacity = 0
	},
/area/bigredv2/outside/general_offices)
"cV" = (
/obj/item/stack/sheet/metal,
/turf/open/floor/plating,
/area/bigredv2/caves_north)
"di" = (
/obj/structure/bed/chair{
	dir = 8
	},
/turf/open/floor,
/area/bigredv2/outside/general_offices)
"dx" = (
/turf/closed/wall/solaris,
/area/bigredv2/outside/bar)
"eF" = (
/turf/template_noop,
/area/template_noop)
"fk" = (
/turf/open/floor/plating/wood,
/area/bigredv2/outside/general_offices)
"fp" = (
/obj/item/paper/crumpled/bloody,
/obj/effect/decal/cleanable/blood{
	icon_state = "u_psycopath_l"
	},
/turf/open/shuttle/dropship/can_surgery/light_grey_single_wide_up_to_down,
/area/bigredv2/outside/general_offices)
"fr" = (
/obj/effect/spawner/gibspawner/human,
/turf/open/floor/plating/platingdmg3,
/area/bigredv2/outside/hydroponics)
"fu" = (
/obj/structure/machinery/washing_machine,
/obj/item/clothing/under/darkred,
/turf/open/floor/freezerfloor,
/area/bigredv2/outside/general_offices)
"fH" = (
/obj/structure/surface/rack,
/obj/item/stack/sheet/mineral/diamond,
/obj/item/stack/sheet/plasteel{
	amount = 30;
	pixel_x = 4;
	pixel_y = 4
	},
/turf/open/floor/dark,
/area/bigredv2/outside/general_offices)
"fK" = (
/obj/effect/decal/cleanable/blood,
/turf/open/shuttle/dropship/can_surgery/medium_grey_single_wide_up_to_down,
/area/bigredv2/outside/general_offices)
"fQ" = (
/obj/structure/surface/rack,
/obj/item/map/big_red_map,
/turf/open/shuttle/dropship/can_surgery/medium_grey_single_wide_up_to_down,
/area/bigredv2/outside/general_offices)
"gf" = (
/obj/structure/pipes/standard/simple/hidden/green,
/turf/open/floor/plating/platingdmg3,
/area/bigredv2/outside/hydroponics)
"gk" = (
/obj/item/clothing/under/darkred,
/turf/open/floor/freezerfloor,
/area/bigredv2/outside/general_offices)
"hH" = (
/obj/structure/machinery/light{
	dir = 1
	},
/turf/open/floor/platingdmg1,
/area/bigredv2/outside/general_offices)
"iH" = (
/obj/item/stack/rods,
/turf/open/floor/plating/platingdmg3,
/area/bigredv2/outside/general_offices)
"iN" = (
/obj/structure/machinery/washing_machine,
/obj/item/clothing/under/brown,
/turf/open/floor/freezerfloor,
/area/bigredv2/outside/general_offices)
"iW" = (
/obj/effect/decal/cleanable/dirt,
/obj/structure/pipes/standard/simple/hidden/green{
	dir = 9
	},
/turf/open/floor/plating/platingdmg3,
/area/bigredv2/outside/hydroponics)
"jj" = (
/obj/structure/surface/rack,
/obj/item/stack/sheet/mineral/phoron{
	amount = 25
	},
/turf/open/floor/dark,
/area/bigredv2/outside/general_offices)
"jr" = (
/obj/structure/machinery/door/airlock/almayer/medical/glass/colony{
	name = "\improper Dormitories Lavatory"
	},
/turf/open/floor/freezerfloor,
/area/bigredv2/outside/general_offices)
"kh" = (
/turf/open/shuttle/dropship/can_surgery/light_grey_top_right,
/area/bigredv2/outside/general_offices)
"ld" = (
/obj/effect/decal/cleanable/dirt,
/obj/effect/decal/cleanable/blood{
	dir = 1;
	icon_state = "gib6"
	},
/turf/open/floor/platingdmg1,
/area/bigredv2/outside/general_offices)
"lS" = (
/obj/structure/girder,
/turf/open/floor/wall_thermite,
/area/bigredv2/outside/general_offices)
"mq" = (
/turf/open/floor/plating/platingdmg3,
/area/bigredv2/outside/hydroponics)
"mw" = (
/obj/item/stack/sheet/plasteel,
/turf/open/floor/dark,
/area/bigredv2/outside/general_offices)
"mC" = (
/obj/structure/machinery/cm_vending/sorted/tech/comp_storage,
/turf/open/floor/platingdmg1,
/area/bigredv2/outside/general_offices)
"mS" = (
/obj/effect/landmark/crap_item,
/turf/open/floor/platingdmg1,
/area/bigredv2/outside/general_offices)
"na" = (
/obj/item/stack/rods,
/turf/open/floor/platingdmg1,
/area/bigredv2/outside/general_offices)
"nC" = (
/turf/open/floor/plating/panelscorched,
/area/bigredv2/outside/ne)
"nU" = (
/obj/structure/machinery/light{
	dir = 8
	},
/turf/open/floor/plating/wood_broken2,
/area/bigredv2/outside/general_offices)
"nW" = (
/obj/structure/computerframe,
/turf/open/shuttle/dropship/can_surgery/medium_grey_single_wide_up_to_down,
/area/bigredv2/outside/general_offices)
"od" = (
/obj/effect/decal/cleanable/dirt,
/obj/effect/spawner/gibspawner/human,
/turf/open/floor/platingdmg1,
/area/bigredv2/outside/general_offices)
"oV" = (
/obj/structure/blocker/forcefield/multitile_vehicles,
/turf/open/mars_cave/mars_dirt_6,
/area/bigredv2/caves_north)
"pL" = (
/turf/open/shuttle/dropship/can_surgery/light_grey_single_wide_left_to_right,
/area/bigredv2/outside/general_offices)
"qc" = (
/turf/open/shuttle/dropship/can_surgery/medium_grey_single_wide_up_to_down,
/area/bigredv2/outside/general_offices)
"qL" = (
/obj/structure/pipes/standard/simple/hidden/green{
	dir = 6
	},
/turf/open/floor/plating/platingdmg3,
/area/bigredv2/outside/hydroponics)
"qW" = (
/obj/structure/bed/chair/dropship/passenger,
/obj/effect/landmark/corpsespawner/wygoon,
/turf/open/shuttle/dropship/can_surgery/medium_grey_single_wide_up_to_down,
/area/bigredv2/outside/general_offices)
"rh" = (
/obj/effect/decal/cleanable/dirt,
/obj/effect/decal/cleanable/blood/oil,
/turf/open/floor/platingdmg1,
/area/bigredv2/outside/general_offices)
"rY" = (
/obj/effect/decal/cleanable/dirt,
/turf/open/floor/plating/platingdmg3,
/area/bigredv2/outside/hydroponics)
"sD" = (
/obj/effect/decal/cleanable/dirt,
/obj/structure/surface/rack,
/obj/item/stack/sheet/mineral/uranium{
	amount = 50
	},
/turf/open/floor/dark,
/area/bigredv2/outside/general_offices)
"ts" = (
/obj/effect/decal/cleanable/blood{
	dir = 1;
	icon_state = "gib6"
	},
/turf/open/floor/plating/panelscorched,
/area/bigredv2/outside/general_offices)
"ui" = (
/obj/structure/machinery/door/airlock/almayer/generic,
/turf/open/shuttle/dropship/can_surgery,
/area/bigredv2/outside/general_offices)
"ut" = (
/turf/open/floor/wall_thermite,
/area/bigredv2/outside/hydroponics)
"wc" = (
/obj/structure/machinery/light,
/turf/open/floor/platingdmg1,
/area/bigredv2/outside/general_offices)
"wv" = (
/obj/structure/machinery/light{
	dir = 8
	},
/turf/open/floor/plating/wood,
/area/bigredv2/outside/general_offices)
"wI" = (
/obj/item/stack/rods,
/turf/open/floor/plating/platingdmg3,
/area/bigredv2/outside/hydroponics)
"xo" = (
/obj/item/stack/sheet/wood,
/turf/open/floor/platingdmg1,
/area/bigredv2/outside/general_offices)
"xM" = (
/obj/structure/surface/table,
/turf/open/floor/platingdmg1,
/area/bigredv2/outside/general_offices)
"yK" = (
/obj/structure/machinery/cm_vending/sorted/tech/tool_storage,
/turf/open/floor/platingdmg1,
/area/bigredv2/outside/general_offices)
"Ad" = (
/obj/structure/machinery/door/airlock/almayer/generic{
	dir = 1;
	name = "\improper Dormitories Bedroom"
	},
/turf/open/floor/wood,
/area/bigredv2/outside/general_offices)
"Aw" = (
/obj/effect/decal/cleanable/blood{
	dir = 1;
	icon_state = "gib6"
	},
/turf/open/floor/platingdmg1,
/area/bigredv2/outside/general_offices)
"BS" = (
/obj/structure/machinery/suit_storage_unit/carbon_unit,
/turf/open/floor/platingdmg1,
/area/bigredv2/outside/general_offices)
"BX" = (
/obj/structure/surface/table,
/turf/open/floor/plating/wood,
/area/bigredv2/outside/general_offices)
"Ca" = (
/obj/effect/spawner/gibspawner/human,
/turf/open/floor/platingdmg1,
/area/bigredv2/outside/general_offices)
"Cp" = (
/obj/structure/barricade/wooden{
	desc = "This barricade is heavily reinforced. Nothing short of blasting it open seems like it'll do the trick, that or melting the breams supporting it...";
	dir = 8;
	health = 25000
	},
/turf/open/floor,
/area/bigredv2/outside/general_offices)
"Cy" = (
/obj/item/stack/rods,
/turf/open/floor/plating/panelscorched,
/area/bigredv2/outside/general_offices)
"CE" = (
/turf/open/floor/platingdmg1,
/area/bigredv2/outside/hydroponics)
"Dp" = (
/obj/structure/machinery/door/airlock/almayer/engineering/colony{
	name = "\improper Dormitories EVA"
	},
/turf/open/floor/dark,
/area/bigredv2/outside/general_offices)
"Du" = (
/turf/open/floor/plating/platingdmg3,
/area/bigredv2/outside/ne)
"DD" = (
/obj/structure/machinery/washing_machine,
/obj/item/clothing/under/lightbrown,
/turf/open/floor/freezerfloor,
/area/bigredv2/outside/general_offices)
"DG" = (
/obj/effect/decal/cleanable/blood{
	dir = 1;
	icon_state = "gib6"
	},
/turf/open/floor/plating/platingdmg3,
/area/bigredv2/outside/hydroponics)
"DU" = (
/turf/open/floor/plating/wood_broken5,
/area/bigredv2/outside/general_offices)
"Eg" = (
/obj/structure/surface/rack,
/obj/item/stack/sheet/mineral/uranium{
	amount = 50
	},
/turf/open/floor/dark,
/area/bigredv2/outside/general_offices)
"Eq" = (
/obj/structure/machinery/camera/autoname,
/obj/item/stack/sheet/plasteel,
/turf/open/floor/dark,
/area/bigredv2/outside/general_offices)
"Et" = (
/obj/structure/bed/chair/dropship/passenger{
	dir = 8
	},
/obj/effect/decal/cleanable/blood{
	dir = 1;
	icon_state = "gib6"
	},
/turf/open/shuttle/dropship/can_surgery/medium_grey_single_wide_up_to_down,
/area/bigredv2/outside/general_offices)
"EA" = (
/turf/open/floor/plating/panelscorched,
/area/bigredv2/outside/general_offices)
"EJ" = (
/obj/structure/surface/rack,
/obj/item/stack/sheet/mineral/gold,
/turf/open/floor/dark,
/area/bigredv2/outside/general_offices)
"EO" = (
/turf/closed/shuttle/ert{
	icon_state = "wy20"
	},
/area/bigredv2/outside/general_offices)
"EP" = (
/obj/effect/decal/cleanable/blood/oil/streak,
/turf/open/floor/wall_thermite,
/area/bigredv2/outside/general_offices)
"ES" = (
/obj/structure/blocker/forcefield/multitile_vehicles,
/turf/open/mars_cave/mars_dirt_4,
/area/bigredv2/caves_north)
"FK" = (
/obj/structure/machinery/door/airlock/almayer/generic{
	dir = 2
	},
/turf/open/shuttle/dropship/can_surgery,
/area/bigredv2/outside/general_offices)
"FW" = (
/obj/effect/decal/cleanable/dirt,
/obj/structure/machinery/light{
	dir = 1
	},
/turf/open/floor,
/area/bigredv2/outside/general_offices)
"Gb" = (
/obj/structure/machinery/light{
	dir = 8
	},
/turf/open/floor/plating/wood_broken3,
/area/bigredv2/outside/general_offices)
"Gh" = (
/obj/structure/bed,
/turf/open/floor/plating/wood,
/area/bigredv2/outside/general_offices)
"GR" = (
/obj/effect/decal/cleanable/dirt,
/turf/open/floor/plating/panelscorched,
/area/bigredv2/outside/ne)
"Hw" = (
/turf/open/floor/plating/wood_broken4,
/area/bigredv2/outside/general_offices)
"HE" = (
/obj/structure/window/framed/solaris,
/obj/structure/machinery/door/poddoor/shutters/almayer{
	dir = 4;
	id = "Dormitories";
	name = "\improper Dormitories Shutters"
	},
/turf/open/floor/plating,
/area/bigredv2/outside/general_offices)
"HP" = (
/obj/structure/closet/l3closet,
/turf/open/floor/platingdmg1,
/area/bigredv2/outside/general_offices)
"HR" = (
/obj/structure/girder,
/turf/open/floor/platingdmg1,
/area/bigredv2/outside/general_offices)
"HT" = (
/obj/effect/decal/cleanable/blood,
/obj/effect/landmark/corpsespawner/wygoon,
/turf/open/shuttle/dropship/can_surgery/light_grey_single_wide_up_to_down,
/area/bigredv2/outside/general_offices)
"JK" = (
/obj/structure/surface/table,
/turf/open/floor/wood,
/area/bigredv2/outside/general_offices)
"JO" = (
/turf/open/floor/plating/wood_broken6,
/area/bigredv2/outside/general_offices)
"JS" = (
/obj/structure/machinery/washing_machine,
/turf/open/floor/platingdmg1,
/area/bigredv2/outside/general_offices)
"JW" = (
/obj/structure/pipes/standard/simple/hidden/green,
/turf/open/floor/platingdmg1,
/area/bigredv2/outside/hydroponics)
"KH" = (
/obj/structure/surface/rack,
/obj/item/stack/sheet/mineral/plastic,
/obj/item/stack/sheet/mineral/plastic,
/obj/item/stack/sheet/mineral/plastic,
/turf/open/floor/dark,
/area/bigredv2/outside/general_offices)
"KI" = (
/obj/item/stack/sheet/metal,
/turf/open/floor/plating/platingdmg3,
/area/bigredv2/outside/ne)
"Lx" = (
/obj/structure/pipes/standard/simple/hidden/green{
	dir = 4
	},
/turf/open/floor/plating/panelscorched,
/area/bigredv2/outside/ne)
"LQ" = (
/obj/effect/landmark/corpsespawner/wygoon,
/turf/open/shuttle/dropship/can_surgery/medium_grey_single_wide_up_to_down,
/area/bigredv2/outside/general_offices)
"Mp" = (
/obj/effect/decal/cleanable/dirt,
/turf/open/floor/dark,
/area/bigredv2/outside/general_offices)
"MY" = (
/turf/open/shuttle/dropship/can_surgery/light_grey_top_left,
/area/bigredv2/outside/general_offices)
"Nd" = (
/turf/open/floor/dark,
/area/bigredv2/outside/general_offices)
"Nk" = (
/turf/open/floor/plating/platingdmg3,
/area/bigredv2/outside/general_offices)
"NR" = (
/obj/item/stack/sheet/metal,
/turf/open/floor/plating/platingdmg3,
/area/bigredv2/outside/hydroponics)
"Oa" = (
/turf/open/shuttle/dropship/can_surgery/light_grey_bottom_left,
/area/bigredv2/outside/general_offices)
"Of" = (
/obj/structure/machinery/cm_vending/sorted/tech/electronics_storage,
/turf/open/floor/platingdmg1,
/area/bigredv2/outside/general_offices)
"Oo" = (
/obj/structure/machinery/light{
	dir = 4
	},
/obj/structure/surface/rack,
/obj/item/stack/sheet/mineral/silver,
/obj/item/stack/sheet/mineral/silver{
	amount = 20
	},
/obj/item/stack/sheet/mineral/phoron{
	amount = 25
	},
/turf/open/floor/dark,
/area/bigredv2/outside/general_offices)
"Pq" = (
/obj/structure/barricade/wooden{
	desc = "This barricade is heavily reinforced. Nothing short of blasting it open seems like it'll do the trick, that or melting the breams supporting it...";
	dir = 8;
	health = 25000
	},
/turf/open/floor/plating/platingdmg3,
/area/bigredv2/outside/general_offices)
"PN" = (
/turf/open/floor/wall_thermite,
/area/bigredv2/outside/general_offices)
"PX" = (
/turf/open/floor/platingdmg1,
/area/bigredv2/outside/general_offices)
"PZ" = (
/obj/effect/decal/cleanable/dirt,
/turf/open/floor/platingdmg1,
/area/bigredv2/outside/general_offices)
"Qz" = (
/obj/effect/decal/cleanable/blood,
/obj/effect/decal/remains,
/turf/open/shuttle/dropship/can_surgery/medium_grey_single_wide_up_to_down,
/area/bigredv2/outside/general_offices)
"Rg" = (
/turf/open/floor/freezerfloor,
/area/bigredv2/outside/general_offices)
"Rk" = (
/obj/item/stack/rods,
/turf/open/floor/plating/platingdmg3/west,
/area/bigredv2/outside/general_offices)
"RM" = (
/obj/structure/surface/rack,
/obj/item/stack/sheet/mineral/diamond,
/turf/open/floor/dark,
/area/bigredv2/outside/general_offices)
"Sv" = (
/obj/structure/surface/rack,
/obj/item/xeno_restraints,
/turf/open/shuttle/dropship/can_surgery/medium_grey_single_wide_up_to_down,
/area/bigredv2/outside/general_offices)
"Sy" = (
/obj/structure/bed,
/turf/open/floor/wood,
/area/bigredv2/outside/general_offices)
"Td" = (
/turf/open/shuttle/dropship/can_surgery/light_grey_bottom_right,
/area/bigredv2/outside/general_offices)
"Tp" = (
/obj/effect/decal/cleanable/blood{
	dir = 1;
	icon_state = "gib6"
	},
/turf/open/floor/plating/platingdmg3/west,
/area/bigredv2/outside/ne)
"Tx" = (
/obj/structure/pipes/standard/simple/hidden/green{
	dir = 4
	},
/obj/effect/decal/cleanable/dirt,
/turf/open/floor/platingdmg1,
/area/bigredv2/outside/ne)
"TM" = (
/obj/structure/dispenser/oxygen,
/turf/open/floor/platingdmg1,
/area/bigredv2/outside/general_offices)
"TX" = (
/obj/effect/spawner/gibspawner/human,
/obj/effect/decal/cleanable/blood,
/turf/open/shuttle/dropship/can_surgery/light_grey_single_wide_left_to_right,
/area/bigredv2/outside/general_offices)
"Uo" = (
/obj/effect/decal/cleanable/blood{
	dir = 1;
	icon_state = "gib6"
	},
/turf/open/shuttle/dropship/can_surgery/light_grey_single_wide_up_to_down,
/area/bigredv2/outside/general_offices)
"Ux" = (
/obj/structure/surface/rack,
/turf/open/shuttle/dropship/can_surgery/medium_grey_single_wide_up_to_down,
/area/bigredv2/outside/general_offices)
"UH" = (
/obj/item/stack/sheet/wood,
/turf/open/floor/plating/panelscorched,
/area/bigredv2/outside/general_offices)
"UU" = (
/obj/effect/decal/cleanable/blood{
	dir = 1;
	icon_state = "gib6"
	},
/turf/open/floor/wall_thermite,
/area/bigredv2/outside/general_offices)
"Vq" = (
/obj/structure/blocker/forcefield/multitile_vehicles,
/turf/open/mars/mars_dirt_11,
/area/bigredv2/caves_north)
"Vr" = (
/turf/open/floor/plating/wood_broken3,
/area/bigredv2/outside/general_offices)
"Xc" = (
/obj/structure/bed/chair/dropship/passenger,
/turf/open/shuttle/dropship/can_surgery/medium_grey_single_wide_up_to_down,
/area/bigredv2/outside/general_offices)
"Xv" = (
/obj/structure/bed/chair/dropship/passenger{
	dir = 4
	},
/turf/open/shuttle/dropship/can_surgery/medium_grey_single_wide_up_to_down,
/area/bigredv2/outside/general_offices)
"XI" = (
/obj/effect/decal/cleanable/dirt,
/obj/effect/decal/cleanable/dirt,
/obj/item/stack/rods,
/turf/open/floor/platingdmg1,
/area/bigredv2/outside/general_offices)
"XX" = (
/turf/open/floor/plating/platingdmg3/west,
/area/bigredv2/outside/general_offices)
"Yy" = (
/obj/effect/decal/cleanable/blood{
	dir = 1;
	icon_state = "gib6"
	},
/turf/open/floor/plating/platingdmg3,
/area/bigredv2/outside/ne)
"YC" = (
/obj/structure/machinery/washing_machine,
/turf/open/floor/freezerfloor,
/area/bigredv2/outside/general_offices)
"YP" = (
/obj/structure/surface/rack,
/obj/item/device/mass_spectrometer/adv,
/turf/open/floor/dark,
/area/bigredv2/outside/general_offices)
"YX" = (
/obj/structure/blocker/forcefield/multitile_vehicles,
/turf/open/mars_cave/mars_dirt_5,
/area/bigredv2/caves_north)
"ZH" = (
/turf/open/shuttle/dropship/can_surgery/light_grey_single_wide_up_to_down,
/area/bigredv2/outside/general_offices)
"ZI" = (
/obj/structure/pipes/standard/simple/hidden/green{
	dir = 10
	},
/turf/open/floor/platingdmg1,
/area/bigredv2/outside/ne)
"ZY" = (
/obj/structure/machinery/light,
/turf/open/floor/plating/platingdmg3,
/area/bigredv2/outside/general_offices)

(1,1,1) = {"
eF
eF
eF
eF
eF
eF
eF
eF
eF
eF
eF
eF
eF
eF
eF
eF
eF
eF
eF
eF
eF
eF
eF
eF
eF
eF
eF
eF
eF
"}
(2,1,1) = {"
eF
eF
eF
eF
eF
eF
eF
eF
eF
eF
eF
eF
eF
eF
eF
eF
eF
eF
eF
eF
eF
eF
eF
eF
eF
eF
eF
eF
eF
"}
(3,1,1) = {"
eF
eF
eF
eF
eF
eF
eF
eF
eF
eF
eF
eF
eF
eF
eF
eF
eF
eF
eF
eF
eF
eF
eF
eF
eF
eF
eF
eF
eF
"}
(4,1,1) = {"
eF
eF
eF
eF
eF
eF
eF
eF
eF
eF
eF
eF
eF
eF
eF
eF
eF
eF
eF
eF
eF
eF
eF
eF
eF
eF
eF
eF
eF
"}
(5,1,1) = {"
eF
eF
eF
eF
eF
eF
eF
aB
aB
aB
jr
aB
aB
aB
aB
aB
aB
aB
cE
aK
aK
di
bA
dx
eF
eF
eF
eF
eF
"}
(6,1,1) = {"
eF
eF
eF
eF
eF
eF
eF
aB
fu
Rg
Rg
Rg
DD
aB
bV
cl
cl
aB
aK
aK
aK
aB
aB
dx
dx
eF
eF
eF
eF
"}
(7,1,1) = {"
eF
eF
eF
eF
eF
eF
eF
aB
YC
Rg
Rg
Rg
YC
aB
hH
PZ
PX
aB
cF
aK
aK
Ad
fk
wv
aB
eF
eF
eF
eF
"}
(8,1,1) = {"
eF
eF
eF
eF
eF
eF
eF
aB
YC
Rg
Rg
Rg
iN
aB
Of
PZ
PX
aB
PZ
bf
bf
aB
BX
Gh
aB
eF
eF
eF
eF
"}
(9,1,1) = {"
eF
eF
eF
eF
eF
eF
eF
aB
YC
gk
Rg
Rg
bf
HR
mC
PZ
PX
lS
PZ
PX
ZY
aB
aB
aB
aB
eF
eF
eF
eF
"}
(10,1,1) = {"
eF
eF
eF
eF
eF
eF
eF
aB
JS
bf
bp
PX
PX
lS
yK
PX
PX
cA
PX
PX
Nk
Ad
DU
nU
aB
eF
eF
eF
eF
"}
(11,1,1) = {"
eF
eF
eF
eF
eF
eF
eF
aB
PX
EA
bf
Nk
PX
PN
PX
PZ
PZ
aK
PZ
PX
Nk
aB
JK
Sy
aB
eF
eF
eF
eF
"}
(12,1,1) = {"
eF
eF
eF
eF
eF
eF
eF
aB
PX
PX
Nk
EA
PX
PX
PX
PZ
PX
PN
EA
na
PX
aB
aB
aB
aB
eF
eF
eF
eF
"}
(13,1,1) = {"
eF
eF
eF
eF
eF
ab
ab
aB
aB
aB
aB
PN
na
PN
na
PX
rh
EP
PZ
EA
PZ
Ad
JO
Gb
lS
Tx
KI
eF
eF
"}
(14,1,1) = {"
eF
eF
eF
eF
eF
aQ
cV
EO
aP
ui
br
bE
bM
ui
ca
cn
cs
cC
cG
PX
XX
PN
Vr
Hw
aA
Tx
ut
CE
CE
"}
(15,1,1) = {"
eF
eF
eF
eF
eF
aQ
cI
aG
Ux
qc
Xv
Xv
Xv
fK
Sv
co
ca
ca
cH
Aw
ts
ts
od
Rk
PN
Lx
mq
mq
qL
"}
(16,1,1) = {"
eF
eF
eF
eF
eF
at
aw
aD
MY
fp
HT
Uo
Uo
Uo
Oa
qc
qc
qc
FK
XX
xo
PX
Nk
Nk
Nk
ZI
JW
gf
iW
"}
(17,1,1) = {"
eF
eF
eF
eF
eF
aQ
ax
nW
TX
Xc
Xc
Xc
qW
Xc
pL
ZH
ZH
ZH
cJ
EA
PX
PX
nC
nC
GR
Du
mq
NR
rY
"}
(18,1,1) = {"
eF
eF
eF
eF
eF
au
ay
aF
kh
ZH
ZH
ZH
ZH
ZH
Td
qc
Qz
qc
FK
ts
ld
UU
Yy
Tp
Yy
eF
DG
fr
mq
"}
(19,1,1) = {"
eF
eF
eF
eF
eF
aQ
an
aG
fQ
LQ
Et
Et
Et
qc
Ux
cp
cf
cf
cK
PZ
PZ
UH
eF
eF
eF
eF
wI
mq
rY
"}
(20,1,1) = {"
eF
eF
eF
eF
eF
Vq
an
aH
aV
ui
bw
bG
bN
ui
cf
cq
cv
cD
cL
EA
PX
XI
eF
eF
eF
eF
CE
mq
eF
"}
(21,1,1) = {"
eF
eF
eF
eF
eF
ES
an
Cy
EA
PZ
PZ
EA
PX
PN
PX
PX
PX
PN
PZ
mS
EA
EA
eF
eF
eF
eF
eF
eF
eF
"}
(22,1,1) = {"
eF
eF
eF
eF
eF
YX
ab
aB
Nk
PZ
iH
PX
mS
na
Ca
PX
PX
aA
PZ
EA
PX
lS
eF
eF
eF
eF
eF
eF
eF
"}
(23,1,1) = {"
eF
eF
eF
eF
eF
oV
ab
aB
BS
PX
PX
TM
xM
lS
HP
HP
HP
lS
Pq
Pq
wc
aB
eF
eF
eF
eF
eF
eF
eF
"}
(24,1,1) = {"
eF
eF
eF
eF
eF
oV
ab
aI
aZ
Dp
aZ
aZ
aI
aI
aI
aI
aI
aI
FW
aK
Cp
aB
eF
eF
eF
eF
eF
eF
eF
"}
(25,1,1) = {"
eF
eF
eF
eF
eF
ab
ab
aI
KH
Nd
jj
Mp
sD
Mp
fH
Nd
EJ
aI
HE
HE
HE
aB
eF
eF
eF
eF
eF
eF
eF
"}
(26,1,1) = {"
eF
eF
eF
eF
eF
eF
eF
aI
Nd
Nd
Nd
Mp
Mp
Mp
Nd
Mp
Nd
aI
eF
eF
eF
eF
eF
eF
eF
eF
eF
eF
eF
"}
(27,1,1) = {"
eF
eF
eF
eF
eF
eF
eF
aI
Nd
Nd
Nd
Nd
mw
Nd
Nd
Nd
Eq
aI
eF
eF
eF
eF
eF
eF
eF
eF
eF
eF
eF
"}
(28,1,1) = {"
eF
eF
eF
eF
eF
eF
eF
aI
YP
Nd
Eg
Nd
Oo
Nd
RM
Nd
RM
aI
eF
eF
eF
eF
eF
eF
eF
eF
eF
eF
eF
"}
(29,1,1) = {"
eF
eF
eF
eF
eF
eF
eF
aI
aI
aI
aI
aI
aI
aI
aI
aI
aI
aI
eF
eF
eF
eF
eF
eF
eF
eF
eF
eF
eF
"}
