//MAP CONVERTED BY dmm2tgm.py THIS HEADER COMMENT PREVENTS RECONVERSION, DO NOT REMOVE
"ap" = (
/obj/effect/decal/cleanable/dirt,
/obj/structure/surface/rack,
/obj/item/storage/pouch/machete/full{
	pixel_y = 2;
	pixel_x = 5
	},
/obj/item/storage/pouch/machete/full{
	pixel_y = 2;
	pixel_x = 5
	},
/obj/item/storage/pouch/flare/full{
	pixel_x = -6
	},
/obj/effect/decal/grass_overlay/jungle{
	dir = 5
	},
/turf/open/floor/sandstone,
/area/whiskey_outpost/blackstone/outside/jungle/sandstone_shrine)
"bq" = (
/obj/effect/decal/cleanable/dirt,
/obj/structure/surface/rack,
/obj/item/stack/medical/splint{
	name = "splints";
	pixel_x = -2
	},
/turf/open/floor/sandstone,
/area/whiskey_outpost/blackstone/outside/jungle/sandstone_shrine)
"cz" = (
/obj/effect/decal/cleanable/dirt,
/obj/item/shard/shrapnel/bone_chips/xeno{
	pixel_x = 11
	},
/turf/open/floor/sandstone/runed,
/area/whiskey_outpost/blackstone/outside/jungle/sandstone_shrine)
"cL" = (
/obj/structure/prop/brazier,
/obj/effect/decal/cleanable/dirt,
/turf/open/floor/sandstone/runed,
/area/whiskey_outpost/blackstone/outside/jungle/sandstone_shrine)
"db" = (
/obj/structure/barricade/handrail/sandstone/b{
	dir = 1
	},
/turf/open/jungle{
	bushes_spawn = 0;
	icon_state = "grass_impenetrable"
	},
/area/whiskey_outpost/blackstone/outside/jungle/sandstone_shrine)
"eg" = (
/obj/structure/flora/jungle/vines/light_3,
/turf/closed/wall/mineral/sandstone,
/area/whiskey_outpost/blackstone/outside/jungle/sandstone_shrine)
"eD" = (
/obj/structure/flora/jungle/vines/light_3,
/obj/structure/prop/brazier/frame/full/torch{
	pixel_y = 32
	},
/obj/effect/decal/cleanable/dirt,
/turf/open/floor/sandstone,
/area/whiskey_outpost/blackstone/outside/jungle/sandstone_shrine)
"ga" = (
/obj/effect/decal/cleanable/blood/drip{
	pixel_x = -7;
	pixel_y = 7;
	icon_state = "3"
	},
/obj/effect/decal/grass_overlay/jungle/inner{
	dir = 9
	},
/turf/open/floor/sandstone,
/area/whiskey_outpost/blackstone/outside/jungle/sandstone_shrine)
"ii" = (
/obj/structure/platform/mineral/sandstone/runed{
	dir = 1
	},
/turf/open/jungle{
	bushes_spawn = 0;
	icon_state = "grass_impenetrable"
	},
/area/whiskey_outpost/blackstone/outside/jungle/sandstone_shrine)
"lM" = (
/obj/structure/surface/table/reinforced/prison{
	color = "#6b675e"
	},
/obj/item/coin/gold{
	pixel_y = 9;
	pixel_x = -5
	},
/obj/item/coin/silver{
	pixel_x = -8;
	pixel_y = 8
	},
/obj/item/ore/diamond,
/obj/item/weapon/chainofcommand{
	pixel_x = 3;
	pixel_y = 3
	},
/turf/open/floor/sandstone/runed,
/area/whiskey_outpost/blackstone/outside/jungle/sandstone_shrine)
"mJ" = (
/obj/structure/prop/brazier,
/turf/open/floor/sandstone/runed,
/area/whiskey_outpost/blackstone/outside/jungle/sandstone_shrine)
"qY" = (
/turf/open/jungle/vines,
/area/whiskey_outpost/blackstone/outside/jungle/sandstone_shrine)
"rr" = (
/obj/item/tool/hatchet{
	pixel_y = 8
	},
/turf/open/floor/sandstone,
/area/whiskey_outpost/blackstone/outside/jungle/sandstone_shrine)
"sf" = (
/obj/structure/barricade/handrail/sandstone/b{
	dir = 4
	},
/obj/structure/platform/mineral/sandstone/runed{
	dir = 8
	},
/turf/open/jungle{
	bushes_spawn = 0;
	icon_state = "grass_impenetrable"
	},
/area/whiskey_outpost/blackstone/outside/jungle/sandstone_shrine)
"sy" = (
/obj/effect/decal/grass_overlay/jungle{
	dir = 9
	},
/turf/open/floor/sandstone,
/area/whiskey_outpost/blackstone/outside/jungle/sandstone_shrine)
"sG" = (
/obj/structure/surface/table/woodentable,
/obj/item/clothing/suit/armor/gladiator{
	pixel_x = -4;
	pixel_y = 4
	},
/obj/item/clothing/head/helmet/gladiator{
	pixel_x = 7;
	pixel_y = 13
	},
/obj/item/reagent_container/syringe/antiviral{
	pixel_x = 5;
	pixel_y = -3
	},
/obj/effect/decal/grass_overlay/jungle{
	dir = 5
	},
/turf/open/floor/sandstone,
/area/whiskey_outpost/blackstone/outside/jungle/sandstone_shrine)
"ue" = (
/obj/structure/barricade/handrail/sandstone/b{
	dir = 4
	},
/turf/open/jungle{
	bushes_spawn = 0;
	icon_state = "grass_impenetrable"
	},
/area/whiskey_outpost/blackstone/outside/jungle/sandstone_shrine)
"uw" = (
/obj/structure/flora/jungle/vines/light_1,
/turf/closed/wall/mineral/sandstone/runed,
/area/whiskey_outpost/blackstone/outside/jungle/sandstone_shrine)
"vg" = (
/obj/effect/decal/cleanable/dirt,
/turf/open/jungle{
	bushes_spawn = 0;
	icon_state = "grass_impenetrable"
	},
/area/whiskey_outpost/blackstone/outside/jungle/sandstone_shrine)
"wq" = (
/obj/effect/decal/grass_overlay/jungle{
	dir = 4
	},
/obj/effect/decal/cleanable/dirt,
/obj/structure/mineral_door/sandstone,
/turf/open/floor/sandstone,
/area/whiskey_outpost/blackstone/outside/jungle/sandstone_shrine)
"wK" = (
/obj/structure/stairs/perspective{
	color = "#b29082";
	dir = 2;
	icon_state = "p_stair_full"
	},
/turf/open/floor/sandstone/runed,
/area/whiskey_outpost/blackstone/outside/jungle/sandstone_shrine)
"wO" = (
/obj/structure/stairs/perspective{
	color = "#b29082";
	dir = 2;
	icon_state = "p_stair_full"
	},
/obj/structure/platform/mineral/sandstone/runed{
	dir = 4
	},
/obj/structure/flora/jungle/vines/light_2,
/turf/open/floor/sandstone/runed,
/area/whiskey_outpost/blackstone/outside/jungle/sandstone_shrine)
"xk" = (
/turf/open/floor/sandstone,
/area/whiskey_outpost/blackstone/outside/jungle/sandstone_shrine)
"xn" = (
/obj/structure/platform/mineral/sandstone/runed{
	dir = 8
	},
/turf/open/jungle/vines,
/area/whiskey_outpost/blackstone/outside/jungle/sandstone_shrine)
"yy" = (
/obj/item/stack/sheet/animalhide/monkey{
	pixel_x = 2;
	pixel_y = -3;
	desc = "A pelt of a monkey, tail and all."
	},
/turf/open/floor/sandstone/runed,
/area/whiskey_outpost/blackstone/outside/jungle/sandstone_shrine)
"zl" = (
/obj/structure/barricade/handrail/sandstone/b{
	dir = 4
	},
/obj/structure/platform_decoration/mineral/sandstone/runed{
	dir = 1
	},
/turf/open/jungle{
	bushes_spawn = 0;
	icon_state = "grass_impenetrable"
	},
/area/whiskey_outpost/blackstone/outside/jungle/sandstone_shrine)
"AU" = (
/obj/effect/decal/grass_overlay/jungle{
	dir = 8
	},
/turf/open/floor/sandstone,
/area/whiskey_outpost/blackstone/outside/jungle/sandstone_shrine)
"BN" = (
/turf/closed/wall/mineral/sandstone,
/area/whiskey_outpost/blackstone/outside/jungle/sandstone_shrine)
"Cf" = (
/obj/structure/platform_decoration/mineral/sandstone/runed{
	dir = 8
	},
/turf/open/jungle{
	bushes_spawn = 0;
	icon_state = "grass_impenetrable"
	},
/area/whiskey_outpost/blackstone/outside/jungle/sandstone_shrine)
"CD" = (
/obj/structure/stairs/perspective{
	color = "#b29082";
	dir = 8;
	icon_state = "p_stair_full"
	},
/turf/open/floor/sandstone/runed,
/area/whiskey_outpost/blackstone/outside/jungle/sandstone_shrine)
"Fs" = (
/obj/structure/platform_decoration/mineral/sandstone/runed,
/turf/open/jungle{
	bushes_spawn = 0;
	icon_state = "grass_impenetrable"
	},
/area/whiskey_outpost/blackstone/outside/jungle/sandstone_shrine)
"Gx" = (
/obj/structure/stairs/perspective{
	color = "#b29082";
	dir = 9;
	icon_state = "p_stair_full"
	},
/turf/open/floor/sandstone,
/area/whiskey_outpost/blackstone/outside/jungle/sandstone_shrine)
"GK" = (
/obj/structure/stairs/perspective{
	color = "#b29082";
	dir = 10;
	icon_state = "p_stair_full"
	},
/turf/open/floor/sandstone/runed,
/area/whiskey_outpost/blackstone/outside/jungle/sandstone_shrine)
"Hn" = (
/obj/structure/surface/table/woodentable,
/obj/item/weapon/twohanded/spear,
/obj/item/weapon/twohanded/spear{
	pixel_x = 6
	},
/obj/item/prop/helmetgarb/compass{
	pixel_y = -3;
	pixel_x = 10
	},
/obj/effect/decal/grass_overlay/jungle{
	dir = 6
	},
/obj/item/weapon/throwing_knife{
	pixel_x = -5;
	pixel_y = 5
	},
/obj/item/weapon/throwing_knife{
	pixel_x = -7;
	pixel_y = 9
	},
/turf/open/floor/sandstone,
/area/whiskey_outpost/blackstone/outside/jungle/sandstone_shrine)
"HA" = (
/obj/structure/stairs/perspective{
	color = "#b29082";
	dir = 1;
	icon_state = "p_stair_full"
	},
/obj/effect/decal/grass_overlay/jungle{
	dir = 10
	},
/turf/open/floor/sandstone,
/area/whiskey_outpost/blackstone/outside/jungle/sandstone_shrine)
"HE" = (
/turf/closed/wall/mineral/sandstone/runed/decor,
/area/whiskey_outpost/blackstone/outside/jungle/sandstone_shrine)
"IA" = (
/obj/effect/decal/grass_overlay/jungle{
	dir = 9
	},
/obj/effect/decal/cleanable/blood/drip{
	pixel_x = -7;
	pixel_y = 7
	},
/turf/open/floor/sandstone,
/area/whiskey_outpost/blackstone/outside/jungle/sandstone_shrine)
"IM" = (
/obj/effect/decal/cleanable/dirt,
/turf/open/floor/sandstone,
/area/whiskey_outpost/blackstone/outside/jungle/sandstone_shrine)
"IO" = (
/turf/open/jungle{
	bushes_spawn = 0;
	icon_state = "grass_impenetrable"
	},
/area/whiskey_outpost/blackstone/outside/jungle/sandstone_shrine)
"JW" = (
/obj/structure/prop/brazier/frame/full/torch{
	pixel_y = 32
	},
/turf/open/floor/sandstone,
/area/whiskey_outpost/blackstone/outside/jungle/sandstone_shrine)
"KQ" = (
/obj/effect/decal/grass_overlay/jungle/inner{
	dir = 5
	},
/turf/open/floor/sandstone,
/area/whiskey_outpost/blackstone/outside/jungle/sandstone_shrine)
"KU" = (
/obj/structure/platform/mineral/sandstone/runed{
	dir = 8
	},
/turf/open/jungle{
	bushes_spawn = 0;
	icon_state = "grass_impenetrable"
	},
/area/whiskey_outpost/blackstone/outside/jungle/sandstone_shrine)
"Ls" = (
/obj/item/device/flashlight/lamp/tripod{
	pixel_y = 5
	},
/obj/effect/decal/grass_overlay/jungle{
	dir = 1
	},
/obj/effect/decal/grass_overlay/jungle{
	dir = 9
	},
/turf/open/floor/sandstone,
/area/whiskey_outpost/blackstone/outside/jungle/sandstone_shrine)
"No" = (
/obj/item/prop/colony/usedbandage,
/obj/effect/decal/cleanable/dirt,
/turf/open/floor/sandstone,
/area/whiskey_outpost/blackstone/outside/jungle/sandstone_shrine)
"Nz" = (
/obj/structure/flora/jungle/vines/light_2,
/turf/closed/wall/mineral/sandstone,
/area/whiskey_outpost/blackstone/outside/jungle/sandstone_shrine)
"Oz" = (
/obj/item/stack/sheet/wood/medium_stack,
/obj/item/stack/sheet/wood/medium_stack{
	pixel_y = 5
	},
/obj/structure/surface/rack,
/obj/item/stack/sheet/mineral/sandstone{
	pixel_y = 9;
	pixel_x = 1
	},
/turf/open/floor/sandstone,
/area/whiskey_outpost/blackstone/outside/jungle/sandstone_shrine)
"OQ" = (
/obj/effect/decal/cleanable/dirt,
/obj/structure/bed/chair/wood/wings{
	dir = 1;
	icon_state = "wooden_chair_wings"
	},
/turf/open/floor/sandstone,
/area/whiskey_outpost/blackstone/outside/jungle/sandstone_shrine)
"Pw" = (
/obj/effect/decal/cleanable/blood/splatter,
/turf/open/floor/sandstone/runed,
/area/whiskey_outpost/blackstone/outside/jungle/sandstone_shrine)
"PA" = (
/obj/structure/flora/jungle/vines/light_2,
/obj/structure/platform/mineral/sandstone/runed,
/obj/item/legcuffs/beartrap{
	icon_state = "beartrap1";
	armed = 1;
	pixel_y = 6
	},
/turf/open/jungle{
	bushes_spawn = 0;
	icon_state = "grass_impenetrable"
	},
/area/whiskey_outpost/blackstone/outside/jungle/sandstone_shrine)
"PY" = (
/turf/closed/wall/mineral/sandstone/runed,
/area/whiskey_outpost/blackstone/outside/jungle/sandstone_shrine)
"PZ" = (
/obj/effect/decal/grass_overlay/jungle,
/turf/open/floor/sandstone,
/area/whiskey_outpost/blackstone/outside/jungle/sandstone_shrine)
"QM" = (
/obj/structure/prop/ice_colony/tiger_rug{
	name = "tiger pelt";
	desc = "A pelt of a large feline. Someone must have gone through a lot of trouble to get it.";
	color = "ecc09d"
	},
/turf/open/floor/sandstone,
/area/whiskey_outpost/blackstone/outside/jungle/sandstone_shrine)
"Rt" = (
/obj/structure/flora/jungle/vines/light_2,
/obj/item/legcuffs/beartrap{
	icon_state = "beartrap1";
	armed = 1;
	pixel_y = 2
	},
/obj/effect/decal/grass_overlay/jungle,
/turf/open/floor/sandstone,
/area/whiskey_outpost/blackstone/outside/jungle/sandstone_shrine)
"Rv" = (
/obj/effect/decal/grass_overlay/jungle/inner{
	dir = 9
	},
/turf/open/floor/sandstone,
/area/whiskey_outpost/blackstone/outside/jungle/sandstone_shrine)
"RX" = (
/obj/effect/landmark/yautja_teleport,
/turf/open/floor/sandstone,
/area/whiskey_outpost/blackstone/outside/jungle/sandstone_shrine)
"Sc" = (
/turf/template_noop,
/area/template_noop)
"Se" = (
/obj/structure/stairs/perspective{
	color = "#b29082";
	dir = 1;
	icon_state = "p_stair_full"
	},
/obj/structure/platform/mineral/sandstone/runed{
	dir = 4
	},
/obj/effect/decal/grass_overlay/grass1{
	dir = 1;
	icon = 'icons/turf/floors/jungle.dmi';
	icon_state = "grass_innercorner";
	pixel_y = 4;
	pixel_x = 10
	},
/obj/effect/decal/grass_overlay/jungle,
/turf/open/floor/sandstone,
/area/whiskey_outpost/blackstone/outside/jungle/sandstone_shrine)
"Us" = (
/obj/item/legcuffs/beartrap{
	icon_state = "beartrap1";
	armed = 1;
	pixel_y = 2
	},
/turf/open/jungle,
/area/whiskey_outpost/blackstone/outside/jungle/sandstone_shrine)
"WN" = (
/obj/structure/surface/table/woodentable,
/obj/item/tool/kitchen/tray{
	color = "#FFE55C";
	pixel_y = 4;
	pixel_x = -2
	},
/obj/item/reagent_container/food/snacks/grown/banana,
/obj/item/reagent_container/food/snacks/grown/grapes{
	pixel_x = -6;
	pixel_y = 7
	},
/obj/item/reagent_container/food/snacks/grown/orange{
	pixel_x = 7
	},
/obj/item/reagent_container/food/drinks/flask/detflask{
	pixel_x = 7;
	pixel_y = 12
	},
/turf/open/floor/sandstone,
/area/whiskey_outpost/blackstone/outside/jungle/sandstone_shrine)
"Xt" = (
/obj/structure/platform_decoration/mineral/sandstone/runed{
	dir = 4
	},
/turf/open/jungle{
	bushes_spawn = 0;
	icon_state = "grass_impenetrable"
	},
/area/whiskey_outpost/blackstone/outside/jungle/sandstone_shrine)
"XO" = (
/obj/structure/flora/jungle/vines/light_1,
/turf/closed/wall/mineral/sandstone,
/area/whiskey_outpost/blackstone/outside/jungle/sandstone_shrine)
"ZJ" = (
/obj/structure/flora/jungle/vines/light_3,
/turf/closed/wall/mineral/sandstone/runed,
/area/whiskey_outpost/blackstone/outside/jungle/sandstone_shrine)

(1,1,1) = {"
IO
IO
qY
IO
IO
qY
IO
IO
Sc
Sc
Sc
"}
(2,1,1) = {"
IO
BN
BN
Nz
wq
BN
BN
IO
IO
Sc
Sc
"}
(3,1,1) = {"
IO
eg
bq
ap
IM
Hn
sG
KQ
IO
Sc
Sc
"}
(4,1,1) = {"
IO
BN
JW
xk
QM
No
sy
Rv
Us
IO
Sc
"}
(5,1,1) = {"
db
PZ
IM
rr
xk
IA
ga
IO
vg
IO
IO
"}
(6,1,1) = {"
db
Rt
RX
WN
OQ
Gx
CD
CD
CD
GK
IO
"}
(7,1,1) = {"
IO
BN
eD
sy
AU
HA
yy
Pw
cz
wK
qY
"}
(8,1,1) = {"
IO
XO
Oz
Ls
Fs
Se
cL
lM
mJ
wO
Cf
"}
(9,1,1) = {"
IO
BN
eg
BN
PA
uw
PY
HE
PY
ZJ
ii
"}
(10,1,1) = {"
IO
IO
qY
ue
zl
sf
KU
KU
xn
KU
Xt
"}
