//MAP CONVERTED BY dmm2tgm.py THIS HEADER COMMENT PREVENTS RECONVERSION, DO NOT REMOVE
"C" = (
/turf/template_noop,
/area/template_noop)

(1,1,1) = {"
C
C
C
C
C
C
C
"}
(2,1,1) = {"
C
C
C
C
C
C
C
"}
(3,1,1) = {"
C
C
C
C
C
C
C
"}
(4,1,1) = {"
C
C
C
C
C
C
C
"}
(5,1,1) = {"
C
C
C
C
C
C
C
"}
(6,1,1) = {"
C
C
C
C
C
C
C
"}
(7,1,1) = {"
C
C
C
C
C
C
C
"}
