//MAP CONVERTED BY dmm2tgm.py THIS HEADER COMMENT PREVENTS RECONVERSION, DO NOT REMOVE
"a" = (
/turf/closed/wall/rock/brown,
/area/whiskey_outpost/blackstone/underground)
"c" = (
/obj/effect/decal/remains/human{
	pixel_y = -5;
	pixel_x = 1
	},
/obj/item/coin/gold{
	pixel_x = -9;
	pixel_y = 1
	},
/obj/item/coin/gold{
	pixel_x = -8;
	pixel_y = 5
	},
/turf/open/floor/sandstone/runed,
/area/whiskey_outpost/blackstone/underground/excavation_site)
"p" = (
/obj/item/coin/gold,
/obj/item/coin/gold{
	pixel_x = -8;
	pixel_y = -4
	},
/obj/item/coin/gold{
	pixel_x = 2;
	pixel_y = -4
	},
/obj/item/coin/gold{
	pixel_x = 6;
	pixel_y = -7
	},
/obj/item/coin/gold{
	pixel_x = -4;
	pixel_y = -8
	},
/turf/open/floor/sandstone/runed,
/area/whiskey_outpost/blackstone/underground/excavation_site)
"q" = (
/obj/structure/stairs/perspective{
	color = "#b29082";
	dir = 1;
	icon_state = "p_stair_full"
	},
/turf/open/floor/sandstone/runed,
/area/whiskey_outpost/blackstone/underground/excavation_site)
"w" = (
/turf/open/floor/sandstone/runed,
/area/whiskey_outpost/blackstone/underground/excavation_site)
"C" = (
/turf/closed/wall/mineral/gold,
/area/whiskey_outpost/blackstone/underground/excavation_site)
"K" = (
/obj/effect/decal/remains/human{
	pixel_y = -5;
	pixel_x = 1
	},
/obj/item/stack/sheet/mineral/gold/small_stack{
	pixel_x = 2;
	pixel_y = 8
	},
/obj/item/stack/sheet/mineral/gold/small_stack{
	pixel_y = 13
	},
/turf/open/floor/sandstone/runed,
/area/whiskey_outpost/blackstone/underground/excavation_site)
"M" = (
/turf/closed/wall/mineral/sandstone/runed/decor,
/area/whiskey_outpost/blackstone/underground/excavation_site)
"N" = (
/obj/effect/decal/remains/human{
	pixel_y = 2;
	pixel_x = -4
	},
/obj/item/coin/gold{
	pixel_x = 7;
	pixel_y = 5
	},
/turf/open/floor/sandstone/runed,
/area/whiskey_outpost/blackstone/underground/excavation_site)
"O" = (
/obj/item/ore/gold{
	pixel_x = 13
	},
/obj/item/ore/gold{
	pixel_y = -2;
	pixel_x = -5
	},
/obj/item/coin/gold{
	pixel_x = 3;
	pixel_y = 9
	},
/turf/open/floor/sandstone/runed,
/area/whiskey_outpost/blackstone/underground/excavation_site)
"R" = (
/obj/effect/decal/sand_overlay/sand5/corner5{
	dir = 4
	},
/obj/structure/machinery/door/airlock/sandstone/runed{
	name = "Strange Temple"
	},
/turf/open/floor/sandstone/runed,
/area/whiskey_outpost/blackstone/underground/excavation_site)
"S" = (
/obj/effect/decal/remains/human,
/obj/effect/decal/remains/human{
	pixel_x = -9;
	pixel_y = 3
	},
/obj/item/coin/gold{
	pixel_x = 7;
	pixel_y = 5
	},
/turf/open/floor/sandstone/runed,
/area/whiskey_outpost/blackstone/underground/excavation_site)
"T" = (
/obj/item/stack/sheet/mineral/gold/small_stack{
	pixel_x = 1
	},
/obj/item/stack/sheet/mineral/gold/small_stack{
	pixel_x = 2;
	pixel_y = 5
	},
/obj/item/stack/sheet/mineral/gold/small_stack{
	pixel_x = 2;
	pixel_y = 10
	},
/turf/open/floor/sandstone/runed,
/area/whiskey_outpost/blackstone/underground/excavation_site)
"U" = (
/obj/item/ore/gold{
	pixel_x = 13
	},
/obj/item/ore/gold{
	pixel_y = 6;
	pixel_x = 9
	},
/obj/item/ore/gold{
	pixel_y = -6;
	pixel_x = 7
	},
/obj/item/ore/gold{
	pixel_y = 1;
	pixel_x = 1
	},
/obj/item/ore/gold{
	pixel_y = -7;
	pixel_x = -5
	},
/turf/open/floor/sandstone/runed,
/area/whiskey_outpost/blackstone/underground/excavation_site)
"V" = (
/obj/structure/stairs/perspective{
	color = "#b29082";
	dir = 1;
	icon_state = "p_stair_full"
	},
/obj/item/coin/gold{
	pixel_y = 13
	},
/turf/open/floor/sandstone/runed,
/area/whiskey_outpost/blackstone/underground/excavation_site)

(1,1,1) = {"
a
a
a
a
a
a
a
"}
(2,1,1) = {"
a
a
C
C
C
C
a
"}
(3,1,1) = {"
M
O
V
S
U
C
a
"}
(4,1,1) = {"
R
w
q
p
T
C
a
"}
(5,1,1) = {"
M
K
V
N
c
C
a
"}
(6,1,1) = {"
a
a
C
C
C
C
a
"}
(7,1,1) = {"
a
a
a
a
a
a
a
"}
