//MAP CONVERTED BY dmm2tgm.py THIS HEADER COMMENT PREVENTS RECONVERSION, DO NOT REMOVE
"d" = (
/turf/open/floor,
/area/lv624/lazarus/landing_zones/lz1)
"f" = (
/obj/effect/landmark/hunter_primary,
/turf/open/floor,
/area/lv624/lazarus/landing_zones/lz1)
"l" = (
/obj/vehicle/train/cargo/trolley,
/turf/open/floor/bot/north,
/area/lv624/lazarus/landing_zones/lz1)
"n" = (
/turf/open/floor/bot/north,
/area/lv624/lazarus/landing_zones/lz1)
"r" = (
/obj/structure/largecrate/random/barrel/red,
/turf/open/floor/bot/north,
/area/lv624/lazarus/landing_zones/lz1)
"u" = (
/obj/structure/largecrate/random/barrel/white,
/turf/open/floor/bot/north,
/area/lv624/lazarus/landing_zones/lz1)
"x" = (
/obj/item/device/radio/intercom{
	freerange = 1;
	frequency = 1469;
	name = "General Listening Channel";
	pixel_x = -30
	},
/turf/open/floor/warning/southwest,
/area/lv624/lazarus/landing_zones/lz1)
"z" = (
/turf/open/floor/loadingarea/north,
/area/lv624/lazarus/landing_zones/lz1)
"A" = (
/obj/structure/largecrate/random/barrel/blue,
/turf/open/floor/bot/north,
/area/lv624/lazarus/landing_zones/lz1)
"E" = (
/turf/open/floor/warning,
/area/lv624/lazarus/landing_zones/lz1)
"F" = (
/obj/vehicle/train/cargo/trolley,
/turf/open/floor,
/area/lv624/lazarus/landing_zones/lz1)
"G" = (
/obj/structure/largecrate,
/turf/open/floor/bot/north,
/area/lv624/lazarus/landing_zones/lz1)
"H" = (
/obj/structure/largecrate/random/barrel/green,
/turf/open/floor/bot/north,
/area/lv624/lazarus/landing_zones/lz1)
"J" = (
/turf/open/floor/loadingarea/west,
/area/lv624/lazarus/landing_zones/lz1)
"M" = (
/turf/open/floor/warningcorner/east,
/area/lv624/lazarus/landing_zones/lz1)
"N" = (
/obj/effect/decal/cleanable/blood/tracks/footprints{
	dir = 4
	},
/obj/effect/decal/cleanable/blood/tracks/footprints{
	dir = 8
	},
/turf/open/floor/warning/west,
/area/lv624/lazarus/landing_zones/lz1)
"P" = (
/obj/vehicle/train/cargo/engine,
/obj/effect/landmark/good_item,
/turf/open/floor,
/area/lv624/lazarus/landing_zones/lz1)
"Q" = (
/obj/structure/machinery/bot/mulebot{
	auto_pickup = 0;
	auto_return = 0;
	health = 1;
	on = 0
	},
/turf/open/floor/loadingarea/west,
/area/lv624/lazarus/landing_zones/lz1)
"S" = (
/obj/structure/machinery/bot/mulebot{
	auto_pickup = 0;
	auto_return = 0;
	health = 1;
	on = 0
	},
/turf/open/floor/bot/north,
/area/lv624/lazarus/landing_zones/lz1)
"V" = (
/turf/open/floor/warning/west,
/area/lv624/lazarus/landing_zones/lz1)
"Z" = (
/obj/effect/landmark/crap_item,
/turf/open/floor/loadingarea/west,
/area/lv624/lazarus/landing_zones/lz1)

(1,1,1) = {"
V
V
V
N
V
V
V
x
V
V
M
d
d
d
E
"}
(2,1,1) = {"
n
J
Z
J
J
Q
n
E
n
G
l
G
n
G
E
"}
(3,1,1) = {"
G
d
n
d
u
d
G
E
z
d
F
d
d
d
E
"}
(4,1,1) = {"
A
d
r
d
G
d
n
E
z
d
l
A
G
G
E
"}
(5,1,1) = {"
r
d
S
f
n
d
n
E
z
d
P
d
d
d
E
"}
(6,1,1) = {"
n
d
n
d
n
d
n
E
n
n
n
u
H
n
E
"}
