//MAP CONVERTED BY dmm2tgm.py THIS HEADER COMMENT PREVENTS RECONVERSION, DO NOT REMOVE
"ad" = (
/obj/structure/flora/bush/ausbushes/var3/brflowers,
/obj/structure/pipes/standard/simple/hidden/cyan,
/obj/item/stack/sheet/metal,
/turf/open/floor/grass,
/area/lv624/lazarus/main_hall)
"aD" = (
/obj/effect/landmark/corpsespawner/engineer,
/turf/open/floor,
/area/lv624/lazarus/main_hall)
"aS" = (
/obj/effect/decal/cleanable/blood/splatter,
/obj/effect/landmark/corpsespawner/doctor,
/obj/item/frame/table,
/obj/item/ammo_casing,
/turf/open/floor,
/area/lv624/lazarus/main_hall)
"aY" = (
/obj/effect/decal/cleanable/blood/splatter,
/obj/item/limb/arm/l_arm,
/obj/structure/surface/table{
	dir = 4;
	flipped = 1
	},
/obj/effect/decal/cleanable/blood/splatter,
/obj/item/ammo_casing,
/turf/open/floor,
/area/lv624/lazarus/main_hall)
"aZ" = (
/obj/effect/decal/cleanable/blood/splatter,
/obj/structure/surface/table{
	flipped = 1
	},
/turf/open/floor,
/area/lv624/lazarus/main_hall)
"bg" = (
/obj/effect/decal/cleanable/blood/splatter,
/obj/effect/decal/cleanable/blood/splatter,
/obj/item/ammo_casing,
/obj/item/ammo_casing,
/turf/open/floor,
/area/lv624/lazarus/main_hall)
"bk" = (
/obj/structure/flora/bush/ausbushes/var3/stalkybush,
/obj/structure/pipes/standard/simple/hidden/cyan,
/obj/structure/surface/table,
/turf/open/floor/grass,
/area/lv624/lazarus/main_hall)
"bn" = (
/obj/structure/pipes/standard/simple/hidden/cyan,
/obj/item/ammo_casing,
/turf/closed/wall/mineral/gold,
/area/lv624/lazarus/main_hall)
"bL" = (
/obj/effect/decal/cleanable/blood/splatter,
/obj/structure/pipes/standard/simple/hidden/cyan,
/obj/structure/surface/table{
	flipped = 1
	},
/obj/item/ammo_casing,
/turf/open/floor,
/area/lv624/lazarus/main_hall)
"bM" = (
/obj/effect/decal/cleanable/blood/splatter,
/obj/item/limb/leg/r_leg,
/obj/structure/surface/table{
	flipped = 1
	},
/obj/effect/decal/cleanable/blood/splatter,
/obj/item/ammo_casing,
/turf/open/floor,
/area/lv624/lazarus/main_hall)
"dE" = (
/obj/effect/decal/cleanable/blood/splatter,
/obj/item/limb/foot/l_foot,
/obj/item/ammo_casing,
/obj/item/ammo_casing,
/turf/open/floor/floorscorched1,
/area/lv624/lazarus/main_hall)
"dQ" = (
/obj/structure/machinery/vending/cigarette/colony,
/turf/open/floor/whiteblue/northwest,
/area/lv624/lazarus/main_hall)
"ef" = (
/obj/structure/barricade/wooden{
	dir = 8
	},
/turf/open/floor/damaged2,
/area/lv624/lazarus/main_hall)
"eI" = (
/obj/effect/decal/cleanable/blood/splatter,
/obj/effect/decal/cleanable/blood/splatter,
/obj/item/ammo_magazine/smg/mp27,
/obj/item/ammo_casing,
/turf/open/floor/white,
/area/lv624/lazarus/main_hall)
"fz" = (
/obj/structure/barricade/wooden,
/turf/open/floor/white,
/area/lv624/lazarus/main_hall)
"fU" = (
/obj/effect/decal/cleanable/blood/splatter,
/obj/item/ammo_casing,
/obj/item/ammo_casing,
/turf/open/floor/whiteyellowcorner/north,
/area/lv624/lazarus/main_hall)
"gY" = (
/obj/effect/landmark/crap_item,
/turf/open/floor/white,
/area/lv624/lazarus/main_hall)
"hC" = (
/obj/effect/decal/cleanable/blood/splatter,
/obj/item/limb/arm/l_arm,
/obj/item/frame/table,
/obj/effect/decal/cleanable/blood/splatter,
/obj/item/ammo_casing,
/obj/item/ammo_casing,
/turf/open/floor/white,
/area/lv624/lazarus/main_hall)
"hL" = (
/obj/effect/decal/cleanable/vomit,
/turf/open/floor/white,
/area/lv624/lazarus/main_hall)
"if" = (
/turf/open/floor/whitegreencorner/west,
/area/lv624/lazarus/main_hall)
"is" = (
/obj/item/tool/crowbar,
/obj/effect/decal/cleanable/blood/splatter,
/obj/structure/surface/table{
	dir = 8;
	flipped = 1
	},
/obj/item/ammo_casing,
/turf/open/floor/whiteyellowfull/east,
/area/lv624/lazarus/main_hall)
"jk" = (
/obj/effect/decal/cleanable/blood/splatter,
/obj/structure/surface/table{
	flipped = 1
	},
/obj/item/ammo_casing,
/obj/item/ammo_casing,
/turf/open/floor/whiteyellowfull/east,
/area/lv624/lazarus/main_hall)
"jp" = (
/obj/structure/window/framed/colony/reinforced,
/turf/open/floor/cult,
/area/lv624/lazarus/kitchen)
"ju" = (
/obj/structure/machinery/door/airlock/multi_tile/almayer/generic{
	name = "\improper Nexus Dome Chapel"
	},
/turf/open/floor/white,
/area/lv624/lazarus/chapel)
"jz" = (
/obj/structure/barricade/metal{
	dir = 4
	},
/obj/item/ammo_casing,
/turf/open/floor/floorscorched2,
/area/lv624/lazarus/main_hall)
"kt" = (
/obj/effect/decal/cleanable/blood/splatter,
/obj/effect/decal/cleanable/blood/gibs,
/turf/open/floor/white,
/area/lv624/lazarus/main_hall)
"kA" = (
/obj/effect/decal/cleanable/blood/splatter,
/obj/item/limb/foot/l_foot,
/obj/item/ammo_casing,
/obj/item/ammo_casing,
/obj/item/ammo_casing,
/turf/open/floor/whiteyellowfull/east,
/area/lv624/lazarus/main_hall)
"kF" = (
/obj/item/limb/foot/r_foot,
/obj/structure/surface/table{
	dir = 8;
	flipped = 1
	},
/obj/item/ammo_casing,
/obj/item/ammo_casing,
/turf/open/floor/white,
/area/lv624/lazarus/main_hall)
"kJ" = (
/obj/effect/decal/cleanable/blood/splatter,
/obj/item/ammo_casing,
/turf/open/floor/damaged5,
/area/lv624/lazarus/main_hall)
"kM" = (
/obj/structure/machinery/vending/cola,
/turf/open/floor/whiteblue/southwest,
/area/lv624/lazarus/main_hall)
"kT" = (
/obj/item/limb/hand/r_hand,
/obj/structure/surface/table{
	dir = 4;
	flipped = 1
	},
/obj/item/ammo_casing,
/obj/item/ammo_casing,
/turf/open/floor/white,
/area/lv624/lazarus/main_hall)
"lu" = (
/obj/effect/decal/cleanable/blood/gibs,
/obj/item/frame/table,
/obj/item/ammo_casing,
/obj/item/ammo_casing,
/obj/item/ammo_casing,
/turf/open/floor/whiteyellowfull/east,
/area/lv624/lazarus/main_hall)
"lH" = (
/obj/item/ammo_magazine/smg/mp27,
/obj/item/ammo_magazine/smg/mp27,
/obj/item/ammo_magazine/smg/mp27,
/turf/open/floor/wall_thermite,
/area/lv624/lazarus/main_hall)
"lI" = (
/obj/item/reagent_container/glass/bucket/mopbucket,
/obj/item/tool/mop,
/obj/item/tool/mop,
/turf/open/floor/white,
/area/lv624/lazarus/main_hall)
"lO" = (
/obj/structure/surface/table,
/turf/open/floor/whitegreencorner/west,
/area/lv624/lazarus/main_hall)
"mx" = (
/obj/item/ammo_casing,
/obj/item/ammo_casing,
/obj/item/ammo_casing,
/turf/open/floor/floorscorched2,
/area/lv624/lazarus/main_hall)
"mI" = (
/obj/structure/pipes/standard/simple/hidden/cyan,
/obj/effect/decal/cleanable/blood/splatter,
/obj/item/ammo_casing,
/turf/open/floor/whitegreen,
/area/lv624/lazarus/main_hall)
"no" = (
/obj/item/limb/foot/r_foot,
/obj/effect/decal/cleanable/blood/splatter,
/obj/item/ammo_casing,
/obj/item/ammo_casing,
/turf/open/floor/damaged4,
/area/lv624/lazarus/main_hall)
"nM" = (
/obj/item/stack/sheet/metal,
/obj/item/stack/sheet/metal,
/obj/effect/decal/cleanable/blood/gibs,
/turf/open/floor/platingdmg3,
/area/lv624/lazarus/main_hall)
"nP" = (
/turf/open/floor/whiteyellowcorner/west,
/area/lv624/lazarus/main_hall)
"oh" = (
/obj/structure/pipes/standard/simple/hidden/cyan,
/obj/item/frame/table,
/obj/item/ammo_casing,
/turf/open/floor/damaged4,
/area/lv624/lazarus/main_hall)
"oj" = (
/obj/item/stack/barbed_wire,
/obj/item/ammo_casing,
/obj/item/ammo_casing,
/obj/item/ammo_casing,
/turf/open/floor/damaged2,
/area/lv624/lazarus/main_hall)
"os" = (
/turf/open/floor/whiteyellow/west,
/area/lv624/lazarus/main_hall)
"oC" = (
/obj/structure/window/framed/colony/reinforced,
/turf/open/floor/cult,
/area/lv624/lazarus/canteen)
"pC" = (
/obj/effect/decal/cleanable/blood/splatter,
/obj/item/ammo_casing,
/turf/open/floor/floorscorched2,
/area/lv624/lazarus/main_hall)
"pY" = (
/obj/structure/machinery/door/airlock/almayer/medical/glass/colony{
	name = "\improper Nexus Dome Canteen"
	},
/turf/open/floor/barber/west,
/area/lv624/lazarus/kitchen)
"qo" = (
/obj/item/trash/raisins,
/obj/structure/barricade/wooden{
	dir = 8
	},
/obj/item/ammo_casing,
/turf/open/floor/white,
/area/lv624/lazarus/main_hall)
"qs" = (
/turf/open/floor/floorscorched2,
/area/lv624/lazarus/main_hall)
"ra" = (
/obj/item/weapon/gun/smg/mp27,
/obj/item/ammo_casing,
/obj/item/ammo_casing,
/obj/item/ammo_casing,
/turf/open/floor/whiteyellowfull/east,
/area/lv624/lazarus/main_hall)
"rz" = (
/obj/structure/barricade/wooden{
	dir = 1
	},
/turf/open/floor/white,
/area/lv624/lazarus/main_hall)
"rS" = (
/obj/effect/landmark/corpsespawner/chef,
/obj/structure/surface/table{
	dir = 4;
	flipped = 1
	},
/obj/item/ammo_casing,
/turf/open/floor/whiteyellowfull/east,
/area/lv624/lazarus/main_hall)
"sB" = (
/obj/item/trash/chips,
/obj/effect/decal/cleanable/blood/splatter,
/obj/item/ammo_casing,
/turf/open/floor/white,
/area/lv624/lazarus/main_hall)
"sH" = (
/obj/effect/decal/cleanable/blood/splatter,
/obj/effect/decal/cleanable/blood/splatter,
/obj/item/ammo_casing,
/turf/open/floor/damaged5,
/area/lv624/lazarus/main_hall)
"sJ" = (
/obj/effect/decal/cleanable/blood/gibs,
/obj/item/weapon/gun/pistol/highpower,
/obj/item/ammo_casing,
/obj/item/ammo_casing,
/obj/item/ammo_casing,
/turf/open/floor/platingdmg3,
/area/lv624/lazarus/main_hall)
"sM" = (
/obj/structure/surface/table,
/turf/open/floor/white,
/area/lv624/lazarus/main_hall)
"sZ" = (
/obj/structure/flora/pottedplant,
/obj/structure/machinery/light/spot{
	dir = 1
	},
/obj/structure/barricade/wooden{
	dir = 8
	},
/turf/open/floor/white,
/area/lv624/lazarus/main_hall)
"tt" = (
/obj/structure/pipes/standard/simple/hidden/cyan,
/obj/item/ammo_casing,
/turf/open/floor/white,
/area/lv624/lazarus/main_hall)
"ub" = (
/obj/structure/barricade/wooden{
	dir = 8
	},
/obj/structure/barricade/wooden,
/obj/item/ammo_casing,
/turf/open/floor/white,
/area/lv624/lazarus/main_hall)
"uI" = (
/turf/open/floor/floorscorched1,
/area/lv624/lazarus/main_hall)
"ve" = (
/obj/effect/decal/cleanable/blood/splatter,
/obj/structure/surface/table{
	flipped = 1
	},
/turf/open/floor/whiteyellowfull/east,
/area/lv624/lazarus/main_hall)
"vH" = (
/turf/open/floor/damaged5,
/area/lv624/lazarus/main_hall)
"vS" = (
/obj/item/ammo_casing,
/turf/open/floor/whiteyellow/east,
/area/lv624/lazarus/main_hall)
"vZ" = (
/obj/item/weapon/gun/smg/mp27,
/obj/item/ammo_casing,
/obj/item/ammo_casing,
/obj/item/ammo_casing,
/turf/open/floor/damaged3,
/area/lv624/lazarus/main_hall)
"xr" = (
/obj/structure/machinery/door/airlock/almayer/engineering/colony{
	density = 0;
	icon_state = "door_open";
	name = "\improper Nexus Cargo Storage"
	},
/turf/open/floor/whiteyellowfull/east,
/area/lv624/lazarus/quart)
"xC" = (
/obj/effect/decal/cleanable/blood/splatter,
/obj/effect/decal/cleanable/blood/splatter,
/obj/item/ammo_casing,
/turf/open/floor/damaged2,
/area/lv624/lazarus/main_hall)
"yh" = (
/obj/structure/reagent_dispensers/watertank,
/turf/open/floor/whiteblue/southeast,
/area/lv624/lazarus/main_hall)
"yT" = (
/obj/structure/machinery/vending/snack,
/obj/item/stack/sheet/metal{
	amount = 30;
	pixel_x = 4;
	pixel_y = 4
	},
/turf/open/floor/whiteblue/northeast,
/area/lv624/lazarus/main_hall)
"za" = (
/obj/item/weapon/twohanded/fireaxe,
/obj/item/ammo_casing,
/obj/item/ammo_casing,
/turf/open/floor/white,
/area/lv624/lazarus/main_hall)
"zd" = (
/turf/open/floor/white,
/area/lv624/lazarus/main_hall)
"zh" = (
/obj/structure/barricade/wooden,
/obj/effect/decal/cleanable/blood/splatter,
/obj/item/ammo_casing,
/turf/open/floor/whiteyellowcorner/east,
/area/lv624/lazarus/main_hall)
"zH" = (
/obj/item/weapon/gun/smg/mp27,
/obj/item/ammo_casing,
/turf/open/floor/floorscorched1,
/area/lv624/lazarus/main_hall)
"An" = (
/obj/item/ammo_casing,
/obj/item/ammo_casing,
/turf/open/floor/floorscorched2,
/area/lv624/lazarus/main_hall)
"BM" = (
/obj/item/ammo_casing,
/obj/item/ammo_casing,
/obj/item/ammo_casing,
/turf/open/floor/damaged4,
/area/lv624/lazarus/main_hall)
"Cn" = (
/obj/structure/bed/chair{
	dir = 4
	},
/turf/open/floor/white,
/area/lv624/lazarus/main_hall)
"Dc" = (
/obj/structure/pipes/standard/simple/hidden/cyan,
/obj/effect/decal/cleanable/blood/splatter,
/obj/item/ammo_casing,
/obj/effect/landmark/xeno_hive_spawn,
/obj/effect/landmark/ert_spawns/groundside_xeno,
/turf/open/floor/white,
/area/lv624/lazarus/main_hall)
"DY" = (
/turf/closed/wall,
/area/lv624/lazarus/quart)
"DZ" = (
/obj/effect/decal/cleanable/blood/splatter,
/turf/open/floor/damaged4,
/area/lv624/lazarus/main_hall)
"EA" = (
/obj/effect/decal/cleanable/blood/splatter,
/obj/item/ammo_magazine/smg/mp27,
/obj/item/ammo_casing,
/obj/item/ammo_casing,
/obj/item/ammo_casing,
/turf/open/floor/damaged2,
/area/lv624/lazarus/main_hall)
"EJ" = (
/obj/effect/decal/cleanable/blood/splatter,
/obj/structure/surface/table{
	dir = 4;
	flipped = 1
	},
/obj/effect/decal/cleanable/blood/splatter,
/obj/item/ammo_casing,
/obj/item/ammo_casing,
/obj/item/ammo_casing,
/obj/item/ammo_casing,
/turf/open/floor/whiteyellowfull/east,
/area/lv624/lazarus/main_hall)
"EN" = (
/obj/item/ammo_casing,
/obj/item/ammo_casing,
/turf/open/floor/damaged4,
/area/lv624/lazarus/main_hall)
"EX" = (
/obj/effect/decal/cleanable/blood/splatter,
/obj/effect/decal/cleanable/blood/gibs,
/obj/structure/pipes/standard/simple/hidden/cyan,
/obj/item/ammo_casing,
/turf/open/floor/floorscorched1,
/area/lv624/lazarus/main_hall)
"Fn" = (
/obj/structure/pipes/standard/simple/hidden/cyan,
/obj/item/ammo_casing,
/obj/item/ammo_casing,
/turf/open/floor/damaged5,
/area/lv624/lazarus/main_hall)
"Fp" = (
/obj/effect/landmark/good_item,
/obj/item/ammo_casing,
/turf/open/floor/white,
/area/lv624/lazarus/main_hall)
"Ft" = (
/obj/structure/pipes/standard/simple/hidden/cyan,
/turf/open/floor/grass,
/area/lv624/lazarus/main_hall)
"Fz" = (
/obj/structure/window/framed/colony/reinforced,
/turf/open/floor/plating,
/area/lv624/lazarus/chapel)
"FH" = (
/obj/effect/decal/cleanable/blood/splatter,
/obj/item/ammo_casing,
/obj/item/ammo_casing,
/turf/open/floor/floorscorched1,
/area/lv624/lazarus/main_hall)
"FT" = (
/obj/structure/flora/bush/ausbushes/grassybush,
/obj/structure/pipes/standard/simple/hidden/cyan,
/turf/open/floor/grass,
/area/lv624/lazarus/main_hall)
"Ge" = (
/obj/effect/decal/cleanable/blood/gibs,
/obj/item/ammo_casing,
/obj/item/ammo_casing,
/obj/item/ammo_casing,
/turf/open/floor/damaged5,
/area/lv624/lazarus/main_hall)
"Gs" = (
/turf/closed/wall,
/area/lv624/lazarus/chapel)
"Hh" = (
/obj/structure/barricade/wooden{
	dir = 8
	},
/turf/open/floor/white,
/area/lv624/lazarus/main_hall)
"Hn" = (
/obj/structure/barricade/metal{
	dir = 4
	},
/obj/effect/decal/cleanable/blood/gibs,
/obj/item/ammo_casing,
/turf/open/floor/damaged5,
/area/lv624/lazarus/main_hall)
"Hx" = (
/obj/structure/flora/pottedplant,
/turf/open/floor/white,
/area/lv624/lazarus/main_hall)
"HC" = (
/obj/effect/decal/cleanable/blood/splatter,
/turf/open/floor/whiteyellowfull/east,
/area/lv624/lazarus/main_hall)
"HQ" = (
/obj/item/stack/sheet/wood,
/turf/open/floor/damaged2,
/area/lv624/lazarus/main_hall)
"HV" = (
/obj/item/ammo_casing,
/turf/open/floor/damaged2,
/area/lv624/lazarus/main_hall)
"Io" = (
/obj/structure/flora/pottedplant,
/obj/structure/machinery/light/spot{
	dir = 1
	},
/turf/open/floor/white,
/area/lv624/lazarus/main_hall)
"IU" = (
/turf/open/floor/white,
/area/lv624/lazarus/chapel)
"Jw" = (
/obj/item/limb/arm/l_arm,
/obj/effect/decal/cleanable/blood/splatter,
/obj/effect/decal/cleanable/blood/splatter,
/obj/item/ammo_casing,
/turf/open/floor/floorscorched1,
/area/lv624/lazarus/main_hall)
"Jz" = (
/obj/item/ammo_casing,
/turf/open/floor/floorscorched1,
/area/lv624/lazarus/main_hall)
"JI" = (
/obj/effect/decal/cleanable/vomit,
/obj/item/ammo_casing,
/obj/item/ammo_casing,
/obj/item/ammo_casing,
/turf/open/floor/damaged2,
/area/lv624/lazarus/main_hall)
"JM" = (
/turf/open/floor/damaged2,
/area/lv624/lazarus/main_hall)
"Kj" = (
/obj/effect/decal/cleanable/blood/splatter,
/obj/effect/decal/cleanable/blood/splatter,
/turf/open/floor/damaged5,
/area/lv624/lazarus/main_hall)
"Kp" = (
/obj/effect/decal/cleanable/blood/splatter,
/obj/item/frame/table,
/obj/item/ammo_casing,
/obj/item/ammo_casing,
/turf/open/floor/white,
/area/lv624/lazarus/main_hall)
"KG" = (
/obj/effect/decal/cleanable/blood/splatter,
/obj/structure/barricade/wooden{
	dir = 8
	},
/obj/effect/decal/cleanable/blood/splatter,
/obj/effect/decal/cleanable/blood/splatter,
/obj/item/ammo_casing,
/turf/open/floor/white,
/area/lv624/lazarus/main_hall)
"KQ" = (
/obj/structure/window/framed/colony/reinforced,
/turf/open/floor/plating,
/area/lv624/lazarus/security)
"Li" = (
/obj/item/ammo_casing,
/turf/open/floor/white,
/area/lv624/lazarus/main_hall)
"Ll" = (
/turf/closed/wall/r_wall,
/area/lv624/lazarus/security)
"Lp" = (
/turf/closed/wall,
/area/lv624/lazarus/canteen)
"Nk" = (
/turf/closed/wall,
/area/lv624/lazarus/kitchen)
"NT" = (
/obj/structure/machinery/door/airlock/almayer/security/colony{
	locked = 1;
	name = "\improper Nexus Dome Marshal Office"
	},
/turf/open/floor,
/area/lv624/lazarus/security)
"NX" = (
/obj/structure/flora/pottedplant,
/obj/structure/machinery/light/spot,
/turf/open/floor/white,
/area/lv624/lazarus/main_hall)
"OK" = (
/turf/template_noop,
/area/template_noop)
"OM" = (
/obj/structure/flora/grass,
/obj/structure/pipes/standard/simple/hidden/cyan,
/turf/open/floor/grass,
/area/lv624/lazarus/main_hall)
"OR" = (
/obj/item/ammo_casing,
/obj/item/ammo_casing,
/turf/open/floor/floorscorched1,
/area/lv624/lazarus/main_hall)
"PD" = (
/obj/item/stack/sheet/metal,
/turf/open/floor/floorscorched2,
/area/lv624/lazarus/main_hall)
"Qy" = (
/obj/structure/barricade/metal{
	dir = 4
	},
/turf/open/floor/floorscorched2,
/area/lv624/lazarus/main_hall)
"Qz" = (
/turf/open/floor/whiteyellowcorner/north,
/area/lv624/lazarus/main_hall)
"QG" = (
/obj/item/stack/barbed_wire,
/obj/effect/decal/cleanable/blood/splatter,
/obj/item/ammo_casing,
/turf/open/floor/damaged2,
/area/lv624/lazarus/main_hall)
"QO" = (
/obj/item/ammo_casing,
/obj/item/ammo_casing,
/turf/open/floor/damaged3,
/area/lv624/lazarus/main_hall)
"QS" = (
/obj/effect/decal/cleanable/blood/splatter,
/obj/effect/decal/cleanable/blood/splatter,
/obj/effect/decal/cleanable/blood/splatter,
/obj/item/ammo_casing,
/obj/item/ammo_casing,
/turf/open/floor/damaged5,
/area/lv624/lazarus/main_hall)
"RV" = (
/obj/effect/landmark/good_item,
/obj/effect/decal/cleanable/blood/splatter,
/obj/item/ammo_casing,
/turf/open/floor/white,
/area/lv624/lazarus/main_hall)
"Sn" = (
/obj/item/stack/barbed_wire,
/turf/open/floor/damaged2,
/area/lv624/lazarus/main_hall)
"SF" = (
/obj/structure/machinery/atm{
	name = "Automatic Teller Machine";
	pixel_y = 30
	},
/obj/structure/bed/chair{
	dir = 8
	},
/turf/open/floor/white,
/area/lv624/lazarus/main_hall)
"SN" = (
/obj/item/trash/cheesie,
/turf/open/floor/white,
/area/lv624/lazarus/main_hall)
"SS" = (
/obj/effect/decal/cleanable/blood/splatter,
/obj/effect/decal/cleanable/blood/splatter,
/obj/item/ammo_casing,
/turf/open/floor/floorscorched2,
/area/lv624/lazarus/main_hall)
"Tc" = (
/obj/item/frame/table,
/obj/effect/decal/cleanable/blood/splatter,
/turf/open/floor/platingdmg3,
/area/lv624/lazarus/main_hall)
"Td" = (
/obj/effect/decal/cleanable/blood/splatter,
/obj/item/ammo_casing,
/obj/item/ammo_casing,
/turf/open/floor/platingdmg3,
/area/lv624/lazarus/main_hall)
"Th" = (
/obj/effect/decal/cleanable/blood{
	pixel_y = 12
	},
/obj/structure/pipes/standard/simple/hidden/cyan,
/obj/item/limb/hand/l_hand,
/obj/item/ammo_casing,
/obj/item/ammo_casing,
/turf/open/floor/floorscorched1,
/area/lv624/lazarus/main_hall)
"Ue" = (
/turf/open/floor/platingdmg3,
/area/lv624/lazarus/main_hall)
"Vr" = (
/turf/open/floor/damaged4,
/area/lv624/lazarus/main_hall)
"Wg" = (
/obj/effect/decal/cleanable/blood/splatter,
/obj/item/ammo_casing,
/obj/item/ammo_casing,
/turf/open/floor/white,
/area/lv624/lazarus/main_hall)
"Ww" = (
/turf/open/floor/wall_thermite,
/area/lv624/lazarus/main_hall)
"WF" = (
/obj/structure/bed/chair{
	dir = 8
	},
/turf/open/floor/white,
/area/lv624/lazarus/main_hall)
"XF" = (
/obj/item/frame/table,
/obj/item/ammo_magazine/smg/mp27,
/turf/open/floor/white,
/area/lv624/lazarus/main_hall)
"XJ" = (
/obj/effect/landmark/good_item,
/obj/effect/decal/cleanable/blood/splatter,
/obj/effect/decal/cleanable/blood/splatter,
/obj/item/ammo_casing,
/obj/item/ammo_casing,
/turf/open/floor/white,
/area/lv624/lazarus/main_hall)
"XQ" = (
/obj/structure/surface/table{
	dir = 4;
	flipped = 1
	},
/obj/effect/landmark/crap_item,
/turf/open/floor/white,
/area/lv624/lazarus/main_hall)
"YO" = (
/turf/open/floor/whitegreencorner,
/area/lv624/lazarus/main_hall)
"Zb" = (
/obj/structure/barricade/wooden,
/turf/open/floor/whitegreencorner,
/area/lv624/lazarus/main_hall)
"ZE" = (
/obj/structure/flora/pottedplant,
/obj/structure/barricade/wooden,
/obj/item/ammo_casing,
/turf/open/floor/white,
/area/lv624/lazarus/main_hall)

(1,1,1) = {"
OK
OK
OK
OK
ju
zd
nP
os
Qz
Vr
KQ
OK
OK
OK
OK
"}
(2,1,1) = {"
OK
OK
OK
OK
IU
zd
zd
vH
JM
zd
KQ
OK
OK
OK
OK
"}
(3,1,1) = {"
OK
OK
Gs
Gs
Gs
sM
ef
Tc
Hh
sM
Ll
KQ
Ll
OK
OK
"}
(4,1,1) = {"
OK
OK
Gs
dQ
Hx
JM
Kj
JM
DZ
fz
Hx
kM
KQ
OK
OK
"}
(5,1,1) = {"
Fz
Fz
Gs
Io
QO
QS
vZ
Td
QO
zh
Fp
NX
Ll
NT
KQ
"}
(6,1,1) = {"
zd
Vr
rz
XF
Jw
sB
no
bg
HV
EA
KG
qo
fz
zd
gY
"}
(7,1,1) = {"
vH
JM
rz
xC
JI
kF
aS
lu
is
jk
Li
kJ
sM
zd
Ue
"}
(8,1,1) = {"
YO
PD
HQ
XJ
Td
hC
BM
Ge
dE
aZ
Td
xC
Zb
YO
YO
"}
(9,1,1) = {"
FT
Ft
ad
Fn
Dc
oh
EX
bn
Th
bL
tt
mI
bk
Ft
OM
"}
(10,1,1) = {"
if
Vr
nM
za
Jz
Kp
lH
kA
sJ
bM
qs
sH
lO
Ue
if
"}
(11,1,1) = {"
zd
vH
rz
EN
SS
kT
aY
EJ
rS
ve
eI
RV
fz
hL
zd
"}
(12,1,1) = {"
JM
zd
rz
SN
FH
Li
kJ
mx
Ww
HV
Wg
Li
fz
zd
zd
"}
(13,1,1) = {"
xr
DY
DY
sZ
ub
kt
aD
ra
OR
fU
zH
NX
Nk
jp
pY
"}
(14,1,1) = {"
OK
OK
DY
yT
ZE
uI
HC
oj
pC
qs
lI
yh
Nk
OK
OK
"}
(15,1,1) = {"
OK
OK
DY
DY
DY
Cn
QG
An
Sn
Cn
Lp
Lp
Lp
OK
OK
"}
(16,1,1) = {"
OK
OK
OK
OK
DY
XQ
jz
Hn
Qy
XQ
oC
OK
OK
OK
OK
"}
(17,1,1) = {"
OK
OK
OK
OK
DY
SF
JM
vS
vH
WF
oC
OK
OK
OK
OK
"}
