//MAP CONVERTED BY dmm2tgm.py THIS HEADER COMMENT PREVENTS RECONVERSION, DO NOT REMOVE
"aa" = (
/turf/open/gm/grass/grass1,
/area/lv624/ground/jungle/north_west_jungle)
"ab" = (
/turf/closed/wall/r_wall,
/area/lv624/lazarus/research)
"ac" = (
/obj/structure/window/framed/colony/reinforced,
/obj/structure/machinery/door/poddoor/almayer{
	id = "science_blast";
	layer = 3.3;
	name = "\improper Science Wing Blast Door"
	},
/turf/open/floor/plating,
/area/lv624/lazarus/research)
"ae" = (
/turf/open/gm/dirt,
/area/lv624/ground/colony/south_medbay_road)
"ag" = (
/obj/effect/decal/remains/xeno,
/turf/open/gm/dirt,
/area/lv624/ground/colony/south_medbay_road)
"ah" = (
/turf/closed/wall/strata_ice/jungle,
/area/lv624/ground/jungle/north_west_jungle)
"ai" = (
/obj/structure/window_frame/colony/reinforced,
/obj/structure/machinery/door/poddoor/almayer{
	id = "science_blast";
	layer = 3.3;
	name = "\improper Science Wing Blast Door"
	},
/turf/open/floor/plating,
/area/lv624/lazarus/research)
"an" = (
/obj/structure/fence,
/turf/open/gm/dirtgrassborder/south,
/area/lv624/ground/colony/south_medbay_road)
"ao" = (
/obj/structure/window/framed/colony/reinforced,
/obj/structure/machinery/door/poddoor/almayer{
	dir = 4;
	id = "science_blast";
	layer = 3.3;
	name = "\improper Science Wing Blast Door"
	},
/turf/open/floor/plating,
/area/lv624/lazarus/research)
"ar" = (
/turf/closed/wall,
/area/lv624/lazarus/research)
"av" = (
/turf/open/gm/grass/grass1,
/area/lv624/ground/colony/south_medbay_road)
"bg" = (
/turf/open/gm/grass/grass1,
/area/lv624/ground/jungle/central_jungle)
"bh" = (
/turf/closed/wall/strata_ice/jungle,
/area/lv624/ground/jungle/central_jungle)
"bq" = (
/obj/effect/landmark/monkey_spawn,
/turf/open/floor/white,
/area/lv624/lazarus/research)
"bw" = (
/obj/structure/bed/chair/office/dark{
	dir = 8
	},
/turf/open/floor/whitepurple/northeast,
/area/lv624/lazarus/research)
"bT" = (
/obj/structure/machinery/cm_vending/sorted/tech/science,
/turf/open/floor/whitepurple/northeast,
/area/lv624/lazarus/research)
"cd" = (
/obj/structure/surface/table,
/obj/item/clipboard,
/obj/item/paper/research_notes,
/turf/open/floor/whitepurple/northeast,
/area/lv624/lazarus/research)
"cY" = (
/obj/structure/machinery/door/airlock/almayer/research/colony{
	dir = 1;
	locked = 1;
	name = "\improper Research Dome"
	},
/turf/open/floor/whitepurple/northeast,
/area/lv624/lazarus/research)
"dK" = (
/obj/structure/surface/table,
/obj/item/paper/research_notes,
/obj/effect/landmark/crap_item,
/turf/open/floor/whitepurple/northeast,
/area/lv624/lazarus/research)
"eJ" = (
/obj/structure/machinery/door/airlock/almayer/research/colony{
	locked = 1;
	name = "\improper Research Dome"
	},
/turf/open/floor/whitepurple/northeast,
/area/lv624/lazarus/research)
"iB" = (
/obj/structure/bed/chair/office/dark,
/turf/open/floor/whitepurple/northeast,
/area/lv624/lazarus/research)
"jo" = (
/obj/structure/surface/table,
/obj/effect/landmark/crap_item,
/obj/item/weapon/yautja/combistick,
/turf/open/floor/whitepurple/northeast,
/area/lv624/lazarus/research)
"lX" = (
/obj/structure/surface/table,
/obj/item/storage/fancy/vials/random,
/turf/open/floor/whitepurple/northeast,
/area/lv624/lazarus/research)
"mG" = (
/obj/structure/surface/table,
/obj/structure/machinery/cell_charger,
/obj/item/tool/crowbar,
/turf/open/floor/whitepurple/northeast,
/area/lv624/lazarus/research)
"nb" = (
/obj/effect/landmark/crap_item,
/turf/open/floor/whitepurple/northeast,
/area/lv624/lazarus/research)
"pM" = (
/obj/structure/machinery/light{
	dir = 8
	},
/obj/effect/landmark/crap_item,
/obj/structure/phone_base/colony_net{
	phone_category = "Lazarus Landing";
	phone_id = "Research Dome";
	pixel_y = 24
	},
/turf/open/floor/whitepurple/northeast,
/area/lv624/lazarus/research)
"rH" = (
/obj/item/clothing/glasses/regular,
/turf/open/floor/white,
/area/lv624/lazarus/research)
"sg" = (
/obj/structure/machinery/door/poddoor/almayer{
	dir = 4;
	id = "science_blast";
	layer = 3.3;
	name = "\improper Science Wing Blast Door"
	},
/turf/open/floor/whitepurple/northeast,
/area/lv624/lazarus/research)
"th" = (
/obj/structure/machinery/door/poddoor/almayer{
	id = "science_blast";
	layer = 3.3;
	name = "\improper Science Wing Blast Door"
	},
/obj/structure/machinery/door/airlock/almayer/research/colony{
	dir = 1;
	locked = 1;
	name = "\improper Research Dome"
	},
/turf/open/floor/white,
/area/lv624/lazarus/research)
"tO" = (
/obj/structure/sink{
	dir = 4;
	icon_state = "sink";
	pixel_x = 11
	},
/obj/effect/landmark/crap_item,
/turf/open/floor/freezerfloor,
/area/lv624/lazarus/research)
"uv" = (
/obj/structure/machinery/smartfridge/chemistry,
/turf/open/floor/whitepurple/northeast,
/area/lv624/lazarus/research)
"vc" = (
/obj/structure/surface/table,
/obj/structure/machinery/light,
/obj/item/tool/surgery/circular_saw/predatorbonesaw,
/obj/item/tool/surgery/hemostat/predatorhemostat,
/obj/item/tool/surgery/retractor/predatorretractor,
/obj/item/tool/surgery/scalpel/predatorscalpel,
/turf/open/floor/whitepurple/northeast,
/area/lv624/lazarus/research)
"yG" = (
/obj/structure/machinery/door/airlock/almayer/research/colony{
	dir = 1;
	locked = 1;
	name = "\improper Research Dome"
	},
/turf/open/floor/white,
/area/lv624/lazarus/research)
"Bw" = (
/obj/structure/machinery/shower{
	pixel_y = 16
	},
/obj/structure/machinery/light{
	dir = 4
	},
/turf/open/floor/freezerfloor,
/area/lv624/lazarus/research)
"BD" = (
/obj/structure/bed/chair/office/dark{
	dir = 1
	},
/turf/open/floor/whitepurple/northeast,
/area/lv624/lazarus/research)
"ER" = (
/obj/structure/machinery/light/small{
	dir = 1
	},
/obj/structure/surface/table,
/obj/item/paper/research_notes,
/turf/open/floor/whitepurple/northeast,
/area/lv624/lazarus/research)
"GA" = (
/obj/structure/surface/table,
/turf/open/floor/freezerfloor,
/area/lv624/lazarus/research)
"Hs" = (
/obj/structure/surface/table,
/obj/item/weapon/yautja/knife,
/turf/open/floor/whitepurple/northeast,
/area/lv624/lazarus/research)
"HF" = (
/obj/structure/surface/table,
/obj/item/reagent_container/hypospray/autoinjector/yautja,
/turf/open/floor/whitepurple/northeast,
/area/lv624/lazarus/research)
"HO" = (
/obj/effect/landmark/crap_item,
/obj/structure/machinery/power/apc/no_power/north,
/turf/open/floor/whitepurple/northeast,
/area/lv624/lazarus/research)
"It" = (
/obj/effect/decal/cleanable/blood/splatter,
/obj/effect/decal/remains/human,
/turf/open/floor/white,
/area/lv624/lazarus/research)
"Iv" = (
/obj/structure/machinery/light{
	dir = 8
	},
/obj/structure/surface/table,
/obj/item/storage/box/disks{
	layer = 2.9;
	pixel_x = 5;
	pixel_y = 5
	},
/obj/item/paper/research_notes,
/obj/item/prop/alien/hugger,
/turf/open/floor/white,
/area/lv624/lazarus/research)
"Iy" = (
/obj/structure/machinery/light{
	dir = 4
	},
/turf/open/floor/whitepurple/northeast,
/area/lv624/lazarus/research)
"IP" = (
/obj/structure/machinery/optable,
/obj/effect/decal/cleanable/blood/splatter,
/turf/open/floor/whitepurple/northeast,
/area/lv624/lazarus/research)
"IY" = (
/obj/structure/surface/table,
/obj/item/reagent_container/hypospray/autoinjector/yautja,
/obj/item/reagent_container/hypospray/autoinjector/yautja,
/turf/open/floor/whitepurple/northeast,
/area/lv624/lazarus/research)
"Jc" = (
/obj/structure/machinery/door_control{
	id = "science_blast";
	name = "Science Wing Lockdown";
	pixel_x = 25
	},
/turf/open/floor/white,
/area/lv624/lazarus/research)
"Ju" = (
/turf/open/floor/whitepurple/northeast,
/area/lv624/lazarus/research)
"JM" = (
/obj/structure/machinery/chem_dispenser,
/turf/open/floor/whitepurple/northeast,
/area/lv624/lazarus/research)
"Ml" = (
/obj/structure/machinery/chem_master,
/turf/open/floor/whitepurple/northeast,
/area/lv624/lazarus/research)
"Mr" = (
/obj/structure/machinery/door/poddoor/almayer{
	dir = 4;
	id = "science_blast";
	layer = 3.3;
	name = "\improper Science Wing Blast Door"
	},
/obj/structure/machinery/door/airlock/almayer/research/colony{
	locked = 1;
	name = "\improper Research Dome"
	},
/turf/open/floor/white,
/area/lv624/lazarus/research)
"Mt" = (
/turf/open/floor/freezerfloor,
/area/lv624/lazarus/research)
"Os" = (
/obj/structure/machinery/light{
	dir = 4
	},
/obj/effect/landmark/crap_item,
/turf/open/floor/white,
/area/lv624/lazarus/research)
"OD" = (
/obj/structure/surface/table,
/obj/item/paper/research_notes,
/turf/open/floor/whitepurple/northeast,
/area/lv624/lazarus/research)
"OE" = (
/obj/structure/machinery/light,
/turf/open/floor/whitepurple/northeast,
/area/lv624/lazarus/research)
"OG" = (
/obj/effect/landmark/crap_item,
/turf/open/floor/white,
/area/lv624/lazarus/research)
"OP" = (
/obj/structure/bed/chair/office/dark{
	dir = 1
	},
/turf/open/floor/white,
/area/lv624/lazarus/research)
"Pd" = (
/obj/structure/surface/rack{
	layer = 2.5
	},
/obj/item/clothing/glasses/regular,
/turf/open/floor/whitepurple/northeast,
/area/lv624/lazarus/research)
"RJ" = (
/obj/effect/decal/cleanable/blood/splatter,
/obj/effect/landmark/corpsespawner/scientist,
/turf/open/floor/whitepurple/northeast,
/area/lv624/lazarus/research)
"Si" = (
/obj/structure/surface/table,
/obj/effect/landmark/crap_item,
/turf/open/floor/whitepurple/northeast,
/area/lv624/lazarus/research)
"Ug" = (
/obj/effect/decal/cleanable/blood/splatter,
/obj/effect/landmark/corpsespawner/scientist,
/turf/open/floor/white,
/area/lv624/lazarus/research)
"Wk" = (
/obj/item/storage/box/beakers,
/obj/structure/surface/table,
/obj/structure/sign/safety/biohazard,
/obj/effect/landmark/crap_item,
/turf/open/floor/whitepurple/northeast,
/area/lv624/lazarus/research)
"Wp" = (
/obj/structure/surface/table,
/obj/item/explosive/grenade/spawnergrenade/smartdisc,
/obj/item/explosive/grenade/spawnergrenade/smartdisc,
/turf/open/floor/whitepurple/northeast,
/area/lv624/lazarus/research)
"Yf" = (
/obj/structure/machinery/door/airlock/almayer/research/colony{
	locked = 1;
	name = "\improper Research Dome"
	},
/turf/open/floor/white,
/area/lv624/lazarus/research)
"YB" = (
/obj/structure/surface/table,
/obj/item/weapon/yautja/scythe,
/turf/open/floor/whitepurple/northeast,
/area/lv624/lazarus/research)
"YD" = (
/obj/effect/landmark/crap_item,
/turf/open/floor/freezerfloor,
/area/lv624/lazarus/research)
"YU" = (
/turf/open/floor/white,
/area/lv624/lazarus/research)

(1,1,1) = {"
aa
ah
aa
aa
aa
ab
ao
Mr
ao
ab
aa
aa
aa
aa
aa
"}
(2,1,1) = {"
aa
ab
ao
ao
ao
ab
lX
YU
nb
ab
ao
ao
ao
ab
aa
"}
(3,1,1) = {"
aa
ai
HF
IP
vc
ar
dK
OP
OE
ar
GA
Mt
YD
ac
aa
"}
(4,1,1) = {"
aa
ai
Ju
bw
Ju
cY
Ju
OG
Ju
cY
Mt
Mt
Mt
ac
aa
"}
(5,1,1) = {"
aa
ai
Ju
Ju
Pd
ar
Ju
YU
Ju
ar
Bw
Mt
tO
ac
aa
"}
(6,1,1) = {"
ab
ab
ar
eJ
ar
ar
ar
Yf
ar
ar
ar
eJ
ar
ab
ab
"}
(7,1,1) = {"
ac
Si
lX
nb
Ju
ar
Iv
It
OG
ar
bT
RJ
Wk
OD
ac
"}
(8,1,1) = {"
th
YU
YU
It
YU
yG
YU
bq
YU
yG
YU
YU
bq
YU
th
"}
(9,1,1) = {"
ac
nb
Iy
Ju
Ju
ar
Jc
YU
Os
ar
Iy
nb
Ju
Ju
ac
"}
(10,1,1) = {"
ab
ab
ar
uv
ar
ab
ab
Yf
ab
ab
ar
eJ
ar
ab
ab
"}
(11,1,1) = {"
ae
ai
lX
Ju
OE
ab
HO
YU
Ju
ab
pM
Ju
Hs
ac
bg
"}
(12,1,1) = {"
ae
ai
cd
BD
Ju
cY
Ju
Ug
Ju
cY
Ju
iB
IY
ac
bg
"}
(13,1,1) = {"
ae
ac
Ml
nb
JM
ab
ER
rH
Ju
ab
YB
Wp
jo
ac
bg
"}
(14,1,1) = {"
ag
ab
ao
ao
ao
ab
mG
YU
OE
ab
ao
ao
ao
ab
bg
"}
(15,1,1) = {"
ae
an
av
av
av
ab
ab
sg
sg
ab
bg
bg
bg
bg
bh
"}
