//MAP CONVERTED BY dmm2tgm.py THIS HEADER COMMENT PREVENTS RECONVERSION, DO NOT REMOVE
"aa" = (
/turf/open/gm/grass/grass1,
/area/lv624/ground/jungle/north_west_jungle)
"ab" = (
/turf/closed/wall/r_wall,
/area/lv624/lazarus/research)
"ac" = (
/obj/structure/window/framed/colony/reinforced,
/obj/structure/machinery/door/poddoor/almayer/planet_side_blastdoor{
	id = "science_blast";
	layer = 3.3;
	name = "\improper Science Wing Blast Door"
	},
/turf/open/floor/plating,
/area/lv624/lazarus/research)
"ae" = (
/turf/open/gm/dirt,
/area/lv624/ground/colony/south_medbay_road)
"ag" = (
/obj/effect/decal/remains/xeno,
/turf/open/gm/dirt,
/area/lv624/ground/colony/south_medbay_road)
"ah" = (
/turf/closed/wall/strata_ice/jungle,
/area/lv624/ground/jungle/north_west_jungle)
"ai" = (
/obj/structure/window_frame/colony/reinforced,
/obj/structure/machinery/door/poddoor/almayer/planet_side_blastdoor{
	id = "science_blast";
	layer = 3.3;
	name = "\improper Science Wing Blast Door"
	},
/turf/open/floor/plating,
/area/lv624/lazarus/research)
"an" = (
/obj/structure/fence,
/turf/open/gm/dirtgrassborder/south,
/area/lv624/ground/colony/south_medbay_road)
"ao" = (
/obj/structure/window/framed/colony/reinforced,
/obj/structure/machinery/door/poddoor/almayer/planet_side_blastdoor{
	dir = 4;
	id = "science_blast";
	layer = 3.3;
	name = "\improper Science Wing Blast Door"
	},
/turf/open/floor/plating,
/area/lv624/lazarus/research)
"au" = (
/turf/closed/wall,
/area/lv624/lazarus/research)
"ax" = (
/turf/open/gm/grass/grass1,
/area/lv624/ground/colony/south_medbay_road)
"bE" = (
/turf/open/gm/grass/grass1,
/area/lv624/ground/jungle/central_jungle)
"bF" = (
/turf/closed/wall/strata_ice/jungle,
/area/lv624/ground/jungle/central_jungle)
"bM" = (
/obj/structure/machinery/chem_dispenser,
/turf/open/floor/whitepurple/northeast,
/area/lv624/lazarus/research)
"bO" = (
/obj/structure/machinery/cm_vending/sorted/tech/science,
/turf/open/floor/whitepurple/northeast,
/area/lv624/lazarus/research)
"dm" = (
/turf/open/floor/white,
/area/lv624/lazarus/research)
"ff" = (
/obj/structure/machinery/light{
	dir = 4
	},
/turf/open/floor/white,
/area/lv624/lazarus/research)
"fQ" = (
/obj/structure/machinery/door/airlock/almayer/research/colony{
	locked = 1;
	name = "\improper Research Dome"
	},
/turf/open/floor/whitepurple/northeast,
/area/lv624/lazarus/research)
"gM" = (
/obj/structure/surface/table,
/obj/structure/machinery/cell_charger,
/obj/item/tool/crowbar,
/turf/open/floor/whitepurple/northeast,
/area/lv624/lazarus/research)
"js" = (
/obj/structure/xenoautopsy/tank/alien,
/turf/open/floor/whitepurple/northeast,
/area/lv624/lazarus/research)
"jE" = (
/obj/structure/bed/chair/office/dark{
	dir = 1
	},
/turf/open/floor/whitepurple/northeast,
/area/lv624/lazarus/research)
"kg" = (
/obj/structure/surface/table,
/turf/open/floor/freezerfloor,
/area/lv624/lazarus/research)
"ly" = (
/obj/structure/machinery/shower{
	pixel_y = 16
	},
/obj/structure/machinery/light{
	dir = 4
	},
/turf/open/floor/freezerfloor,
/area/lv624/lazarus/research)
"lS" = (
/obj/structure/machinery/light{
	dir = 4
	},
/turf/open/floor/whitepurple/northeast,
/area/lv624/lazarus/research)
"nT" = (
/obj/item/clothing/glasses/regular,
/turf/open/floor/white,
/area/lv624/lazarus/research)
"oa" = (
/obj/structure/machinery/power/apc/no_power/north,
/turf/open/floor/whitepurple/northeast,
/area/lv624/lazarus/research)
"pL" = (
/obj/effect/landmark/corpsespawner/scientist,
/obj/effect/decal/cleanable/blood/splatter,
/turf/open/floor/white,
/area/lv624/lazarus/research)
"qg" = (
/obj/structure/surface/rack{
	layer = 2.5
	},
/obj/item/clothing/glasses/regular,
/turf/open/floor/whitepurple/northeast,
/area/lv624/lazarus/research)
"sc" = (
/obj/structure/machinery/door/airlock/almayer/research/colony{
	locked = 1;
	name = "\improper Research Dome"
	},
/turf/open/floor/white,
/area/lv624/lazarus/research)
"sn" = (
/obj/structure/machinery/door_control{
	id = "science_blast";
	name = "Science Wing Lockdown";
	pixel_x = 25
	},
/turf/open/floor/white,
/area/lv624/lazarus/research)
"st" = (
/obj/structure/surface/table,
/obj/item/storage/fancy/vials/random,
/turf/open/floor/whitepurple/northeast,
/area/lv624/lazarus/research)
"sJ" = (
/obj/structure/machinery/chem_master,
/turf/open/floor/whitepurple/northeast,
/area/lv624/lazarus/research)
"vG" = (
/obj/structure/sink{
	dir = 4;
	icon_state = "sink";
	pixel_x = 11
	},
/turf/open/floor/freezerfloor,
/area/lv624/lazarus/research)
"wv" = (
/turf/open/floor/whitepurple/northeast,
/area/lv624/lazarus/research)
"wE" = (
/obj/structure/machinery/door/poddoor/almayer/planet_side_blastdoor{
	dir = 4;
	id = "science_blast";
	layer = 3.3;
	name = "\improper Science Wing Blast Door"
	},
/turf/open/floor/whitepurple/northeast,
/area/lv624/lazarus/research)
"yd" = (
/obj/structure/machinery/door/poddoor/almayer/planet_side_blastdoor{
	dir = 4;
	id = "science_blast";
	layer = 3.3;
	name = "\improper Science Wing Blast Door"
	},
/obj/structure/machinery/door/airlock/almayer/research/colony{
	locked = 1;
	name = "\improper Research Dome"
	},
/turf/open/floor/white,
/area/lv624/lazarus/research)
"yh" = (
/obj/structure/bed/chair/office/dark,
/turf/open/floor/whitepurple/northeast,
/area/lv624/lazarus/research)
"zn" = (
/obj/structure/machinery/door/airlock/almayer/research/colony{
	dir = 1;
	locked = 1;
	name = "\improper Research Dome"
	},
/turf/open/floor/white,
/area/lv624/lazarus/research)
"Aq" = (
/obj/structure/xenoautopsy/tank/hugger,
/turf/open/floor/whitepurple/northeast,
/area/lv624/lazarus/research)
"Av" = (
/obj/structure/machinery/door/poddoor/almayer/planet_side_blastdoor{
	id = "science_blast";
	layer = 3.3;
	name = "\improper Science Wing Blast Door"
	},
/obj/structure/machinery/door/airlock/almayer/research/colony{
	dir = 1;
	locked = 1;
	name = "\improper Research Dome"
	},
/turf/open/floor/white,
/area/lv624/lazarus/research)
"AG" = (
/obj/structure/bed/chair/office/dark{
	dir = 1
	},
/turf/open/floor/white,
/area/lv624/lazarus/research)
"Bw" = (
/obj/structure/machinery/light{
	dir = 8
	},
/obj/structure/surface/table,
/obj/item/storage/box/disks{
	layer = 2.9;
	pixel_x = 5;
	pixel_y = 5
	},
/obj/item/storage/fancy/vials/random,
/turf/open/floor/white,
/area/lv624/lazarus/research)
"EY" = (
/obj/structure/phone_base/colony_net{
	phone_category = "Lazarus Landing";
	phone_id = "Research Dome";
	pixel_y = 24
	},
/turf/open/floor/whitepurple/northeast,
/area/lv624/lazarus/research)
"FJ" = (
/obj/effect/decal/cleanable/blood/splatter,
/turf/open/floor/white,
/area/lv624/lazarus/research)
"HT" = (
/obj/structure/surface/table,
/obj/item/clipboard,
/obj/item/paper/research_notes,
/turf/open/floor/whitepurple/northeast,
/area/lv624/lazarus/research)
"Id" = (
/obj/structure/machinery/optable,
/turf/open/floor/whitepurple/northeast,
/area/lv624/lazarus/research)
"IY" = (
/obj/structure/machinery/light/small{
	dir = 1
	},
/obj/structure/surface/table,
/turf/open/floor/whitepurple/northeast,
/area/lv624/lazarus/research)
"JM" = (
/turf/open/floor/freezerfloor,
/area/lv624/lazarus/research)
"KD" = (
/obj/structure/surface/table,
/turf/open/floor/whitepurple/northeast,
/area/lv624/lazarus/research)
"LL" = (
/obj/structure/machinery/smartfridge/chemistry,
/turf/open/floor/whitepurple/northeast,
/area/lv624/lazarus/research)
"NO" = (
/obj/structure/surface/table,
/obj/item/tool/surgery/scalpel{
	pixel_y = 12
	},
/obj/structure/machinery/light,
/turf/open/floor/whitepurple/northeast,
/area/lv624/lazarus/research)
"PD" = (
/obj/structure/surface/table,
/obj/item/paper/research_notes,
/turf/open/floor/whitepurple/northeast,
/area/lv624/lazarus/research)
"QH" = (
/obj/structure/bed/chair/office/dark{
	dir = 8
	},
/turf/open/floor/whitepurple/northeast,
/area/lv624/lazarus/research)
"Ri" = (
/obj/item/storage/box/beakers,
/obj/structure/surface/table,
/obj/structure/sign/safety/biohazard,
/turf/open/floor/whitepurple/northeast,
/area/lv624/lazarus/research)
"Rk" = (
/obj/structure/machinery/light{
	dir = 8
	},
/obj/structure/xenoautopsy/jar_shelf,
/turf/open/floor/whitepurple/northeast,
/area/lv624/lazarus/research)
"Wx" = (
/obj/structure/machinery/light,
/obj/effect/decal/cleanable/blood/splatter,
/turf/open/floor/whitepurple/northeast,
/area/lv624/lazarus/research)
"XS" = (
/obj/structure/machinery/door/airlock/almayer/research/colony{
	dir = 1;
	locked = 1;
	name = "\improper Research Dome"
	},
/turf/open/floor/whitepurple/northeast,
/area/lv624/lazarus/research)
"Yd" = (
/obj/structure/machinery/light,
/turf/open/floor/whitepurple/northeast,
/area/lv624/lazarus/research)

(1,1,1) = {"
aa
ah
aa
aa
aa
ab
ao
yd
ao
ab
aa
aa
aa
aa
aa
"}
(2,1,1) = {"
aa
ab
ao
ao
ao
ab
st
pL
wv
ab
ao
ao
ao
ab
aa
"}
(3,1,1) = {"
aa
ai
KD
Id
NO
au
PD
AG
Yd
au
kg
JM
JM
ac
aa
"}
(4,1,1) = {"
aa
ai
js
QH
wv
XS
wv
dm
wv
XS
JM
JM
JM
ac
aa
"}
(5,1,1) = {"
aa
ai
Aq
wv
qg
au
EY
dm
wv
au
ly
JM
vG
ac
aa
"}
(6,1,1) = {"
ab
ab
au
fQ
au
au
au
sc
au
au
au
fQ
au
ab
ab
"}
(7,1,1) = {"
ac
PD
KD
wv
wv
au
Bw
FJ
dm
au
bO
wv
Ri
PD
ac
"}
(8,1,1) = {"
Av
dm
dm
pL
dm
zn
dm
dm
FJ
zn
dm
pL
dm
dm
Av
"}
(9,1,1) = {"
ac
wv
lS
wv
wv
au
sn
dm
ff
au
lS
wv
wv
wv
ac
"}
(10,1,1) = {"
ab
ab
au
LL
au
ab
ab
sc
ab
ab
au
fQ
au
ab
ab
"}
(11,1,1) = {"
ae
ai
st
wv
Yd
ab
oa
dm
wv
ab
Rk
wv
KD
ac
bE
"}
(12,1,1) = {"
ae
ai
HT
jE
wv
XS
wv
FJ
wv
XS
wv
yh
st
ac
bE
"}
(13,1,1) = {"
ae
ac
sJ
wv
bM
ab
IY
nT
wv
ab
PD
PD
KD
ac
bE
"}
(14,1,1) = {"
ag
ab
ao
ao
ao
ab
gM
dm
Wx
ab
ao
ao
ao
ab
bE
"}
(15,1,1) = {"
ae
an
ax
ax
ax
ab
ab
wE
wE
ab
bE
bE
bE
bE
bF
"}
