//MAP CONVERTED BY dmm2tgm.py THIS HEADER COMMENT PREVENTS RECONVERSION, DO NOT REMOVE
"c" = (
/obj/structure/interior_wall/pizza_van{
	icon_state = "back_1"
	},
/turf/open/void/vehicle,
/area/space)
"e" = (
/obj/structure/interior_wall/pizza_van{
	icon_state = "back_3"
	},
/turf/open/void/vehicle,
/area/space)
"f" = (
/obj/effect/vehicle_roof/pizza_van{
	icon_state = "front_2"
	},
/turf/open/void/vehicle,
/area/space)
"h" = (
/obj/effect/landmark/interior/spawn/entrance{
	dir = 8;
	exit_type = /obj/structure/interior_exit/vehicle/pizza_van/backright;
	name = "back right entrance marker";
	pixel_x = -32;
	tag = "back_right"
	},
/obj/structure/bed/roller,
/obj/structure/machinery/iv_drip{
	pixel_x = 7;
	pixel_y = 23;
	anchored = 1
	},
/turf/open/shuttle/vehicle/floor_2,
/area/interior/vehicle/ambulance)
"i" = (
/obj/effect/vehicle_roof/pizza_van{
	icon_state = "front_1"
	},
/turf/open/void/vehicle,
/area/space)
"j" = (
/obj/structure/interior_wall/pizza_van,
/obj/effect/vehicle_roof/pizza_van{
	icon_state = "roof_4"
	},
/turf/open/void/vehicle,
/area/space)
"o" = (
/obj/effect/landmark/interior/spawn/interior_viewport/simple{
	pixel_y = 30;
	pixel_x = -1
	},
/obj/structure/extinguisher_cabinet/lifeboat{
	layer = 3.21;
	pixel_x = 10;
	pixel_y = 24
	},
/obj/structure/closet/crate/medical{
	anchored = 1;
	desc = "A medical crate. There's a label on the side that say's 'CLOSE DURING TRANSPORT'."
	},
/obj/item/reagent_container/spray/cleaner,
/obj/item/storage/surgical_case/regular,
/obj/item/clothing/accessory/stethoscope,
/obj/item/device/flashlight/pen,
/obj/item/storage/firstaid/o2,
/obj/item/storage/firstaid/adv,
/obj/item/reagent_container/blood/OMinus,
/obj/item/reagent_container/blood/OMinus,
/obj/item/reagent_container/blood/OMinus,
/obj/item/storage/box/bodybags,
/obj/item/roller,
/obj/effect/vehicle_roof/pizza_van{
	icon_state = "roof_3"
	},
/turf/open/shuttle/vehicle/med/gray,
/area/interior/vehicle/ambulance)
"p" = (
/obj/structure/interior_wall/pizza_van{
	icon_state = "background_3";
	pixel_y = 32;
	layer = 5.2;
	alpha = 50
	},
/turf/open/void/vehicle,
/area/space)
"r" = (
/obj/structure/interior_wall/pizza_van{
	icon_state = "exterior_3"
	},
/obj/effect/vehicle_roof/pizza_van{
	icon_state = "roof_5"
	},
/turf/open/void/vehicle,
/area/space)
"s" = (
/obj/structure/interior_wall/pizza_van{
	icon_state = "back_2"
	},
/turf/open/void/vehicle,
/area/space)
"t" = (
/obj/effect/landmark/interior/spawn/entrance{
	dir = 1;
	exit_type = /obj/structure/interior_exit/vehicle/pizza_van/left;
	name = "left entrance marker";
	pixel_y = 32;
	tag = "left"
	},
/obj/effect/landmark/interior/spawn/vehicle_driver_seat{
	dir = 4;
	icon_state = "comfychair_beige"
	},
/obj/effect/landmark/interior/spawn/interior_viewport/simple/windshield{
	icon_state = "windshield_viewport_bottom";
	icon = 'icons/obj/vehicles/interiors/pizza_van_interior.dmi'
	},
/obj/effect/vehicle_roof/pizza_van{
	icon_state = "front_roof_2"
	},
/turf/open/shuttle/vehicle/floor_3_11,
/area/interior/vehicle/ambulance)
"v" = (
/obj/effect/landmark/interior/spawn/interior_viewport/simple/windshield{
	icon = 'icons/obj/vehicles/interiors/pizza_van_interior.dmi'
	},
/obj/effect/vehicle_roof/pizza_van{
	icon_state = "interior_door"
	},
/obj/effect/vehicle_roof/pizza_van{
	icon_state = "front_roof_1"
	},
/turf/open/void/vehicle,
/area/space)
"w" = (
/obj/effect/vehicle_roof/pizza_van{
	icon_state = "front_3"
	},
/turf/open/void/vehicle,
/area/space)
"x" = (
/obj/structure/interior_wall/pizza_van{
	icon_state = "background_2";
	pixel_y = 32;
	layer = 5.2;
	alpha = 50
	},
/turf/open/void/vehicle,
/area/space)
"y" = (
/obj/effect/landmark/interior/spawn/entrance{
	alpha = 50;
	exit_type = /obj/structure/interior_exit/vehicle/pizza_van/right;
	name = "right entrance marker";
	tag = "right"
	},
/obj/structure/bed/chair/comfy/beige{
	dir = 4
	},
/turf/open/shuttle/vehicle/floor_3_12,
/area/interior/vehicle/ambulance)
"G" = (
/obj/structure/bed/chair/comfy/black{
	dir = 8
	},
/turf/open/shuttle/vehicle/floor_2,
/area/interior/vehicle/ambulance)
"I" = (
/obj/structure/interior_wall/pizza_van{
	icon_state = "exterior_door";
	pixel_y = 32;
	layer = 5.2;
	alpha = 50
	},
/turf/open/void/vehicle,
/area/space)
"M" = (
/obj/effect/landmark/interior/spawn/entrance{
	dir = 8;
	exit_type = /obj/structure/interior_exit/vehicle/pizza_van/backleft;
	name = "back left entrance marker";
	pixel_x = -32;
	tag = "back_left"
	},
/obj/effect/vehicle_roof/pizza_van{
	icon_state = "roof_2"
	},
/turf/open/shuttle/vehicle/med/gray,
/area/interior/vehicle/ambulance)
"O" = (
/turf/open/void/vehicle,
/area/space)

(1,1,1) = {"
O
O
O
O
O
"}
(2,1,1) = {"
O
e
s
c
O
"}
(3,1,1) = {"
O
j
M
h
x
"}
(4,1,1) = {"
O
r
o
G
p
"}
(5,1,1) = {"
O
v
t
y
I
"}
(6,1,1) = {"
O
w
f
i
O
"}
