//MAP CONVERTED BY dmm2tgm.py THIS HEADER COMMENT PREVENTS RECONVERSION, DO NOT REMOVE
"aa" = (
/obj/structure/interior_wall/apc{
	icon_state = "rear_2"
	},
/turf/open/void/vehicle,
/area/space)
"ae" = (
/obj/structure/interior_wall/apc{
	icon_state = "rear_1"
	},
/turf/open/void/vehicle,
/area/space)
"ag" = (
/obj/structure/interior_wall/apc{
	icon_state = "corner_small_R"
	},
/obj/structure/interior_wall/apc{
	icon_state = "front_5"
	},
/turf/open/void/vehicle,
/area/space)
"ah" = (
/obj/structure/interior_wall/apc{
	icon_state = "rear_wheel_R";
	opacity = 0
	},
/turf/open/void/vehicle,
/area/space)
"aj" = (
/turf/open/void/vehicle,
/area/space)
"ak" = (
/obj/structure/interior_wall/apc{
	icon_state = "rear_wheel_L"
	},
/turf/open/void/vehicle,
/area/space)
"al" = (
/obj/structure/interior_wall/apc{
	alpha = 100;
	icon_state = "wall_door_front";
	layer = 5.2;
	pixel_y = 32
	},
/turf/open/void/vehicle,
/area/space)
"an" = (
/obj/structure/interior_wall/apc{
	icon_state = "front_2"
	},
/turf/open/void/vehicle,
/area/space)
"ao" = (
/obj/structure/interior_wall/apc{
	icon_state = "front_wheel_L";
	opacity = 0
	},
/turf/open/void/vehicle,
/area/space)
"ap" = (
/obj/structure/interior_wall/apc{
	icon_state = "front_4"
	},
/turf/open/void/vehicle,
/area/space)
"aq" = (
/obj/structure/interior_wall/apc{
	icon_state = "front_3"
	},
/turf/open/void/vehicle,
/area/space)
"ar" = (
/obj/structure/interior_wall/apc{
	icon_state = "corner_inverse_L";
	opacity = 0
	},
/turf/open/void/vehicle,
/area/space)
"at" = (
/obj/structure/interior_wall/apc{
	icon_state = "rear_3"
	},
/turf/open/void/vehicle,
/area/space)
"ax" = (
/obj/effect/landmark/interior/spawn/vehicle_support_gunner_seat/second,
/obj/structure/prop/vehicle/firing_port_weapon{
	layer = 4.1;
	name = "Right M56 FPW handle";
	pixel_y = 2
	},
/turf/open/shuttle/vehicle/floor_3_12,
/area/interior/vehicle/apc)
"ay" = (
/obj/structure/interior_wall/apc{
	icon_state = "front_6"
	},
/turf/open/void/vehicle,
/area/space)
"aB" = (
/obj/structure/interior_wall/apc{
	icon_state = "corner_inverse_R";
	opacity = 0
	},
/turf/open/void/vehicle,
/area/space)
"aD" = (
/obj/structure/interior_wall/apc{
	icon_state = "wall";
	opacity = 0
	},
/turf/open/void/vehicle,
/area/space)
"aE" = (
/obj/structure/interior_wall/apc{
	icon_state = "corner_small_R";
	opacity = 0
	},
/obj/structure/interior_wall/apc{
	icon_state = "wheel_front_top_2";
	pixel_x = 4;
	pixel_y = -4
	},
/turf/open/void/vehicle,
/area/space)
"aG" = (
/obj/effect/landmark/interior/spawn/entrance{
	alpha = 50;
	exit_type = /obj/structure/interior_exit/vehicle/apc;
	name = "Right APC door";
	tag = "right"
	},
/obj/effect/landmark/interior/spawn/interior_viewport{
	dir = 8;
	pixel_x = 5;
	pixel_y = 1
	},
/turf/open/shuttle/vehicle/floor_1_12,
/area/interior/vehicle/apc)
"aJ" = (
/obj/structure/interior_wall/apc{
	icon_state = "corner_small_L";
	opacity = 0
	},
/obj/structure/interior_wall/apc{
	icon_state = "wheel_back_top_2";
	pixel_x = -4;
	pixel_y = -4
	},
/turf/open/void/vehicle,
/area/space)
"aL" = (
/obj/structure/interior_wall/apc{
	icon_state = "corner_small_L"
	},
/obj/structure/interior_wall/apc{
	icon_state = "rear_5"
	},
/turf/open/void/vehicle,
/area/space)
"aM" = (
/obj/structure/interior_wall/apc{
	icon_state = "front_1"
	},
/turf/open/void/vehicle,
/area/space)
"aN" = (
/obj/structure/interior_wall/apc{
	icon_state = "wheel_front_top_1";
	pixel_x = 1;
	pixel_y = -4
	},
/turf/open/void/vehicle,
/area/space)
"aO" = (
/obj/structure/interior_wall/apc{
	icon_state = "door_back"
	},
/turf/open/void/vehicle,
/area/space)
"aP" = (
/obj/structure/interior_wall/apc{
	icon_state = "rear_6"
	},
/turf/open/void/vehicle,
/area/space)
"aQ" = (
/obj/effect/landmark/interior/spawn/entrance{
	dir = 8;
	exit_type = /obj/structure/interior_exit/vehicle/apc/rear/right;
	pixel_x = -32;
	tag = "rear right"
	},
/obj/structure/bed/chair/vehicle{
	dir = 1;
	pixel_x = -8
	},
/obj/structure/bed/chair/vehicle{
	dir = 1;
	pixel_x = 8
	},
/turf/open/shuttle/vehicle/floor_3_13,
/area/interior/vehicle/apc)
"aS" = (
/obj/structure/interior_wall/apc{
	alpha = 100;
	icon_state = "door_front";
	layer = 5.2;
	pixel_y = 32
	},
/turf/open/void/vehicle,
/area/space)
"aT" = (
/obj/structure/interior_wall/apc{
	icon_state = "wheel_back_top_1";
	pixel_x = -4;
	pixel_y = -4
	},
/turf/open/void/vehicle,
/area/space)
"aV" = (
/obj/structure/interior_wall/apc{
	icon_state = "wall"
	},
/turf/open/void/vehicle,
/area/space)
"aX" = (
/obj/structure/interior_wall/apc{
	icon_state = "front_wheel_R"
	},
/turf/open/void/vehicle,
/area/space)
"aZ" = (
/obj/structure/interior_wall/apc{
	icon_state = "rear_4"
	},
/turf/open/void/vehicle,
/area/space)
"cS" = (
/obj/structure/vehicle_locker{
	layer = 5.21;
	pixel_y = 28
	},
/obj/structure/bed/chair/vehicle{
	pixel_x = -8
	},
/obj/structure/bed/chair/vehicle{
	pixel_x = 8
	},
/turf/open/shuttle/vehicle/floor_3_8_1,
/area/interior/vehicle/apc)
"dq" = (
/turf/open/shuttle/vehicle/floor_1_14,
/area/interior/vehicle/apc)
"eX" = (
/obj/effect/landmark/interior/spawn/entrance{
	dir = 8;
	exit_type = /obj/structure/interior_exit/vehicle/apc/rear/left;
	pixel_x = -32;
	tag = "rear left"
	},
/obj/structure/bed/chair/vehicle{
	pixel_x = -8
	},
/obj/structure/bed/chair/vehicle{
	pixel_x = 8
	},
/obj/effect/landmark/interior/spawn/interior_viewport{
	pixel_x = -7;
	pixel_y = 23
	},
/turf/open/shuttle/vehicle/floor_3_13,
/area/interior/vehicle/apc)
"oZ" = (
/obj/structure/bed/chair/vehicle{
	dir = 1;
	pixel_x = 8
	},
/obj/structure/bed/chair/vehicle{
	dir = 1;
	pixel_x = -8
	},
/turf/open/shuttle/vehicle/floor_3_8_1,
/area/interior/vehicle/apc)
"pA" = (
/obj/effect/landmark/interior/spawn/entrance{
	alpha = 50;
	dir = 1;
	exit_type = /obj/structure/interior_exit/vehicle/apc;
	name = "Left APC door";
	pixel_y = 32;
	tag = "left"
	},
/obj/effect/landmark/interior/spawn/interior_viewport{
	dir = 8;
	pixel_x = 5;
	pixel_y = 8
	},
/turf/open/shuttle/vehicle/floor_1_11,
/area/interior/vehicle/apc)
"uP" = (
/obj/structure/bed/chair/vehicle{
	dir = 1;
	pixel_x = -8
	},
/obj/structure/bed/chair/vehicle{
	dir = 1;
	pixel_x = 8
	},
/obj/effect/landmark/interior/spawn/interior_viewport{
	dir = 1;
	pixel_x = 8;
	pixel_y = -11
	},
/turf/open/shuttle/vehicle/floor_3_5,
/area/interior/vehicle/apc)
"uT" = (
/obj/structure/bed/chair/vehicle{
	pixel_x = -8
	},
/obj/structure/bed/chair/vehicle{
	pixel_x = 8
	},
/obj/effect/landmark/interior/spawn/telephone{
	pixel_x = 5;
	pixel_y = 30
	},
/obj/structure/extinguisher_cabinet/lifeboat{
	icon = 'icons/obj/vehicles/interiors/general.dmi';
	pixel_x = -8;
	pixel_y = 28
	},
/turf/open/shuttle/vehicle/floor_3_13,
/area/interior/vehicle/apc)
"vv" = (
/obj/structure/bed/chair/vehicle{
	pixel_x = 8
	},
/obj/structure/bed/chair/vehicle{
	pixel_x = -8
	},
/obj/effect/landmark/interior/spawn/interior_camera{
	dir = 10;
	pixel_x = -14;
	pixel_y = 38
	},
/turf/open/shuttle/vehicle/floor_3_9_1,
/area/interior/vehicle/apc)
"xd" = (
/obj/structure/bed/chair/vehicle{
	dir = 1;
	pixel_x = 8
	},
/obj/structure/bed/chair/vehicle{
	dir = 1;
	pixel_x = -8
	},
/turf/open/shuttle/vehicle/floor_3_13,
/area/interior/vehicle/apc)
"JD" = (
/turf/open/shuttle/vehicle/floor_1_5,
/area/interior/vehicle/apc)
"Nn" = (
/obj/effect/landmark/interior/spawn/entrance{
	dir = 8;
	exit_type = /obj/structure/interior_exit/vehicle/apc/rear;
	pixel_x = -32;
	tag = "rear center"
	},
/turf/open/shuttle/vehicle/floor_1_13,
/area/interior/vehicle/apc)
"Ns" = (
/turf/open/shuttle/vehicle/floor_0_1_15,
/area/interior/vehicle/apc)
"QS" = (
/obj/structure/machinery/cm_vending/sorted/vehicle_supply{
	pixel_y = 20
	},
/obj/structure/machinery/cm_vending/sorted/medical/wall_med/vehicle{
	pixel_x = -24;
	pixel_y = 28
	},
/turf/open/shuttle/vehicle/floor_1_11,
/area/interior/vehicle/apc)
"QZ" = (
/turf/open/shuttle/vehicle/floor_1_6,
/area/interior/vehicle/apc)
"Sq" = (
/obj/effect/landmark/interior/spawn/vehicle_driver_seat/armor{
	dir = 4
	},
/turf/open/shuttle/vehicle/floor_3_9_1,
/area/interior/vehicle/apc)
"SV" = (
/turf/open/shuttle/vehicle/floor_1_1_3,
/area/interior/vehicle/apc)
"Xl" = (
/obj/effect/landmark/interior/spawn/vehicle_support_gunner_seat{
	dir = 1
	},
/obj/structure/prop/vehicle/firing_port_weapon{
	dir = 1;
	name = "Left M56 FPW handle";
	pixel_y = 17
	},
/turf/open/shuttle/vehicle/floor_3_11,
/area/interior/vehicle/apc)
"Yh" = (
/obj/effect/landmark/interior/spawn/weapons_loader,
/turf/open/shuttle/vehicle/floor_3_6,
/area/interior/vehicle/apc)

(1,1,1) = {"
aP
aL
aZ
at
aa
ae
aj
"}
(2,1,1) = {"
aT
aD
eX
Nn
aQ
ak
aj
"}
(3,1,1) = {"
aJ
ar
QS
SV
uP
ah
aj
"}
(4,1,1) = {"
aV
Xl
vv
JD
oZ
ax
al
"}
(5,1,1) = {"
aO
pA
QZ
Ns
QZ
aG
aS
"}
(6,1,1) = {"
aE
aB
uT
dq
xd
ao
aj
"}
(7,1,1) = {"
aN
aD
cS
Yh
Sq
aX
aj
"}
(8,1,1) = {"
ay
ag
ap
aq
an
aM
aj
"}
