//MAP CONVERTED BY dmm2tgm.py THIS HEADER COMMENT PREVENTS RECONVERSION, DO NOT REMOVE
"a" = (
/obj/structure/interior_wall/apc{
	icon_state = "rear_6"
	},
/turf/open/void/vehicle,
/area/space)
"b" = (
/obj/structure/interior_wall/apc{
	icon_state = "wall";
	pixel_y = -12;
	opacity = 0
	},
/obj/structure/interior_wall/apc{
	icon_state = "wheel_front_top_2";
	pixel_x = -4;
	pixel_y = -5;
	layer = 2.01
	},
/turf/open/void/vehicle,
/area/space)
"c" = (
/obj/structure/prop/vehicle/sensor_equipment{
	name = "Sensor Apparatus Nexus";
	desc = "This machinery collects and analyzes data from the M579 ADS-C's sensors cluster and then feeds the results to the onboard gunner station. Better not touch it.";
	density = 1
	},
/obj/structure/vehicle_locker/movie{
	pixel_y = 19;
	layer = 2.9
	},
/turf/open/shuttle/vehicle/floor_3_10_1,
/area/interior/vehicle/apc/movie/aa)
"d" = (
/obj/structure/bed/chair/vehicle{
	dir = 1;
	pixel_x = -8
	},
/obj/structure/bed/chair/vehicle{
	dir = 1;
	pixel_x = 8
	},
/obj/effect/landmark/interior/spawn/interior_viewport{
	dir = 1;
	pixel_x = 2;
	pixel_y = -13
	},
/turf/open/shuttle/vehicle/floor_2,
/area/interior/vehicle/apc/movie/aa)
"e" = (
/obj/structure/interior_wall/apc{
	icon_state = "wheel_front_top_2";
	pixel_x = 4;
	pixel_y = -5;
	layer = 2.01
	},
/turf/open/void/vehicle,
/area/space)
"f" = (
/obj/structure/interior_wall/apc{
	icon_state = "wheel_front_top_1";
	pixel_x = 1;
	pixel_y = -5;
	layer = 2.01
	},
/turf/open/void/vehicle,
/area/space)
"g" = (
/obj/structure/interior_wall/apc{
	icon_state = "front_1"
	},
/turf/open/void/vehicle,
/area/space)
"h" = (
/obj/effect/landmark/interior/spawn/weapons_loader{
	pixel_y = -11;
	layer = 4
	},
/turf/open/shuttle/vehicle/floor_2,
/area/interior/vehicle/apc/movie/aa)
"j" = (
/obj/structure/interior_wall/apc{
	icon_state = "aa_back_1";
	layer = 5.2;
	pixel_x = -2
	},
/turf/open/space/basic,
/area/space)
"l" = (
/obj/structure/surface/table/reinforced/toc/west{
	pixel_y = -7
	},
/obj/effect/landmark/interior/spawn/interior_viewport/terminal{
	pixel_y = 12
	},
/turf/open/shuttle/vehicle/floor_1_4,
/area/interior/vehicle/apc/movie/aa)
"o" = (
/obj/structure/interior_wall/apc{
	icon_state = "rear_1"
	},
/turf/open/void/vehicle,
/area/space)
"p" = (
/obj/structure/interior_wall/apc{
	icon_state = "wall_2";
	opacity = 0
	},
/turf/open/space/basic,
/area/space)
"q" = (
/obj/structure/interior_wall/apc{
	icon_state = "front_wheel_L_1"
	},
/turf/open/space/basic,
/area/space)
"r" = (
/obj/structure/interior_wall/apc{
	icon_state = "rear_wheel_R_aa";
	layer = 5.2
	},
/turf/open/space/basic,
/area/space)
"t" = (
/obj/structure/interior_wall/apc{
	icon_state = "aa_back_2";
	layer = 5.2;
	pixel_x = -12
	},
/obj/structure/interior_wall/apc{
	icon_state = "aa_back_3";
	layer = 5.2
	},
/turf/open/space/basic,
/area/space)
"v" = (
/obj/effect/landmark/interior/spawn/vehicle_gunner_seat/armor{
	can_buckle = 1;
	dir = 1;
	pixel_x = 4;
	pixel_y = 16
	},
/turf/open/shuttle/vehicle/floor_1_4,
/area/interior/vehicle/apc/movie/aa)
"w" = (
/obj/effect/landmark/interior/spawn/interior_camera{
	dir = 5;
	pixel_x = -18;
	pixel_y = 38
	},
/obj/structure/vehicle_locker/movie{
	pixel_y = 11;
	layer = 2.9
	},
/obj/structure/gun_rack/apc/frontal/aa{
	pixel_y = 1;
	pixel_x = 8;
	density = 0
	},
/obj/structure/gun_rack/apc/boyars/aa{
	pixel_x = -8;
	pixel_y = 1;
	density = 0
	},
/turf/open/shuttle/vehicle/floor_2,
/area/interior/vehicle/apc/movie/aa)
"x" = (
/obj/structure/interior_wall/apc{
	icon_state = "wall";
	opacity = 0;
	pixel_y = -12
	},
/obj/structure/interior_wall/apc{
	icon_state = "wheel_front_top_2";
	pixel_x = 10;
	pixel_y = -5;
	layer = 2.01
	},
/obj/structure/interior_wall/apc{
	icon_state = "wheel_front_top_2";
	pixel_x = -18;
	pixel_y = -5;
	layer = 2.01
	},
/turf/open/void/vehicle,
/area/space)
"y" = (
/obj/structure/interior_wall/apc{
	icon_state = "front_5"
	},
/turf/open/void/vehicle,
/area/space)
"z" = (
/obj/effect/landmark/interior/spawn/entrance{
	alpha = 50;
	exit_type = /obj/structure/interior_exit/vehicle/apc;
	name = "Right APC door";
	tag = "right rear"
	},
/turf/open/shuttle/vehicle/floor_1_3,
/area/interior/vehicle/apc/movie/aa)
"A" = (
/obj/structure/bed/chair/vehicle{
	dir = 1;
	pixel_x = 8
	},
/obj/structure/bed/chair/vehicle{
	dir = 1;
	pixel_x = -8
	},
/turf/open/shuttle/vehicle/floor_2,
/area/interior/vehicle/apc/movie/aa)
"B" = (
/turf/open/shuttle/vehicle/floor_1_3,
/area/interior/vehicle/apc/movie/aa)
"C" = (
/obj/structure/interior_wall/apc{
	icon_state = "door_big_right";
	layer = 5.2;
	pixel_y = 32;
	alpha = 100
	},
/turf/open/void/vehicle,
/area/space)
"D" = (
/obj/structure/interior_wall/apc{
	icon_state = "rear_5"
	},
/turf/open/void/vehicle,
/area/space)
"E" = (
/turf/open/void/vehicle,
/area/space)
"G" = (
/obj/structure/machinery/cm_vending/sorted/medical/wall_med/vehicle{
	pixel_y = 30;
	pixel_x = -6
	},
/obj/structure/extinguisher_cabinet/lifeboat{
	icon = 'icons/obj/vehicles/interiors/general.dmi';
	pixel_y = 30;
	pixel_x = 8
	},
/turf/open/shuttle/vehicle/floor_2,
/area/interior/vehicle/apc/movie/aa)
"H" = (
/obj/structure/interior_wall/apc{
	icon_state = "corner_inverse_R";
	opacity = 0
	},
/turf/open/space/basic,
/area/space)
"I" = (
/obj/structure/interior_wall/apc{
	icon_state = "front_3"
	},
/obj/structure/interior_wall/apc{
	icon_state = "front_4";
	pixel_y = 12
	},
/turf/open/void/vehicle,
/area/space)
"J" = (
/obj/structure/interior_wall/apc{
	icon_state = "wheel_front_top_2";
	pixel_x = 4;
	pixel_y = 1;
	layer = 2.01;
	opacity = 0
	},
/obj/structure/interior_wall/apc{
	icon_state = "corner_smaller_R";
	opacity = 0;
	pixel_y = 12
	},
/obj/structure/interior_wall/apc{
	icon_state = "corner_smaller_L";
	opacity = 0;
	pixel_y = 12
	},
/obj/structure/interior_wall/apc{
	icon_state = "intersection_2";
	opacity = 0;
	pixel_y = -20
	},
/turf/open/shuttle/vehicle,
/area/space)
"K" = (
/obj/structure/interior_wall/apc{
	icon_state = "corner_smaller_L";
	opacity = 0
	},
/obj/structure/interior_wall/apc{
	icon_state = "wheel_back_top_2";
	pixel_x = -4;
	pixel_y = -4
	},
/turf/open/void/vehicle,
/area/space)
"L" = (
/obj/structure/interior_wall/apc{
	icon_state = "rear_wheel_L"
	},
/turf/open/space/basic,
/area/space)
"M" = (
/obj/structure/interior_wall/apc{
	icon_state = "rear_3"
	},
/turf/open/void/vehicle,
/area/space)
"N" = (
/turf/open/shuttle/vehicle/floor_1_4,
/area/interior/vehicle/apc/movie/aa)
"O" = (
/obj/structure/interior_wall/apc{
	icon_state = "front_2";
	pixel_y = 7
	},
/obj/structure/interior_wall/apc{
	icon_state = "front_2";
	pixel_y = -2;
	layer = 2.01
	},
/turf/open/void/vehicle,
/area/space)
"Q" = (
/obj/structure/interior_wall/apc{
	icon_state = "door_big_left";
	pixel_y = 32;
	layer = 5.2;
	alpha = 100
	},
/turf/open/void/vehicle,
/area/space)
"R" = (
/obj/structure/interior_wall/apc{
	icon_state = "wall_wheelside"
	},
/turf/open/space/basic,
/area/space)
"S" = (
/obj/structure/interior_wall/apc{
	icon_state = "front_6";
	pixel_y = -1
	},
/turf/open/void/vehicle,
/area/space)
"T" = (
/obj/effect/landmark/interior/spawn/entrance{
	alpha = 50;
	exit_type = /obj/structure/interior_exit/vehicle/apc;
	name = "Right APC door";
	tag = "right front"
	},
/turf/open/shuttle/vehicle/floor_1_4,
/area/interior/vehicle/apc/movie/aa)
"U" = (
/obj/structure/interior_wall/apc{
	icon_state = "front_wheel_R";
	layer = 4.1
	},
/turf/open/space/basic,
/area/space)
"V" = (
/obj/structure/interior_wall/apc{
	icon_state = "wheel_back_top_1";
	pixel_x = -4;
	pixel_y = -4
	},
/turf/open/void/vehicle,
/area/space)
"W" = (
/obj/effect/landmark/interior/spawn/interior_viewport{
	dir = 8;
	pixel_x = 5;
	pixel_y = 18
	},
/obj/effect/landmark/interior/spawn/vehicle_driver_seat/armor/movie{
	dir = 4;
	buckling_y = 16;
	pixel_y = 16
	},
/turf/open/shuttle/vehicle/floor_2,
/area/interior/vehicle/apc/movie/aa)
"Y" = (
/obj/structure/interior_wall/apc{
	icon_state = "rear_2"
	},
/turf/open/void/vehicle,
/area/space)
"Z" = (
/obj/structure/interior_wall/apc{
	icon_state = "corner_smaller_R";
	opacity = 0
	},
/obj/structure/interior_wall/apc{
	icon_state = "wheel_front_top_2";
	pixel_x = 4;
	pixel_y = -5;
	layer = 2.01
	},
/obj/structure/interior_wall/apc{
	icon_state = "wheel_front_top_2";
	pixel_x = 8;
	pixel_y = -5;
	layer = 2.01
	},
/turf/open/void/vehicle,
/area/space)

(1,1,1) = {"
a
D
M
Y
o
E
"}
(2,1,1) = {"
V
j
j
j
L
E
"}
(3,1,1) = {"
K
t
t
t
r
E
"}
(4,1,1) = {"
b
c
B
B
z
Q
"}
(5,1,1) = {"
x
l
v
N
T
C
"}
(6,1,1) = {"
Z
H
G
d
R
E
"}
(7,1,1) = {"
e
J
w
A
q
E
"}
(8,1,1) = {"
f
p
W
h
U
E
"}
(9,1,1) = {"
S
I
O
y
g
E
"}
