//MAP CONVERTED BY dmm2tgm.py THIS HEADER COMMENT PREVENTS RECONVERSION, DO NOT REMOVE
"aa" = (
/turf/open/void/vehicle,
/area/space)
"af" = (
/obj/structure/interior_wall/apc{
	icon_state = "front_2"
	},
/turf/open/void/vehicle,
/area/space)
"ag" = (
/obj/structure/interior_wall/apc{
	icon_state = "front_6"
	},
/turf/open/void/vehicle,
/area/space)
"ah" = (
/obj/structure/interior_wall/apc{
	icon_state = "front_3"
	},
/turf/open/void/vehicle,
/area/space)
"ak" = (
/obj/structure/interior_wall/apc{
	icon_state = "wall";
	opacity = 0
	},
/turf/open/void/vehicle,
/area/space)
"am" = (
/obj/structure/interior_wall/apc{
	icon_state = "front_1"
	},
/turf/open/void/vehicle,
/area/space)
"an" = (
/obj/structure/interior_wall/apc{
	icon_state = "wall"
	},
/turf/open/void/vehicle,
/area/space)
"ao" = (
/obj/structure/interior_wall/apc{
	icon_state = "rear_4"
	},
/turf/open/void/vehicle,
/area/space)
"aq" = (
/obj/structure/bed/chair/vehicle{
	dir = 4
	},
/turf/open/shuttle/vehicle/floor_3_12,
/area/interior/vehicle/apc)
"as" = (
/obj/structure/interior_wall/apc{
	icon_state = "rear_2"
	},
/turf/open/void/vehicle,
/area/space)
"au" = (
/obj/structure/interior_wall/apc{
	icon_state = "wheel_front_top_1";
	pixel_x = 1;
	pixel_y = -4
	},
/turf/open/void/vehicle,
/area/space)
"av" = (
/obj/structure/interior_wall/apc{
	alpha = 100;
	icon_state = "door_front";
	layer = 5.2;
	pixel_y = 32
	},
/turf/open/void/vehicle,
/area/space)
"aw" = (
/obj/structure/interior_wall/apc{
	icon_state = "rear_3"
	},
/turf/open/void/vehicle,
/area/space)
"ax" = (
/obj/effect/landmark/interior/spawn/entrance{
	alpha = 50;
	exit_type = /obj/structure/interior_exit/vehicle/apc;
	tag = "right"
	},
/obj/effect/landmark/interior/spawn/interior_viewport{
	dir = 8;
	pixel_x = 5;
	pixel_y = 1
	},
/turf/open/shuttle/vehicle/floor_1_12,
/area/interior/vehicle/apc)
"aA" = (
/obj/structure/interior_wall/apc{
	icon_state = "wheel_back_top_1";
	pixel_x = -4;
	pixel_y = -4
	},
/turf/open/void/vehicle,
/area/space)
"aD" = (
/obj/structure/interior_wall/apc{
	icon_state = "rear_wheel_L"
	},
/turf/open/void/vehicle,
/area/space)
"aF" = (
/obj/structure/interior_wall/apc{
	icon_state = "corner_small_R";
	opacity = 0
	},
/obj/structure/interior_wall/apc{
	icon_state = "wheel_front_top_2";
	pixel_x = 4;
	pixel_y = -4
	},
/turf/open/void/vehicle,
/area/space)
"aG" = (
/obj/structure/interior_wall/apc{
	icon_state = "rear_6"
	},
/turf/open/void/vehicle,
/area/space)
"aH" = (
/obj/structure/interior_wall/apc{
	icon_state = "corner_small_R"
	},
/obj/structure/interior_wall/apc{
	icon_state = "front_5"
	},
/turf/open/void/vehicle,
/area/space)
"aJ" = (
/obj/structure/interior_wall/apc{
	icon_state = "corner_inverse_R";
	opacity = 0
	},
/turf/open/void/vehicle,
/area/space)
"aK" = (
/obj/structure/interior_wall/apc{
	icon_state = "corner_small_L";
	opacity = 0
	},
/obj/structure/interior_wall/apc{
	icon_state = "wheel_back_top_2";
	pixel_x = -4;
	pixel_y = -4
	},
/turf/open/void/vehicle,
/area/space)
"aM" = (
/obj/structure/interior_wall/apc{
	icon_state = "front_wheel_L";
	opacity = 0
	},
/turf/open/void/vehicle,
/area/space)
"aN" = (
/obj/structure/interior_wall/apc{
	icon_state = "door_back"
	},
/turf/open/void/vehicle,
/area/space)
"aP" = (
/obj/structure/interior_wall/apc{
	icon_state = "corner_small_L"
	},
/obj/structure/interior_wall/apc{
	icon_state = "rear_5"
	},
/turf/open/void/vehicle,
/area/space)
"aQ" = (
/obj/structure/interior_wall/apc{
	icon_state = "front_wheel_R"
	},
/turf/open/void/vehicle,
/area/space)
"aR" = (
/obj/structure/interior_wall/apc{
	alpha = 100;
	icon_state = "wall_door_front";
	layer = 5.2;
	pixel_y = 32
	},
/turf/open/void/vehicle,
/area/space)
"aS" = (
/obj/structure/interior_wall/apc{
	icon_state = "corner_inverse_L";
	opacity = 0
	},
/turf/open/void/vehicle,
/area/space)
"aT" = (
/obj/structure/interior_wall/apc{
	icon_state = "front_4"
	},
/turf/open/void/vehicle,
/area/space)
"aV" = (
/obj/structure/interior_wall/apc{
	icon_state = "rear_1"
	},
/turf/open/void/vehicle,
/area/space)
"aX" = (
/obj/structure/interior_wall/apc{
	icon_state = "wall_2";
	opacity = 0
	},
/turf/open/void/vehicle,
/area/space)
"aY" = (
/obj/structure/interior_wall/apc{
	icon_state = "rear_wheel_R";
	opacity = 0
	},
/turf/open/void/vehicle,
/area/space)
"dP" = (
/obj/structure/bed/chair/vehicle{
	dir = 4
	},
/turf/open/shuttle/vehicle/floor_3_11,
/area/interior/vehicle/apc)
"hz" = (
/obj/structure/bed/chair/vehicle{
	pixel_x = 8
	},
/obj/structure/bed/chair/vehicle{
	pixel_x = -8
	},
/obj/effect/landmark/interior/spawn/interior_camera{
	dir = 10;
	pixel_x = -14;
	pixel_y = 38
	},
/turf/open/shuttle/vehicle/floor_3_9_1,
/area/interior/vehicle/apc)
"lj" = (
/obj/structure/machinery/cm_vending/sorted/vehicle_supply{
	pixel_y = 20
	},
/obj/structure/machinery/cm_vending/sorted/medical/wall_med/vehicle{
	pixel_x = -24;
	pixel_y = 28
	},
/turf/open/shuttle/vehicle/floor_1_11,
/area/interior/vehicle/apc)
"vg" = (
/turf/open/shuttle/vehicle/floor_1_1_3,
/area/interior/vehicle/apc)
"CB" = (
/obj/effect/landmark/interior/spawn/vehicle_driver_seat/armor{
	dir = 4
	},
/turf/open/shuttle/vehicle/floor_3_9_1,
/area/interior/vehicle/apc)
"CJ" = (
/obj/effect/landmark/interior/spawn/interior_viewport{
	dir = 8;
	pixel_x = 5;
	pixel_y = 8
	},
/obj/effect/landmark/interior/spawn/entrance{
	alpha = 50;
	dir = 1;
	exit_type = /obj/structure/interior_exit/vehicle/apc;
	name = "Left APC door";
	pixel_y = 32;
	tag = "left"
	},
/turf/open/shuttle/vehicle/floor_1_11,
/area/interior/vehicle/apc)
"Dn" = (
/obj/structure/bed/chair/vehicle{
	dir = 1;
	pixel_x = 8
	},
/obj/structure/bed/chair/vehicle{
	dir = 1;
	pixel_x = -8
	},
/turf/open/shuttle/vehicle/floor_3_8_1,
/area/interior/vehicle/apc)
"Dy" = (
/obj/structure/bed/chair/vehicle{
	dir = 1;
	pixel_x = -8
	},
/obj/structure/bed/chair/vehicle{
	dir = 1;
	pixel_x = 8
	},
/obj/effect/landmark/interior/spawn/interior_viewport{
	dir = 1;
	pixel_x = 8;
	pixel_y = -11
	},
/turf/open/shuttle/vehicle/floor_3_5,
/area/interior/vehicle/apc)
"DT" = (
/turf/open/shuttle/vehicle/floor_1_5,
/area/interior/vehicle/apc)
"Ed" = (
/obj/effect/landmark/interior/spawn/weapons_loader,
/turf/open/shuttle/vehicle/floor_3_6,
/area/interior/vehicle/apc)
"EA" = (
/obj/effect/landmark/interior/spawn/entrance{
	dir = 8;
	exit_type = /obj/structure/interior_exit/vehicle/apc/rear/right;
	pixel_x = -32;
	tag = "rear right"
	},
/obj/structure/bed/chair/vehicle{
	dir = 1;
	pixel_x = -8
	},
/obj/structure/bed/chair/vehicle{
	dir = 1;
	pixel_x = 8
	},
/turf/open/shuttle/vehicle/floor_3_13,
/area/interior/vehicle/apc)
"EZ" = (
/obj/effect/landmark/interior/spawn/entrance{
	dir = 8;
	exit_type = /obj/structure/interior_exit/vehicle/apc/rear/left;
	pixel_x = -32;
	tag = "rear left"
	},
/obj/structure/bed/chair/vehicle{
	pixel_x = -8
	},
/obj/structure/bed/chair/vehicle{
	pixel_x = 8
	},
/obj/effect/landmark/interior/spawn/interior_viewport{
	pixel_x = -7;
	pixel_y = 23
	},
/turf/open/shuttle/vehicle/floor_3_13,
/area/interior/vehicle/apc)
"Fg" = (
/turf/open/shuttle/vehicle/floor_1_14,
/area/interior/vehicle/apc)
"Hj" = (
/obj/structure/bed/chair/vehicle{
	dir = 1;
	pixel_x = 8
	},
/obj/structure/bed/chair/vehicle{
	dir = 1;
	pixel_x = -8
	},
/turf/open/shuttle/vehicle/floor_3_13,
/area/interior/vehicle/apc)
"Nl" = (
/obj/structure/bed/chair/vehicle{
	pixel_x = -8
	},
/obj/structure/bed/chair/vehicle{
	pixel_x = 8
	},
/obj/effect/landmark/interior/spawn/telephone{
	pixel_x = 5;
	pixel_y = 30
	},
/obj/structure/extinguisher_cabinet/lifeboat{
	icon = 'icons/obj/vehicles/interiors/general.dmi';
	pixel_x = -8;
	pixel_y = 28
	},
/turf/open/shuttle/vehicle/floor_3_13,
/area/interior/vehicle/apc)
"NY" = (
/turf/open/shuttle/vehicle/floor_1_6,
/area/interior/vehicle/apc)
"TJ" = (
/turf/open/shuttle/vehicle/floor_0_1_15,
/area/interior/vehicle/apc)
"Yz" = (
/obj/structure/vehicle_locker{
	layer = 5.21;
	pixel_y = 28
	},
/obj/structure/bed/chair/vehicle{
	pixel_x = -8
	},
/obj/structure/bed/chair/vehicle{
	pixel_x = 8
	},
/turf/open/shuttle/vehicle/floor_3_8_1,
/area/interior/vehicle/apc)
"Zl" = (
/obj/effect/landmark/interior/spawn/entrance{
	dir = 8;
	exit_type = /obj/structure/interior_exit/vehicle/apc/rear;
	pixel_x = -32;
	tag = "rear center"
	},
/turf/open/shuttle/vehicle/floor_1_13,
/area/interior/vehicle/apc)

(1,1,1) = {"
aG
aP
ao
aw
as
aV
aa
"}
(2,1,1) = {"
aA
aX
EZ
Zl
EA
aD
aa
"}
(3,1,1) = {"
aK
aS
lj
vg
Dy
aY
aa
"}
(4,1,1) = {"
an
dP
hz
DT
Dn
aq
aR
"}
(5,1,1) = {"
aN
CJ
NY
TJ
NY
ax
av
"}
(6,1,1) = {"
aF
aJ
Nl
Fg
Hj
aM
aa
"}
(7,1,1) = {"
au
ak
Yz
Ed
CB
aQ
aa
"}
(8,1,1) = {"
ag
aH
aT
ah
af
am
aa
"}
