//MAP CONVERTED BY dmm2tgm.py THIS HEADER COMMENT PREVENTS RECONVERSION, DO NOT REMOVE
"aa" = (
/obj/structure/interior_wall/apc{
	icon_state = "rear_2"
	},
/turf/open/void/vehicle,
/area/space)
"ae" = (
/obj/structure/interior_wall/apc{
	icon_state = "rear_1"
	},
/turf/open/void/vehicle,
/area/space)
"af" = (
/obj/structure/interior_wall/apc{
	icon_state = "rear_wheel_L"
	},
/turf/open/void/vehicle,
/area/space)
"ag" = (
/obj/structure/interior_wall/apc{
	icon_state = "rear_wheel_R";
	opacity = 0
	},
/turf/open/void/vehicle,
/area/space)
"ai" = (
/obj/effect/landmark/interior/spawn/entrance{
	alpha = 50;
	exit_type = /obj/structure/interior_exit/vehicle/apc;
	name = "Right APC door";
	tag = "right"
	},
/obj/effect/landmark/interior/spawn/interior_viewport{
	dir = 8;
	pixel_x = 5;
	pixel_y = 1
	},
/turf/open/shuttle/vehicle/floor_1_12,
/area/interior/vehicle/apc/med)
"aj" = (
/obj/structure/interior_wall/apc{
	icon_state = "rear_6"
	},
/turf/open/void/vehicle,
/area/space)
"ak" = (
/turf/open/void/vehicle,
/area/space)
"al" = (
/obj/structure/interior_wall/apc{
	alpha = 100;
	icon_state = "wall_door_front";
	layer = 5.2;
	pixel_y = 32
	},
/turf/open/void/vehicle,
/area/space)
"an" = (
/obj/structure/interior_wall/apc{
	icon_state = "wheel_back_top_1";
	pixel_x = -4;
	pixel_y = -4
	},
/turf/open/void/vehicle,
/area/space)
"ao" = (
/obj/structure/surface/table/reinforced/prison,
/obj/structure/machinery/recharger{
	pixel_x = -5
	},
/obj/item/device/defibrillator,
/turf/open/shuttle/vehicle/dark_sterile_green_11,
/area/interior/vehicle/apc/med)
"ap" = (
/obj/structure/interior_wall/apc{
	icon_state = "wall"
	},
/turf/open/void/vehicle,
/area/space)
"aq" = (
/obj/structure/interior_wall/apc{
	icon_state = "corner_small_R";
	opacity = 0
	},
/obj/structure/interior_wall/apc{
	icon_state = "wheel_front_top_2";
	pixel_x = 4;
	pixel_y = -4
	},
/turf/open/void/vehicle,
/area/space)
"ar" = (
/obj/structure/interior_wall/apc{
	icon_state = "corner_small_R"
	},
/obj/structure/interior_wall/apc{
	icon_state = "front_5"
	},
/turf/open/void/vehicle,
/area/space)
"as" = (
/obj/structure/interior_wall/apc{
	icon_state = "front_6"
	},
/turf/open/void/vehicle,
/area/space)
"at" = (
/obj/structure/interior_wall/apc{
	icon_state = "rear_3"
	},
/turf/open/void/vehicle,
/area/space)
"au" = (
/obj/structure/interior_wall/apc{
	icon_state = "corner_small_L";
	opacity = 0
	},
/obj/structure/interior_wall/apc{
	icon_state = "wheel_back_top_2";
	pixel_x = -4;
	pixel_y = -4
	},
/turf/open/void/vehicle,
/area/space)
"av" = (
/obj/structure/interior_wall/apc{
	icon_state = "front_3"
	},
/turf/open/void/vehicle,
/area/space)
"ax" = (
/obj/structure/interior_wall/apc{
	icon_state = "wall";
	opacity = 0
	},
/turf/open/void/vehicle,
/area/space)
"az" = (
/obj/structure/interior_wall/apc{
	icon_state = "wheel_front_top_1";
	pixel_x = 1;
	pixel_y = -4
	},
/turf/open/void/vehicle,
/area/space)
"aC" = (
/obj/structure/interior_wall/apc{
	icon_state = "front_wheel_L";
	opacity = 0
	},
/turf/open/void/vehicle,
/area/space)
"aF" = (
/obj/structure/interior_wall/apc{
	icon_state = "front_2"
	},
/turf/open/void/vehicle,
/area/space)
"aG" = (
/obj/structure/interior_wall/apc{
	alpha = 100;
	icon_state = "door_front";
	layer = 5.2;
	pixel_y = 32
	},
/turf/open/void/vehicle,
/area/space)
"aH" = (
/obj/structure/interior_wall/apc{
	icon_state = "front_wheel_R"
	},
/turf/open/void/vehicle,
/area/space)
"aM" = (
/obj/structure/interior_wall/apc{
	icon_state = "corner_inverse_L";
	opacity = 0
	},
/turf/open/void/vehicle,
/area/space)
"aN" = (
/obj/structure/interior_wall/apc{
	icon_state = "corner_small_L"
	},
/obj/structure/interior_wall/apc{
	icon_state = "rear_5"
	},
/turf/open/void/vehicle,
/area/space)
"aP" = (
/obj/structure/interior_wall/apc{
	icon_state = "door_back"
	},
/turf/open/void/vehicle,
/area/space)
"aS" = (
/obj/structure/interior_wall/apc{
	icon_state = "front_4"
	},
/turf/open/void/vehicle,
/area/space)
"aU" = (
/obj/structure/interior_wall/apc{
	icon_state = "front_1"
	},
/turf/open/void/vehicle,
/area/space)
"aX" = (
/obj/structure/bed/chair/vehicle{
	dir = 1;
	pixel_x = 8
	},
/obj/structure/bed/chair/vehicle{
	dir = 1;
	pixel_x = -8
	},
/turf/open/shuttle/vehicle/floor_3,
/area/interior/vehicle/apc/med)
"aY" = (
/obj/structure/interior_wall/apc{
	icon_state = "rear_4"
	},
/turf/open/void/vehicle,
/area/space)
"aZ" = (
/obj/structure/interior_wall/apc{
	icon_state = "corner_inverse_R";
	opacity = 0
	},
/turf/open/void/vehicle,
/area/space)
"ce" = (
/obj/effect/landmark/interior/spawn/interior_viewport{
	dir = 8;
	pixel_x = 5;
	pixel_y = 8
	},
/obj/effect/landmark/interior/spawn/entrance{
	alpha = 50;
	dir = 1;
	exit_type = /obj/structure/interior_exit/vehicle/apc;
	name = "Left APC door";
	pixel_y = 32;
	tag = "left"
	},
/turf/open/shuttle/vehicle/floor_1_11,
/area/interior/vehicle/apc/med)
"cg" = (
/obj/effect/decal/medical_decals/permanent{
	dir = 4;
	icon_state = "triagedecaldir"
	},
/turf/open/shuttle/vehicle/dark_sterile_green_8,
/area/interior/vehicle/apc/med)
"hH" = (
/obj/effect/decal/medical_decals/permanent{
	icon_state = "docdecal2";
	pixel_x = -5;
	pixel_y = 16
	},
/obj/effect/decal/medical_decals/permanent{
	icon_state = "triagedecalbottom"
	},
/turf/open/shuttle/vehicle/dark_sterile_green_5,
/area/interior/vehicle/apc/med)
"hU" = (
/turf/open/shuttle/vehicle/floor_1_6,
/area/interior/vehicle/apc/med)
"rg" = (
/obj/structure/vehicle_locker{
	pixel_y = 28
	},
/obj/structure/bed/chair/vehicle{
	pixel_x = -8
	},
/obj/structure/bed/chair/vehicle{
	pixel_x = 8
	},
/turf/open/shuttle/vehicle/floor_3_8_1,
/area/interior/vehicle/apc/med)
"uT" = (
/turf/open/shuttle/vehicle/floor_1_14,
/area/interior/vehicle/apc/med)
"yh" = (
/obj/effect/decal/medical_decals/permanent{
	icon_state = "docdecal1";
	pixel_x = -5;
	pixel_y = 16
	},
/turf/open/shuttle/vehicle/dark_sterile,
/area/interior/vehicle/apc/med)
"Dn" = (
/turf/open/shuttle/vehicle/floor_1_3_3,
/area/interior/vehicle/apc/med)
"Eg" = (
/obj/structure/machinery/iv_drip{
	anchored = 1
	},
/obj/structure/bed/roller,
/obj/effect/landmark/interior/spawn/interior_viewport{
	pixel_x = -6;
	pixel_y = 23
	},
/turf/open/shuttle/vehicle/dark_sterile_green_12,
/area/interior/vehicle/apc/med)
"FL" = (
/obj/effect/landmark/interior/spawn/weapons_loader,
/turf/open/shuttle/vehicle/floor_3_6,
/area/interior/vehicle/apc/med)
"HB" = (
/obj/structure/bed/chair/vehicle{
	pixel_x = 8
	},
/obj/structure/bed/chair/vehicle{
	pixel_x = -8
	},
/turf/open/shuttle/vehicle/floor_3,
/area/interior/vehicle/apc/med)
"HD" = (
/obj/effect/decal/medical_decals/permanent{
	icon_state = "triagedecalbottom"
	},
/obj/effect/decal/medical_decals/permanent{
	icon_state = "triagedecaltopright"
	},
/turf/open/shuttle/vehicle/dark_sterile_green_14,
/area/interior/vehicle/apc/med)
"IP" = (
/obj/structure/bed/chair/vehicle{
	pixel_x = -8
	},
/obj/structure/bed/chair/vehicle{
	pixel_x = 8
	},
/obj/effect/landmark/interior/spawn/telephone{
	pixel_x = 5;
	pixel_y = 30
	},
/obj/structure/extinguisher_cabinet/lifeboat{
	icon = 'icons/obj/vehicles/interiors/general.dmi';
	pixel_x = -8;
	pixel_y = 28
	},
/turf/open/shuttle/vehicle/floor_3_13,
/area/interior/vehicle/apc/med)
"Of" = (
/obj/effect/landmark/interior/spawn/vehicle_driver_seat/armor{
	dir = 4
	},
/turf/open/shuttle/vehicle/floor_3_9_1,
/area/interior/vehicle/apc/med)
"QI" = (
/obj/effect/decal/medical_decals/permanent{
	icon_state = "triagedecaltop";
	pixel_y = -2
	},
/obj/effect/decal/medical_decals/permanent{
	icon_state = "triagedecalbottomright"
	},
/obj/effect/landmark/interior/spawn/interior_camera{
	dir = 10;
	pixel_x = -14;
	pixel_y = 38
	},
/turf/open/shuttle/vehicle/dark_sterile_green_13,
/area/interior/vehicle/apc/med)
"TB" = (
/obj/structure/bed/chair/vehicle{
	dir = 1;
	pixel_x = 9
	},
/obj/structure/bed/chair/vehicle{
	dir = 1;
	pixel_x = -7
	},
/turf/open/shuttle/vehicle/floor_3_13,
/area/interior/vehicle/apc/med)
"TP" = (
/obj/structure/bed/chair/comfy{
	dir = 4
	},
/turf/open/shuttle/vehicle/dark_sterile_green_6,
/area/interior/vehicle/apc/med)
"Xj" = (
/obj/structure/machinery/cm_vending/sorted/medical/blood/vehicle{
	pixel_x = -20;
	pixel_y = 23
	},
/obj/structure/machinery/cm_vending/sorted/medical/vehicle{
	pixel_x = 2;
	pixel_y = 23
	},
/obj/effect/decal/medical_decals/permanent{
	icon_state = "triagedecaltop";
	pixel_y = -2
	},
/turf/open/shuttle/vehicle/dark_sterile_green_7,
/area/interior/vehicle/apc/med)

(1,1,1) = {"
aj
aN
aY
at
aa
ae
ak
"}
(2,1,1) = {"
an
ax
Eg
TP
ao
af
ak
"}
(3,1,1) = {"
au
aM
Xj
yh
hH
ag
ak
"}
(4,1,1) = {"
ap
HB
QI
cg
HD
aX
al
"}
(5,1,1) = {"
aP
ce
hU
Dn
hU
ai
aG
"}
(6,1,1) = {"
aq
aZ
IP
uT
TB
aC
ak
"}
(7,1,1) = {"
az
ax
rg
FL
Of
aH
ak
"}
(8,1,1) = {"
as
ar
aS
av
aF
aU
ak
"}
