//MAP CONVERTED BY dmm2tgm.py THIS HEADER COMMENT PREVENTS RECONVERSION, DO NOT REMOVE
"a" = (
/turf/closed/void{
	opacity = 0
	},
/area/space)
"q" = (
/obj/structure/prop/vehicle/arc{
	layer = 2.01;
	mouse_opacity = 0
	},
/turf/closed/void{
	opacity = 0
	},
/area/space)
"r" = (
/obj/effect/landmark/interior/spawn/telephone{
	pixel_x = -13;
	pixel_y = 15;
	layer = 2.9
	},
/obj/effect/landmark/interior/spawn/vehicle_driver_seat/armor{
	dir = 4
	},
/obj/structure/gun_rack/apc/frontal{
	desc = "A small compartment that stores ammunition for the ARC's 'Bleihagel RE-RE850 Frontal Rotary Cannon'.";
	pixel_y = 6;
	pixel_x = 2;
	layer = 2.9;
	density = 0
	},
/turf/open/floor/almayer,
/area/vehicle/apc/arc)
"G" = (
/obj/structure/bed/chair/vehicle{
	dir = 1;
	pixel_x = -8
	},
/obj/structure/bed/chair/vehicle{
	dir = 1;
	pixel_x = 8
	},
/turf/open/floor/almayer,
/area/vehicle/apc/arc)
"H" = (
/obj/effect/landmark/interior/spawn/weapons_loader{
	pixel_x = -2
	},
/turf/open/floor/almayer,
/area/vehicle/apc/arc)
"I" = (
/obj/structure/bed/chair/vehicle{
	pixel_x = -7
	},
/obj/effect/landmark/interior/spawn/interior_viewport{
	pixel_x = 8;
	pixel_y = 4;
	layer = 2.9
	},
/turf/open/floor/almayer,
/area/vehicle/apc/arc)
"N" = (
/obj/effect/landmark/interior/spawn/entrance{
	alpha = 50;
	exit_type = /obj/structure/interior_exit/vehicle/arc;
	name = "ARC exit door";
	tag = "right";
	pixel_y = -10
	},
/turf/open/floor/almayer,
/area/vehicle/apc/arc)
"X" = (
/obj/structure/machinery/cm_vending/sorted/medical/wall_med/vehicle{
	pixel_y = 12;
	pixel_x = 11
	},
/obj/structure/machinery/prop/almayer/CICmap/arc{
	dir = 4;
	pixel_x = -13;
	pixel_y = -9;
	layer = 2.981
	},
/obj/structure/machinery/computer/overwatch/almayer/arc{
	dir = 4;
	pixel_x = -13;
	pixel_y = 4
	},
/obj/structure/bed/chair/vehicle{
	dir = 8;
	pixel_x = 3
	},
/turf/open/floor/almayer,
/area/vehicle/apc/arc)

(1,1,1) = {"
a
a
a
q
"}
(2,1,1) = {"
a
X
G
a
"}
(3,1,1) = {"
a
I
N
a
"}
(4,1,1) = {"
a
r
H
a
"}
(5,1,1) = {"
a
a
a
a
"}
