//MAP CONVERTED BY dmm2tgm.py THIS HEADER COMMENT PREVENTS RECONVERSION, DO NOT REMOVE
"a" = (
/turf/open/void/vehicle,
/area/space)
"d" = (
/obj/structure/bed/chair/vehicle{
	pixel_x = -8;
	pixel_y = 23
	},
/obj/structure/bed/chair/vehicle{
	pixel_x = 8;
	pixel_y = 23
	},
/turf/open/shuttle/vehicle/floor_2,
/area/interior/vehicle/twe_apc)
"g" = (
/obj/effect/landmark/interior/spawn/vehicle_driver_seat/armor{
	dir = 4;
	pixel_x = 8;
	pixel_y = 3
	},
/obj/structure/phone_base{
	dir = 1;
	pixel_x = -6;
	phone_category = "Vehicles";
	name = "APC Telephone";
	phone_id = "FV150-C Light APC";
	pixel_y = -19
	},
/turf/open/shuttle/vehicle/floor_2,
/area/interior/vehicle/twe_apc)
"s" = (
/obj/structure/vehicle_locker/tank/twe{
	pixel_y = 32;
	pixel_x = -3;
	layer = 2.99
	},
/obj/effect/landmark/interior/spawn/weapons_loader{
	pixel_y = 10
	},
/obj/effect/landmark/interior/spawn/interior_camera{
	dir = 5;
	layer = 3.2;
	pixel_x = 15;
	pixel_y = 37
	},
/turf/open/shuttle/vehicle/floor_2,
/area/interior/vehicle/twe_apc)
"L" = (
/obj/structure/prop/vehicle/twe_tank/apc{
	pixel_x = -8;
	pixel_y = -20
	},
/obj/effect/landmark/interior/spawn/entrance{
	dir = 8;
	exit_type = /obj/structure/interior_exit/vehicle/tank;
	name = "back entrance marker";
	tag = "rear"
	},
/obj/structure/bed/chair/vehicle{
	dir = 1;
	pixel_x = 12
	},
/turf/open/shuttle/vehicle/floor_2,
/area/interior/vehicle/twe_apc)
"S" = (
/turf/open/shuttle/vehicle/floor_2,
/area/interior/vehicle/twe_apc)
"T" = (
/obj/structure/bed/chair/vehicle{
	pixel_x = 8;
	pixel_y = 23
	},
/obj/structure/bed/chair/vehicle{
	pixel_x = -8;
	pixel_y = 23
	},
/obj/effect/landmark/interior/spawn/interior_viewport{
	dir = 4;
	pixel_x = -5;
	pixel_y = -4
	},
/turf/open/shuttle/vehicle/floor_2,
/area/interior/vehicle/twe_apc)
"Z" = (
/turf/open/void/vehicle,
/area/interior/vehicle/twe_apc)

(1,1,1) = {"
a
a
a
a
a
"}
(2,1,1) = {"
a
Z
T
L
a
"}
(3,1,1) = {"
a
Z
d
g
a
"}
(4,1,1) = {"
a
Z
s
S
a
"}
(5,1,1) = {"
a
a
a
a
a
"}
