"a" = (/obj/structure/prop/tank{icon = 'icons/obj/vehicles/interiors/upptank.dmi'},/turf/open/shuttle/vehicle/floor_3_5,/area/interior/vehicle/upptank)
"b" = (/turf/open/void/vehicle,/area/space)
"f" = (/obj/effect/landmark/interior/spawn/interior_camera{dir = 10; layer = 3.2; pixel_x = -14; pixel_y = 33},/obj/effect/landmark/interior/spawn/interior_viewport{dir = 1; pixel_x = 0; pixel_y = -11},/obj/structure/bed/chair/dropship{dir = 2; name = "handrail seat"; icon = 'icons/obj/structures/handrail.dmi'; icon_state = "handrail_strata"; indestructible = 1},/turf/open/shuttle/vehicle/floor_1_14,/area/interior/vehicle/upptank)
"v" = (/obj/structure/prop/vehicle/upptank{pixel_x = 16; pixel_y = 0},/turf/open/void/vehicle,/area/space)
"E" = (/turf/open/void/vehicle{opacity = 0},/area/space)
"H" = (/obj/effect/landmark/interior/spawn/entrance{dir = 8; exit_type = /obj/structure/interior_exit/vehicle/tank; name = "back entrance marker"; tag = "back"},/obj/structure/machinery/cm_vending/sorted/medical/wall_med/vehicle{pixel_y = 27; pixel_x = -7},/obj/structure/vehicle_locker/tank/upp2{pixel_x = 3; pixel_y = 27},/obj/structure/vehicle_locker/tank/upp2{pixel_x = 11; pixel_y = 27},/turf/open/shuttle/vehicle/floor_1_13,/area/interior/vehicle/upptank)
"M" = (/turf/open/void/vehicle{opacity = 0},/area/interior/vehicle/upptank)
"Q" = (/obj/effect/landmark/interior/spawn/weapons_loader{icon = 'icons/obj/vehicles/interiors/upptank.dmi'; pixel_x = -6; pixel_y = 23},/obj/structure/vehicle_locker/tank/upp1{pixel_x = -25; pixel_y = 16},/obj/effect/landmark/interior/spawn/vehicle_gunner_seat/armor{dir = 4},/turf/open/shuttle/vehicle/floor_3_13,/area/interior/vehicle/upptank)
"R" = (/obj/structure/extinguisher_cabinet/lifeboat{icon = 'icons/obj/vehicles/interiors/general.dmi'; pixel_x = -3; pixel_y = 18; layer = 3.1},/obj/structure/phone_base{icon = 'icons/obj/vehicles/interiors/movie.dmi'; pixel_x = 18; pixel_y = 31; layer = 3.1},/obj/effect/landmark/interior/spawn/vehicle_driver_seat/armor{dir = 4},/turf/open/shuttle/vehicle/floor_3_13,/area/interior/vehicle/upptank)
"S" = (/turf/closed/void,/area/space)

(1,1,1) = {"
bbbbSS
bbMMSS
bMQaES
bHfRES
vbbbbS
"}
