//MAP CONVERTED BY dmm2tgm.py THIS HEADER COMMENT PREVENTS RECONVERSION, DO NOT REMOVE
"a" = (
/turf/open/void/vehicle,
/area/space)
"c" = (
/obj/effect/landmark/interior/spawn/entrance{
	dir = 8;
	exit_type = /obj/structure/interior_exit/vehicle/uppvan/backleft;
	name = "back left entrance marker";
	pixel_x = -32;
	tag = "back_left"
	},
/obj/structure/machinery/cm_vending/sorted/medical/vehicle{
	pixel_x = -5;
	pixel_y = 25
	},
/obj/structure/machinery/cm_vending/sorted/medical/blood/vehicle{
	pixel_y = 25;
	pixel_x = 17
	},
/obj/structure/bed/roller/hospital_empty/bigrollerempty3{
	anchored = 1
	},
/turf/open/shuttle/vehicle/dark_sterile_green_12,
/area/interior/vehicle/uppvan/medical)
"f" = (
/obj/effect/landmark/interior/spawn/entrance{
	alpha = 50;
	exit_type = /obj/structure/interior_exit/vehicle/uppvan/right;
	name = "right entrance marker";
	tag = "right"
	},
/obj/effect/decal/warning_stripes{
	icon_state = "door_warning";
	anchored = 1
	},
/turf/open/shuttle/vehicle/floor_1_12,
/area/interior/vehicle/uppvan/medical)
"x" = (
/obj/structure/prop/vehicle/uppvan{
	pixel_x = 16;
	pixel_y = 16
	},
/turf/open/void/vehicle,
/area/space)
"z" = (
/obj/effect/decal/medical_decals/permanent{
	icon_state = "triagedecalleft";
	pixel_y = 0;
	pixel_x = 32
	},
/obj/structure/bed/portable_surgery{
	name = "vehicle surgical bed";
	foldabletype = null
	},
/obj/structure/vehicle_locker/med{
	pixel_y = 31;
	pixel_x = 6
	},
/obj/structure/machinery/iv_drip{
	anchored = 1;
	pixel_y = 21;
	pixel_x = -12;
	layer = 299
	},
/turf/open/shuttle/vehicle/dark_sterile_green_13,
/area/interior/vehicle/uppvan/medical)
"D" = (
/obj/structure/barricade/handrail{
	dir = 4;
	pixel_y = -30;
	pixel_x = 4;
	layer = 3.01
	},
/turf/open/void/vehicle,
/area/space)
"I" = (
/obj/effect/landmark/interior/spawn/entrance{
	dir = 8;
	exit_type = /obj/structure/interior_exit/vehicle/uppvan/backright;
	name = "back right entrance marker";
	pixel_x = -32;
	tag = "back_right"
	},
/obj/effect/landmark/interior/spawn/interior_viewport/simple/uppvan{
	alpha = 100;
	pixel_y = -2;
	icon = 'icons/obj/vehicles/interiors/uppvan.dmi'
	},
/obj/structure/bed/roller/hospital_empty/bigrollerempty3{
	anchored = 1
	},
/turf/open/shuttle/vehicle/dark_sterile_green_11,
/area/interior/vehicle/uppvan/medical)
"M" = (
/obj/structure/bed/chair/vehicle{
	dir = 4
	},
/obj/effect/landmark/interior/spawn/interior_viewport/simple/uppvanfront{
	pixel_x = 0;
	pixel_y = -2
	},
/turf/open/shuttle/vehicle/floor_3_12,
/area/interior/vehicle/uppvan/medical)
"R" = (
/obj/effect/landmark/interior/spawn/vehicle_driver_seat/armor{
	dir = 4
	},
/obj/structure/machinery/cm_vending/sorted/medical/wall_med/vehicle{
	pixel_y = 23;
	pixel_x = 4
	},
/obj/structure/extinguisher_cabinet/lifeboat{
	icon = 'icons/obj/vehicles/interiors/general.dmi';
	pixel_x = -7;
	pixel_y = 23
	},
/obj/effect/landmark/interior/spawn/interior_viewport/simple/uppvanfront{
	pixel_x = 0;
	pixel_y = 32
	},
/turf/open/shuttle/vehicle/floor_3_11,
/area/interior/vehicle/uppvan/medical)
"U" = (
/obj/effect/landmark/interior/spawn/interior_viewport/simple/uppvan{
	alpha = 100;
	pixel_y = -2;
	icon = 'icons/obj/vehicles/interiors/uppvan.dmi'
	},
/obj/effect/decal/medical_decals/permanent{
	icon_state = "triagedecalleft";
	pixel_y = 0;
	pixel_x = 32
	},
/obj/structure/bed/chair/vehicle/toc{
	dir = 1;
	pixel_y = 11;
	pixel_x = -1;
	name = "surgical chair";
	buckle_offset_x = -1;
	buckle_offset_y = 11
	},
/obj/structure/machinery/iv_drip{
	anchored = 1;
	pixel_y = -1;
	pixel_x = -9;
	layer = 299
	},
/turf/open/shuttle/vehicle/dark_sterile_green_14,
/area/interior/vehicle/uppvan/medical)
"W" = (
/obj/effect/landmark/interior/spawn/entrance{
	dir = 1;
	exit_type = /obj/structure/interior_exit/vehicle/uppvan/left;
	name = "left entrance marker";
	pixel_y = 32;
	tag = "left"
	},
/obj/effect/decal/warning_stripes{
	icon_state = "door_warning";
	pixel_x = 0;
	pixel_y = 20;
	anchored = 1
	},
/turf/open/shuttle/vehicle/floor_1_11,
/area/interior/vehicle/uppvan/medical)

(1,1,1) = {"
a
a
a
a
x
"}
(2,1,1) = {"
a
a
c
I
a
"}
(3,1,1) = {"
a
D
z
U
a
"}
(4,1,1) = {"
a
a
W
f
a
"}
(5,1,1) = {"
a
a
R
M
a
"}
(6,1,1) = {"
a
a
a
a
a
"}
