//MAP CONVERTED BY dmm2tgm.py THIS HEADER COMMENT PREVENTS RECONVERSION, DO NOT REMOVE
"a" = (
/turf/open/void/vehicle,
/area/space)
"c" = (
/obj/effect/landmark/interior/spawn/entrance{
	dir = 8;
	exit_type = /obj/structure/interior_exit/vehicle/uppvan/backleft;
	name = "back left entrance marker";
	pixel_x = -32;
	tag = "back_left"
	},
/obj/structure/vehicle_locker/tank/upp3{
	pixel_x = -6;
	pixel_y = 36
	},
/obj/structure/vehicle_locker/tank/upp3{
	pixel_x = 7;
	pixel_y = 36
	},
/obj/effect/decal/warning_stripes{
	icon_state = "cargo";
	anchored = 1
	},
/turf/open/shuttle/vehicle/floor_2,
/area/interior/vehicle/uppvan/logistics)
"f" = (
/obj/effect/landmark/interior/spawn/entrance{
	alpha = 50;
	exit_type = /obj/structure/interior_exit/vehicle/uppvan/right;
	name = "right entrance marker";
	tag = "right"
	},
/obj/effect/decal/warning_stripes{
	icon_state = "door_warning";
	anchored = 1
	},
/obj/effect/decal/warning_stripes{
	icon_state = "W";
	layer = 3.3;
	pixel_x = -1;
	anchored = 1
	},
/turf/open/shuttle/vehicle/floor_1_12,
/area/interior/vehicle/uppvan/logistics)
"x" = (
/obj/structure/prop/vehicle/uppvan_logistics{
	pixel_x = 16;
	pixel_y = 16
	},
/turf/open/void/vehicle,
/area/space)
"z" = (
/obj/structure/vehicle_locker/tank/upp3{
	pixel_x = -6;
	pixel_y = 36
	},
/obj/structure/vehicle_locker/tank/upp3{
	pixel_x = 7;
	pixel_y = 36
	},
/obj/effect/decal/warning_stripes{
	icon_state = "cargo";
	anchored = 1
	},
/turf/open/shuttle/vehicle/floor_3_4,
/area/interior/vehicle/uppvan/logistics)
"I" = (
/obj/effect/landmark/interior/spawn/entrance{
	dir = 8;
	exit_type = /obj/structure/interior_exit/vehicle/uppvan/backright;
	name = "back right entrance marker";
	pixel_x = -32;
	tag = "back_right"
	},
/obj/effect/decal/warning_stripes{
	icon_state = "cargo";
	anchored = 1
	},
/turf/open/shuttle/vehicle/floor_2,
/area/interior/vehicle/uppvan/logistics)
"M" = (
/obj/structure/bed/chair/vehicle{
	dir = 4
	},
/obj/effect/landmark/interior/spawn/interior_viewport/simple/uppvanfront{
	pixel_x = 0;
	pixel_y = -2
	},
/turf/open/shuttle/vehicle/floor_3_12,
/area/interior/vehicle/uppvan/logistics)
"R" = (
/obj/effect/landmark/interior/spawn/vehicle_driver_seat/armor{
	dir = 4
	},
/obj/structure/machinery/cm_vending/sorted/medical/wall_med/vehicle{
	pixel_y = 23;
	pixel_x = 4
	},
/obj/structure/extinguisher_cabinet/lifeboat{
	icon = 'icons/obj/vehicles/interiors/general.dmi';
	pixel_x = -7;
	pixel_y = 23
	},
/obj/effect/landmark/interior/spawn/interior_viewport/simple/uppvanfront{
	pixel_x = 0;
	pixel_y = 32
	},
/turf/open/shuttle/vehicle/floor_3_11,
/area/interior/vehicle/uppvan/logistics)
"U" = (
/obj/effect/decal/warning_stripes{
	icon_state = "cargo";
	anchored = 1
	},
/turf/open/shuttle/vehicle/floor_3_4,
/area/interior/vehicle/uppvan/logistics)
"V" = (
/obj/structure/barricade/handrail{
	dir = 4;
	pixel_y = -30;
	pixel_x = 4;
	layer = 3.01
	},
/obj/structure/vehicle_locker/tank/upp{
	pixel_x = 0;
	pixel_y = -2
	},
/turf/open/void/vehicle,
/area/space)
"W" = (
/obj/effect/landmark/interior/spawn/entrance{
	dir = 1;
	exit_type = /obj/structure/interior_exit/vehicle/uppvan/left;
	name = "left entrance marker";
	pixel_y = 32;
	tag = "left"
	},
/obj/effect/decal/warning_stripes{
	icon_state = "door_warning";
	pixel_x = 0;
	pixel_y = 20;
	anchored = 1
	},
/obj/effect/decal/warning_stripes{
	icon_state = "W";
	layer = 3.3;
	pixel_x = -1;
	anchored = 1
	},
/turf/open/shuttle/vehicle/floor_1_11,
/area/interior/vehicle/uppvan/logistics)
"X" = (
/obj/structure/vehicle_locker/tank/upp{
	pixel_x = 0;
	pixel_y = -2
	},
/turf/open/void/vehicle,
/area/space)

(1,1,1) = {"
a
a
a
a
x
"}
(2,1,1) = {"
a
X
c
I
a
"}
(3,1,1) = {"
a
V
z
U
a
"}
(4,1,1) = {"
a
a
W
f
a
"}
(5,1,1) = {"
a
a
R
M
a
"}
(6,1,1) = {"
a
a
a
a
a
"}
