//MAP CONVERTED BY dmm2tgm.py THIS HEADER COMMENT PREVENTS RECONVERSION, DO NOT REMOVE
"a" = (
/turf/open/void/vehicle,
/area/space)
"c" = (
/obj/structure/bed/chair/vehicle{
	pixel_x = 8;
	pixel_y = 14
	},
/obj/structure/bed/chair/vehicle{
	pixel_x = -8;
	pixel_y = 14
	},
/obj/effect/landmark/interior/spawn/entrance{
	dir = 8;
	exit_type = /obj/structure/interior_exit/vehicle/uppvan/backleft;
	name = "back left entrance marker";
	pixel_x = -32;
	tag = "back_left"
	},
/obj/effect/landmark/interior/spawn/interior_viewport/simple/uppvan{
	pixel_y = 32;
	icon = 'icons/obj/vehicles/interiors/uppvan.dmi';
	pixel_x = -1
	},
/turf/open/shuttle/vehicle/floor_2,
/area/interior/vehicle/uppvant)
"f" = (
/obj/effect/landmark/interior/spawn/entrance{
	alpha = 50;
	exit_type = /obj/structure/interior_exit/vehicle/uppvan/right;
	name = "right entrance marker";
	tag = "right"
	},
/obj/effect/decal/warning_stripes{
	icon_state = "door_warning";
	anchored = 1
	},
/turf/open/shuttle/vehicle/floor_1_12,
/area/interior/vehicle/uppvant)
"x" = (
/obj/structure/prop/vehicle/uppvan/turret{
	pixel_x = 15;
	pixel_y = 16
	},
/turf/open/void/vehicle,
/area/space)
"z" = (
/obj/structure/bed/chair/vehicle{
	pixel_x = 8;
	pixel_y = 14
	},
/obj/structure/bed/chair/vehicle{
	pixel_x = -8;
	pixel_y = 14
	},
/obj/effect/landmark/interior/spawn/interior_viewport/simple/uppvan{
	pixel_y = 32;
	icon = 'icons/obj/vehicles/interiors/uppvan.dmi';
	pixel_x = -1
	},
/turf/open/shuttle/vehicle/floor_3_4,
/area/interior/vehicle/uppvant)
"I" = (
/obj/structure/bed/chair/vehicle{
	dir = 1;
	pixel_x = -8
	},
/obj/structure/bed/chair/vehicle{
	dir = 1;
	pixel_x = 8
	},
/obj/effect/landmark/interior/spawn/entrance{
	dir = 8;
	exit_type = /obj/structure/interior_exit/vehicle/uppvan/backright;
	name = "back right entrance marker";
	pixel_x = -32;
	tag = "back_right"
	},
/obj/effect/landmark/interior/spawn/interior_viewport/simple/uppvan{
	alpha = 100;
	pixel_y = -2;
	icon = 'icons/obj/vehicles/interiors/uppvan.dmi';
	pixel_x = -1
	},
/obj/effect/decal/warning_stripes{
	icon_state = "door_warning";
	pixel_x = 0;
	pixel_y = 20;
	anchored = 1;
	dir = 8
	},
/turf/open/shuttle/vehicle/floor_2,
/area/interior/vehicle/uppvant)
"M" = (
/obj/effect/landmark/interior/spawn/weapons_loader{
	icon = 'icons/obj/vehicles/interiors/uppvan.dmi';
	pixel_x = 19;
	pixel_y = 17
	},
/obj/structure/vehicle_locker/uppvan{
	pixel_x = 14;
	pixel_y = -11
	},
/obj/effect/landmark/interior/spawn/vehicle_gunner_seat/armor/van{
	dir = 4
	},
/turf/open/shuttle/vehicle/floor_3_12,
/area/interior/vehicle/uppvant)
"R" = (
/obj/effect/landmark/interior/spawn/vehicle_driver_seat/armor{
	dir = 4
	},
/obj/structure/machinery/cm_vending/sorted/medical/wall_med/vehicle{
	pixel_y = 23;
	pixel_x = 4
	},
/obj/structure/extinguisher_cabinet/lifeboat{
	icon = 'icons/obj/vehicles/interiors/general.dmi';
	pixel_x = -7;
	pixel_y = 23
	},
/obj/effect/landmark/interior/spawn/interior_viewport/simple/uppvanfront{
	pixel_x = 0;
	pixel_y = 32
	},
/turf/open/shuttle/vehicle/floor_3_11,
/area/interior/vehicle/uppvant)
"U" = (
/obj/structure/bed/chair/vehicle{
	dir = 1;
	pixel_x = -8
	},
/obj/structure/bed/chair/vehicle{
	dir = 1;
	pixel_x = 8
	},
/obj/effect/landmark/interior/spawn/interior_viewport/simple/uppvan{
	alpha = 100;
	pixel_y = -2;
	icon = 'icons/obj/vehicles/interiors/uppvan.dmi';
	pixel_x = -1
	},
/turf/open/shuttle/vehicle/floor_3_4,
/area/interior/vehicle/uppvant)
"W" = (
/obj/effect/landmark/interior/spawn/entrance{
	dir = 1;
	exit_type = /obj/structure/interior_exit/vehicle/uppvan/left;
	name = "left entrance marker";
	pixel_y = 32;
	tag = "left"
	},
/obj/effect/decal/warning_stripes{
	icon_state = "door_warning";
	pixel_x = 0;
	pixel_y = 20;
	anchored = 1
	},
/turf/open/shuttle/vehicle/floor_1_11,
/area/interior/vehicle/uppvant)

(1,1,1) = {"
a
a
a
a
x
"}
(2,1,1) = {"
a
a
c
I
a
"}
(3,1,1) = {"
a
a
z
U
a
"}
(4,1,1) = {"
a
a
W
f
a
"}
(5,1,1) = {"
a
a
R
M
a
"}
(6,1,1) = {"
a
a
a
a
a
"}
