//MAP CONVERTED BY dmm2tgm.py THIS HEADER COMMENT PREVENTS RECONVERSION, DO NOT REMOVE
"a" = (
/obj/structure/interior_wall/van{
	alpha = 50;
	icon_state = "exterior_door";
	layer = 5.2;
	pixel_y = 32
	},
/turf/open/void/vehicle,
/area/space)
"b" = (
/obj/structure/interior_wall/van{
	alpha = 50;
	icon_state = "exterior_3";
	layer = 5.2;
	pixel_y = 32
	},
/turf/open/void/vehicle,
/area/space)
"g" = (
/obj/structure/interior_wall/van{
	icon_state = "back_2"
	},
/turf/open/void/vehicle,
/area/space)
"o" = (
/obj/structure/interior_wall/van{
	icon_state = "interior_door"
	},
/obj/effect/landmark/interior/spawn/interior_viewport/simple/windshield,
/obj/effect/vehicle_roof/van{
	icon_state = "front_roof_1"
	},
/turf/open/void/vehicle,
/area/space)
"p" = (
/turf/open/void/vehicle,
/area/space)
"t" = (
/obj/structure/interior_wall/apc{
	icon_state = "wall";
	opacity = 0
	},
/obj/effect/vehicle_roof/van{
	icon_state = "roof_3"
	},
/turf/open/void/vehicle,
/area/space)
"u" = (
/obj/structure/interior_wall/van{
	icon_state = "front_1"
	},
/turf/open/void/vehicle,
/area/space)
"G" = (
/obj/structure/interior_wall/van{
	icon_state = "front_2"
	},
/turf/open/void/vehicle,
/area/space)
"I" = (
/obj/structure/vehicle_locker{
	pixel_y = 30;
	layer = 3.3;
	pixel_x = -7
	},
/obj/effect/landmark/interior/spawn/weapons_loader{
	icon = 'icons/obj/vehicles/interiors/arc.dmi';
	icon_state = "arcloader";
	pixel_y = 31;
	pixel_x = 8
	},
/obj/effect/vehicle_roof/van{
	icon_state = "roof_3"
	},
/turf/open/shuttle/vehicle/floor_3_7,
/area/interior/vehicle/van/armored)
"N" = (
/obj/structure/barricade/handrail/type_b{
	dir = 4;
	pixel_y = 1;
	pixel_x = 3
	},
/obj/structure/largecrate/random/barrel/purewhite{
	pixel_x = -4;
	pixel_y = 2
	},
/turf/open/shuttle/vehicle/floor_3_10_1,
/area/interior/vehicle/van/armored)
"R" = (
/obj/effect/landmark/interior/spawn/entrance{
	dir = 1;
	exit_type = /obj/structure/interior_exit/vehicle/van/left;
	name = "left entrance marker";
	pixel_y = 32;
	tag = "left"
	},
/obj/effect/landmark/interior/spawn/vehicle_driver_seat{
	dir = 4;
	layer = 2
	},
/obj/effect/landmark/interior/spawn/interior_viewport/simple/windshield{
	icon_state = "windshield_viewport_bottom"
	},
/obj/effect/vehicle_roof/van{
	icon_state = "front_roof_2"
	},
/turf/open/shuttle/vehicle/floor_3_8,
/area/interior/vehicle/van/armored)
"V" = (
/obj/structure/interior_wall/van{
	icon_state = "front_3"
	},
/turf/open/void/vehicle,
/area/space)
"W" = (
/obj/effect/landmark/interior/spawn/entrance{
	alpha = 50;
	exit_type = /obj/structure/interior_exit/vehicle/van/right;
	name = "right entrance marker";
	tag = "right"
	},
/obj/structure/bed/chair/comfy{
	dir = 4;
	layer = 3.01
	},
/turf/open/shuttle/vehicle/floor_3_12,
/area/interior/vehicle/van/armored)

(1,1,1) = {"
p
p
g
g
p
"}
(2,1,1) = {"
p
t
I
N
b
"}
(3,1,1) = {"
p
o
R
W
a
"}
(4,1,1) = {"
p
V
G
u
p
"}
