//MAP CONVERTED BY dmm2tgm.py THIS HEADER COMMENT PREVENTS RECONVERSION, DO NOT REMOVE
"aa" = (
/turf/open/floor{
	icon_state = "white"
	},
/area/lv624/lazarus/main_hall)
"ab" = (
/obj/item/stack/sheet/wood,
/turf/open/floor{
	icon_state = "white"
	},
/area/lv624/lazarus/main_hall)
"ac" = (
/turf/open/floor{
	dir = 4;
	icon_state = "whiteyellow"
	},
/area/lv624/lazarus/main_hall)
"ad" = (
/obj/structure/target/syndicate,
/turf/open/floor/red/northeast,
/area/lv624/lazarus/security)
"ae" = (
/obj/structure/barricade/wooden{
	dir = 8
	},
/turf/open/floor{
	icon_state = "white"
	},
/area/lv624/lazarus/main_hall)
"af" = (
/turf/open/floor{
	dir = 4;
	icon_state = "whiteyellowcorner"
	},
/area/lv624/lazarus/main_hall)
"ag" = (
/turf/open/floor{
	dir = 1;
	icon_state = "whiteyellow"
	},
/area/lv624/lazarus/main_hall)
"ah" = (
/obj/structure/machinery/light/small,
/obj/effect/landmark/crap_item,
/turf/open/floor{
	icon_state = "white"
	},
/area/lv624/lazarus/main_hall)
"ai" = (
/turf/closed/wall/r_wall,
/area/lv624/lazarus/armory)
"aj" = (
/turf/closed/wall/r_wall,
/area/lv624/lazarus/security)
"ak" = (
/obj/structure/surface/rack,
/obj/item/weapon/gun/shotgun/pump,
/obj/item/ammo_magazine/shotgun/slugs,
/turf/open/floor{
	icon_state = "cult"
	},
/area/lv624/lazarus/armory)
"al" = (
/obj/effect/decal/cleanable/cobweb2,
/obj/item/reagent_container/hypospray/autoinjector/tricord,
/obj/structure/surface/rack,
/obj/item/reagent_container/hypospray/autoinjector/tricord,
/obj/effect/landmark/crap_item,
/obj/effect/landmark/crap_item,
/turf/open/floor{
	icon_state = "cult"
	},
/area/lv624/lazarus/armory)
"am" = (
/obj/structure/target/syndicate,
/turf/open/floor{
	dir = 5;
	icon_state = "red"
	},
/area/lv624/lazarus/security)
"an" = (
/obj/structure/machinery/deployable/barrier,
/obj/effect/decal/cleanable/cobweb,
/turf/open/floor{
	icon_state = "cult"
	},
/area/lv624/lazarus/armory)
"ao" = (
/obj/structure/machinery/light/small{
	dir = 1
	},
/obj/structure/surface/rack,
/obj/item/weapon/gun/pistol/highpower,
/obj/item/ammo_magazine/pistol/highpower,
/obj/item/ammo_magazine/pistol/highpower,
/obj/item/ammo_magazine/pistol/highpower,
/turf/open/floor{
	icon_state = "cult"
	},
/area/lv624/lazarus/armory)
"ap" = (
/turf/open/floor{
	icon_state = "cult"
	},
/area/lv624/lazarus/armory)
"aq" = (
/obj/structure/surface/rack,
/obj/effect/landmark/crap_item,
/obj/effect/landmark/crap_item,
/obj/item/reagent_container/food/snacks/sliceable/cheesewheel/verymature,
/obj/item/reagent_container/food/snacks/sliceable/cheesewheel/verymature,
/turf/open/floor{
	icon_state = "cult"
	},
/area/lv624/lazarus/armory)
"ar" = (
/obj/structure/machinery/light/small{
	dir = 8
	},
/turf/open/floor{
	dir = 5;
	icon_state = "red"
	},
/area/lv624/lazarus/security)
"as" = (
/obj/structure/machinery/deployable/barrier,
/turf/open/floor{
	icon_state = "cult"
	},
/area/lv624/lazarus/armory)
"at" = (
/turf/open/floor{
	dir = 5;
	icon_state = "red"
	},
/area/lv624/lazarus/security)
"au" = (
/obj/structure/machinery/power/apc{
	dir = 8;
	name = "Secure Vault APC";
	pixel_x = -28;
	start_charge = 0
	},
/obj/structure/surface/rack,
/obj/item/reagent_container/food/snacks/cheesewedge/verymature{
	pixel_x = -7;
	pixel_y = -3
	},
/obj/item/reagent_container/food/snacks/cheesewedge/verymature{
	pixel_x = 6;
	pixel_y = -3
	},
/obj/item/reagent_container/food/snacks/cheesewedge/verymature{
	pixel_y = 6
	},
/turf/open/floor{
	icon_state = "cult"
	},
/area/lv624/lazarus/armory)
"av" = (
/turf/open/floor/red/northeast,
/area/lv624/lazarus/security)
"aw" = (
/turf/open/floor/whiteyellowcorner/east,
/area/lv624/lazarus/main_hall)
"ax" = (
/obj/structure/machinery/light/small{
	dir = 1
	},
/obj/structure/surface/rack,
/obj/item/weapon/gun/pistol/highpower,
/obj/item/ammo_magazine/pistol/highpower,
/obj/item/ammo_magazine/pistol/highpower,
/obj/item/ammo_magazine/pistol/highpower,
/turf/open/floor/cult,
/area/lv624/lazarus/armory)
"ay" = (
/obj/structure/window/reinforced{
	dir = 4
	},
/obj/structure/surface/table,
/obj/item/weapon/gun/revolver/cmb,
/obj/item/ammo_magazine/revolver/cmb,
/obj/item/ammo_magazine/revolver/cmb,
/obj/item/ammo_magazine/revolver/cmb,
/turf/open/floor{
	dir = 5;
	icon_state = "red"
	},
/area/lv624/lazarus/security)
"az" = (
/turf/closed/wall/strata_ice/jungle,
/area/lv624/ground/jungle/east_central_jungle)
"aA" = (
/obj/effect/landmark/crap_item,
/turf/open/floor{
	icon_state = "cult"
	},
/area/lv624/lazarus/armory)
"aB" = (
/obj/structure/machinery/door/airlock/almayer/secure/colony{
	locked = 1;
	name = "\improper Nexus Dome Armory"
	},
/turf/open/floor{
	icon_state = "cult"
	},
/area/lv624/lazarus/armory)
"aC" = (
/obj/structure/machinery/door_control{
	id = "garage_blast";
	name = "Garage Shutters";
	pixel_x = -26;
	range = 200
	},
/obj/structure/surface/rack,
/obj/item/reagent_container/food/snacks/sliceable/cheesewheel/mature{
	pixel_y = 8
	},
/obj/item/reagent_container/food/snacks/sliceable/cheesewheel/mature{
	pixel_y = -6
	},
/turf/open/floor{
	icon_state = "cult"
	},
/area/lv624/lazarus/armory)
"aD" = (
/obj/structure/machinery/light/small{
	dir = 8
	},
/turf/open/floor/red/northeast,
/area/lv624/lazarus/security)
"aE" = (
/obj/structure/barricade/wooden{
	dir = 8
	},
/turf/open/floor/white,
/area/lv624/lazarus/main_hall)
"aF" = (
/obj/structure/surface/rack,
/obj/item/reagent_container/food/snacks/cheesewedge/verymature{
	pixel_x = -7;
	pixel_y = -3
	},
/obj/item/reagent_container/food/snacks/cheesewedge/verymature{
	pixel_x = 6;
	pixel_y = -3
	},
/obj/item/reagent_container/food/snacks/cheesewedge/verymature{
	pixel_y = 6
	},
/obj/structure/machinery/power/apc/no_power/west,
/turf/open/floor/cult,
/area/lv624/lazarus/armory)
"aG" = (
/obj/structure/machinery/deployable/barrier,
/turf/open/floor/cult,
/area/lv624/lazarus/armory)
"aH" = (
/obj/item/stack/sheet/wood,
/turf/open/floor/white,
/area/lv624/lazarus/main_hall)
"aI" = (
/obj/structure/machinery/light/small,
/obj/effect/landmark/crap_item,
/turf/open/floor/white,
/area/lv624/lazarus/main_hall)
"aJ" = (
/obj/structure/surface/rack,
/obj/item/weapon/gun/shotgun/pump,
/obj/item/ammo_magazine/shotgun/slugs,
/turf/open/floor/cult,
/area/lv624/lazarus/armory)
"aK" = (
/obj/effect/decal/cleanable/cobweb2,
/obj/item/reagent_container/hypospray/autoinjector/tricord,
/obj/structure/surface/rack,
/obj/item/reagent_container/hypospray/autoinjector/tricord,
/obj/effect/landmark/crap_item,
/obj/effect/landmark/crap_item,
/turf/open/floor/cult,
/area/lv624/lazarus/armory)
"aL" = (
/obj/structure/surface/rack,
/obj/item/storage/box/mousetraps{
	pixel_x = -5
	},
/obj/item/paper/lv_624/cheese{
	pixel_x = 8;
	pixel_y = -4
	},
/turf/open/floor{
	icon_state = "cult"
	},
/area/lv624/lazarus/armory)
"aM" = (
/turf/open/floor/whiteyellow/east,
/area/lv624/lazarus/main_hall)
"aN" = (
/obj/structure/machinery/deployable/barrier,
/obj/effect/decal/cleanable/cobweb,
/turf/open/floor/cult,
/area/lv624/lazarus/armory)
"aO" = (
/obj/item/handset{
	desc = "A model of an ancient Earth communication device.";
	force = 8
	},
/obj/structure/surface/rack{
	layer = 2.5
	},
/obj/structure/window/reinforced{
	dir = 8
	},
/obj/structure/window/reinforced{
	dir = 1
	},
/obj/structure/window/reinforced,
/turf/open/floor{
	icon_state = "wood"
	},
/area/lv624/lazarus/main_hall)
"aP" = (
/turf/open/floor/whiteyellow/north,
/area/lv624/lazarus/main_hall)
"aQ" = (
/obj/structure/surface/rack,
/obj/effect/landmark/crap_item,
/obj/effect/landmark/crap_item,
/obj/item/reagent_container/food/snacks/sliceable/cheesewheel/mature{
	pixel_y = 6
	},
/obj/item/reagent_container/food/snacks/cheesewedge/extramature{
	pixel_x = -4;
	pixel_y = -3
	},
/turf/open/floor{
	icon_state = "cult"
	},
/area/lv624/lazarus/armory)
"aR" = (
/obj/structure/surface/rack,
/obj/effect/landmark/crap_item,
/obj/effect/landmark/crap_item,
/obj/item/reagent_container/food/snacks/sliceable/cheesewheel/verymature,
/obj/item/reagent_container/food/snacks/sliceable/cheesewheel/verymature,
/turf/open/floor/cult,
/area/lv624/lazarus/armory)
"aS" = (
/obj/structure/machinery/door_control{
	id = "garage_blast";
	name = "Garage Shutters";
	pixel_x = -26;
	range = 200
	},
/obj/structure/surface/rack,
/obj/item/reagent_container/food/snacks/sliceable/cheesewheel/mature{
	pixel_y = 8
	},
/obj/item/reagent_container/food/snacks/sliceable/cheesewheel/mature{
	pixel_y = -6
	},
/turf/open/floor/cult,
/area/lv624/lazarus/armory)
"aT" = (
/obj/structure/surface/rack,
/obj/effect/landmark/crap_item,
/obj/effect/landmark/crap_item,
/obj/item/reagent_container/food/snacks/sliceable/cheesewheel/mature{
	pixel_y = 6
	},
/obj/item/reagent_container/food/snacks/cheesewedge/extramature{
	pixel_x = -4;
	pixel_y = -3
	},
/turf/open/floor/cult,
/area/lv624/lazarus/armory)
"aU" = (
/obj/effect/landmark/crap_item,
/turf/open/floor/cult,
/area/lv624/lazarus/armory)
"aV" = (
/turf/open/floor/cult,
/area/lv624/lazarus/armory)
"aW" = (
/obj/structure/window/reinforced{
	dir = 4
	},
/obj/structure/surface/table,
/obj/item/weapon/gun/revolver/spearhead,
/obj/item/ammo_magazine/revolver/spearhead,
/obj/item/ammo_magazine/revolver/spearhead,
/obj/item/ammo_magazine/revolver/spearhead,
/turf/open/floor/red/northeast,
/area/lv624/lazarus/security)
"aX" = (
/turf/open/floor/white,
/area/lv624/lazarus/main_hall)
"aY" = (
/obj/structure/machinery/door/airlock/almayer/secure/colony{
	locked = 1;
	name = "\improper Nexus Dome Armory"
	},
/turf/open/floor/cult,
/area/lv624/lazarus/armory)
"aZ" = (
/obj/structure/surface/rack,
/obj/item/storage/box/mousetraps{
	pixel_x = -5
	},
/obj/item/paper/lv_624/cheese{
	pixel_x = 8;
	pixel_y = -4
	},
/turf/open/floor/cult,
/area/lv624/lazarus/armory)
"mE" = (
/obj/item/handset{
	desc = "A model of an ancient Earth communication device.";
	force = 8
	},
/obj/structure/surface/rack{
	layer = 2.5
	},
/obj/structure/window/reinforced{
	dir = 8
	},
/obj/structure/window/reinforced{
	dir = 1
	},
/obj/structure/window/reinforced,
/turf/open/floor/wood,
/area/lv624/lazarus/main_hall)

(1,1,1) = {"
aX
aX
aX
aX
ai
ai
ai
ai
az
az
"}
(2,1,1) = {"
aH
aE
aE
aE
ai
aN
aG
ai
ai
ai
"}
(3,1,1) = {"
aX
aX
aI
ai
ai
ax
aV
aF
aS
ai
"}
(4,1,1) = {"
aX
aX
aX
ai
aJ
aV
aV
aV
aU
ai
"}
(5,1,1) = {"
aX
aX
aX
ai
aK
aR
aT
aZ
aV
ai
"}
(6,1,1) = {"
aM
aw
aX
ai
ai
ai
ai
ai
aY
ai
"}
(7,1,1) = {"
mE
aP
aX
aj
ad
aD
av
aW
av
aj
"}
