//MAP CONVERTED BY dmm2tgm.py THIS HEADER COMMENT PREVENTS RECONVERSION, DO NOT REMOVE
"i" = (
/turf/closed/wall/r_wall,
/area/lv624/lazarus/armory)
"j" = (
/turf/closed/wall/r_wall,
/area/lv624/lazarus/security)
"v" = (
/obj/structure/barricade/wooden{
	dir = 8
	},
/turf/open/floor/white,
/area/lv624/lazarus/main_hall)
"x" = (
/obj/effect/landmark/crap_item,
/turf/open/floor/cult,
/area/lv624/lazarus/armory)
"z" = (
/turf/closed/wall/strata_ice/jungle,
/area/lv624/ground/jungle/east_central_jungle)
"D" = (
/obj/effect/decal/cleanable/cobweb2,
/obj/item/reagent_container/hypospray/autoinjector/tricord,
/obj/structure/surface/rack{
	layer = 2.5
	},
/obj/item/reagent_container/hypospray/autoinjector/dexalinp{
	pixel_x = -2;
	pixel_y = -2
	},
/obj/item/reagent_container/hypospray/autoinjector/tricord,
/obj/effect/landmark/crap_item,
/obj/effect/landmark/crap_item,
/turf/open/floor/cult,
/area/lv624/lazarus/armory)
"E" = (
/obj/structure/machinery/deployable/barrier,
/obj/effect/decal/cleanable/cobweb,
/turf/open/floor/cult,
/area/lv624/lazarus/armory)
"F" = (
/obj/structure/machinery/door/airlock/almayer/secure/colony{
	locked = 1;
	name = "\improper Nexus Dome Armory"
	},
/turf/open/floor/cult,
/area/lv624/lazarus/armory)
"G" = (
/obj/structure/machinery/power/apc/no_power/west,
/turf/open/floor/cult,
/area/lv624/lazarus/armory)
"I" = (
/obj/item/handset{
	desc = "A model of an ancient Earth communication device.";
	force = 8
	},
/obj/structure/surface/rack{
	layer = 2.5
	},
/obj/structure/window/reinforced{
	dir = 8
	},
/obj/structure/window/reinforced{
	dir = 1
	},
/obj/structure/window/reinforced,
/turf/open/floor/wood,
/area/lv624/lazarus/main_hall)
"J" = (
/obj/structure/machinery/light/small{
	dir = 8
	},
/turf/open/floor/red/northeast,
/area/lv624/lazarus/security)
"K" = (
/obj/structure/machinery/light/small{
	dir = 1
	},
/obj/structure/surface/rack{
	layer = 2.5
	},
/obj/item/weapon/gun/pistol/highpower,
/obj/item/ammo_magazine/pistol/highpower,
/obj/item/ammo_magazine/pistol/highpower,
/obj/item/ammo_magazine/pistol/highpower,
/obj/item/explosive/grenade/flashbang,
/obj/item/explosive/grenade/flashbang,
/obj/item/ammo_magazine/shotgun/beanbag,
/turf/open/floor/cult,
/area/lv624/lazarus/armory)
"L" = (
/obj/structure/target/syndicate,
/turf/open/floor/red/northeast,
/area/lv624/lazarus/security)
"M" = (
/obj/structure/surface/rack{
	layer = 2.5
	},
/obj/item/weapon/gun/shotgun/pump,
/obj/item/ammo_magazine/shotgun/slugs,
/obj/item/ammo_magazine/shotgun/flechette,
/obj/item/ammo_magazine/shotgun/incendiary,
/turf/open/floor/cult,
/area/lv624/lazarus/armory)
"N" = (
/obj/structure/machinery/light/small,
/obj/effect/landmark/crap_item,
/turf/open/floor/white,
/area/lv624/lazarus/main_hall)
"O" = (
/obj/structure/window/reinforced{
	dir = 4
	},
/obj/structure/surface/table,
/obj/item/weapon/gun/revolver/cmb,
/obj/item/ammo_magazine/revolver/cmb,
/obj/item/ammo_magazine/revolver/cmb,
/obj/item/ammo_magazine/revolver/cmb,
/turf/open/floor/red/northeast,
/area/lv624/lazarus/security)
"P" = (
/obj/structure/surface/rack{
	layer = 2.5
	},
/obj/effect/landmark/crap_item,
/obj/effect/landmark/crap_item,
/obj/item/ammo_magazine/smg/m39/extended,
/obj/item/weapon/gun/smg/m39,
/turf/open/floor/cult,
/area/lv624/lazarus/armory)
"Q" = (
/obj/item/stack/sheet/wood,
/turf/open/floor/white,
/area/lv624/lazarus/main_hall)
"R" = (
/obj/item/storage/toolbox/syndicate,
/obj/structure/surface/rack{
	layer = 2.5
	},
/obj/effect/landmark/crap_item,
/obj/effect/landmark/crap_item,
/obj/item/ammo_magazine/smg/m39/extended,
/obj/item/weapon/gun/smg/m39,
/turf/open/floor/cult,
/area/lv624/lazarus/armory)
"S" = (
/turf/open/floor/whiteyellow/east,
/area/lv624/lazarus/main_hall)
"T" = (
/turf/open/floor/cult,
/area/lv624/lazarus/armory)
"U" = (
/turf/open/floor/red/northeast,
/area/lv624/lazarus/security)
"V" = (
/obj/structure/surface/rack,
/obj/item/explosive/plastic,
/obj/item/explosive/plastic,
/obj/item/explosive/grenade/high_explosive/pmc,
/obj/item/explosive/grenade/high_explosive/pmc,
/obj/item/explosive/grenade/high_explosive/pmc,
/obj/item/explosive/grenade/high_explosive/pmc,
/obj/structure/machinery/door_control{
	id = "garage_blast";
	name = "Garage Shutters";
	pixel_x = -26;
	range = 200
	},
/turf/open/floor/cult,
/area/lv624/lazarus/armory)
"W" = (
/turf/open/floor/whiteyellow/north,
/area/lv624/lazarus/main_hall)
"X" = (
/turf/open/floor/white,
/area/lv624/lazarus/main_hall)
"Y" = (
/turf/open/floor/whiteyellowcorner/east,
/area/lv624/lazarus/main_hall)
"Z" = (
/obj/structure/machinery/deployable/barrier,
/turf/open/floor/cult,
/area/lv624/lazarus/armory)

(1,1,1) = {"
X
X
X
X
i
i
i
i
z
z
"}
(2,1,1) = {"
Q
v
v
v
i
E
Z
i
i
i
"}
(3,1,1) = {"
X
X
N
i
i
K
T
G
V
i
"}
(4,1,1) = {"
X
X
X
i
M
T
T
T
x
i
"}
(5,1,1) = {"
X
X
X
i
D
P
P
R
T
i
"}
(6,1,1) = {"
S
Y
X
i
i
i
i
i
F
i
"}
(7,1,1) = {"
I
W
X
j
L
J
U
O
U
j
"}
