//MAP CONVERTED BY dmm2tgm.py THIS HEADER COMMENT PREVENTS RECONVERSION, DO NOT REMOVE
"a" = (
/turf/closed/wall/shiva/prefabricated/reinforced/hull,
/area/shiva/exterior/lz2_fortress)
"b" = (
/obj/item/lightstick/red/spoke/planted{
	pixel_x = 12;
	pixel_y = 25
	},
/turf/open/auto_turf/snow/layer1,
/area/shiva/exterior/cp_lz2)
"d" = (
/obj/item/stack/sheet/metal/small_stack,
/turf/open/floor/shiva/multi_tiles/north,
/area/shiva/exterior/lz2_fortress)
"e" = (
/obj/item/lightstick/red/spoke/planted{
	layer = 3.1;
	pixel_x = -13;
	pixel_y = 25
	},
/turf/open/auto_turf/snow/layer1,
/area/shiva/exterior/cp_lz2)
"f" = (
/obj/structure/machinery/landinglight/ds2/spoke{
	pixel_x = -2;
	pixel_y = 23
	},
/turf/closed/wall/shiva/prefabricated/reinforced/hull,
/area/shiva/exterior/lz2_fortress)
"g" = (
/obj/effect/decal/cleanable/ash,
/turf/open/floor/plating/plating_catwalk/shiva,
/area/shiva/exterior/lz2_fortress)
"h" = (
/obj/effect/decal/cleanable/ash,
/turf/open/auto_turf/snow/layer0,
/area/shiva/exterior/cp_lz2)
"i" = (
/turf/open/floor/shiva/floor3,
/area/shiva/exterior/lz2_fortress)
"m" = (
/turf/open/floor/shiva/radiator_tile,
/area/shiva/exterior/lz2_fortress)
"o" = (
/obj/structure/machinery/landinglight/ds2/spoke{
	pixel_x = -2;
	pixel_y = 22
	},
/turf/closed/wall/shiva/prefabricated/reinforced/hull,
/area/shiva/exterior/lz2_fortress)
"s" = (
/turf/open/auto_turf/snow/layer0,
/area/shiva/exterior/cp_lz2)
"v" = (
/obj/item/stack/sheet/metal/small_stack,
/turf/open/floor/shiva/floor3,
/area/shiva/exterior/lz2_fortress)
"y" = (
/obj/item/lightstick/red/spoke/planted{
	layer = 3.1;
	pixel_x = -13;
	pixel_y = 25
	},
/turf/open/floor/shiva/radiator_tile,
/area/shiva/exterior/lz2_fortress)
"C" = (
/turf/open/auto_turf/snow/layer2,
/area/shiva/exterior/cp_lz2)
"D" = (
/obj/structure/foamed_metal,
/turf/open/floor/shiva/north,
/area/shiva/exterior/lz2_fortress)
"E" = (
/obj/item/stack/sheet/metal/small_stack,
/turf/open/floor/shiva/radiator_tile,
/area/shiva/exterior/lz2_fortress)
"G" = (
/turf/open/floor/shiva/multi_tiles/north,
/area/shiva/exterior/lz2_fortress)
"J" = (
/obj/structure/machinery/landinglight/ds2/spoke{
	pixel_x = 1;
	pixel_y = 23
	},
/turf/closed/wall/shiva/prefabricated/reinforced/hull,
/area/shiva/exterior/lz2_fortress)
"K" = (
/obj/structure/foamed_metal,
/obj/effect/decal/cleanable/ash,
/turf/open/floor/shiva/north,
/area/shiva/exterior/lz2_fortress)
"L" = (
/turf/open/floor/plating/plating_catwalk/shiva,
/area/shiva/exterior/lz2_fortress)
"P" = (
/obj/item/weapon/gun/boltaction{
	pixel_x = -6
	},
/turf/open/floor/shiva/multi_tiles/north,
/area/shiva/exterior/lz2_fortress)
"Q" = (
/obj/structure/foamed_metal,
/turf/open/floor/plating/plating_catwalk/shiva,
/area/shiva/exterior/lz2_fortress)
"R" = (
/obj/structure/machinery/landinglight/ds2/spoke{
	pixel_x = 1;
	pixel_y = 22
	},
/turf/closed/wall/shiva/prefabricated/reinforced/hull,
/area/shiva/exterior/lz2_fortress)
"U" = (
/obj/item/lightstick/red/spoke/planted{
	pixel_x = 12;
	pixel_y = 25
	},
/turf/open/floor/shiva/radiator_tile,
/area/shiva/exterior/lz2_fortress)
"V" = (
/obj/structure/foamed_metal,
/turf/open/floor/shiva/multi_tiles/north,
/area/shiva/exterior/lz2_fortress)
"W" = (
/turf/open/auto_turf/snow/layer4,
/area/shiva/exterior/cp_lz2)
"Z" = (
/turf/open/floor/shiva/north,
/area/shiva/exterior/lz2_fortress)

(1,1,1) = {"
Z
a
a
a
a
a
a
W
"}
(2,1,1) = {"
Z
o
a
a
a
a
f
W
"}
(3,1,1) = {"
Z
y
Q
D
D
Q
E
e
"}
(4,1,1) = {"
i
P
Q
K
D
Q
G
h
"}
(5,1,1) = {"
v
V
Q
D
D
L
d
s
"}
(6,1,1) = {"
Z
U
g
D
K
Q
m
b
"}
(7,1,1) = {"
Z
R
a
a
a
a
J
C
"}
(8,1,1) = {"
D
a
a
a
a
a
a
C
"}
