//MAP CONVERTED BY dmm2tgm.py THIS HEADER COMMENT PREVENTS RECONVERSION, DO NOT REMOVE
"a" = (
/turf/closed/wall/shiva/prefabricated/reinforced/hull,
/area/shiva/exterior/lz2_fortress)
"f" = (
/obj/structure/machinery/door_control{
	id = "slz_shutters";
	pixel_x = -7
	},
/turf/closed/wall/shiva/prefabricated/reinforced/hull,
/area/shiva/exterior/lz2_fortress)
"i" = (
/obj/structure/machinery/door_control{
	id = "slz_shutters";
	pixel_x = -22
	},
/turf/open/floor/shiva{
	dir = 1
	},
/area/shiva/exterior/lz2_fortress)
"j" = (
/turf/open/floor/shiva{
	dir = 1
	},
/area/shiva/exterior/lz2_fortress)
"l" = (
/turf/open/floor/shiva{
	dir = 1;
	icon_state = "multi_tiles"
	},
/area/shiva/exterior/lz2_fortress)
"m" = (
/obj/structure/foamed_metal,
/turf/open/floor/shiva{
	dir = 1
	},
/area/shiva/exterior/lz2_fortress)
"o" = (
/obj/item/lightstick/red/spoke/planted{
	pixel_x = 12;
	pixel_y = 25
	},
/turf/open/auto_turf/snow/layer1,
/area/shiva/exterior/cp_lz2)
"q" = (
/obj/structure/machinery/door_control{
	id = "sslz_shutters";
	pixel_x = -22
	},
/turf/open/floor/shiva{
	icon_state = "radiator_tile"
	},
/area/shiva/exterior/lz2_fortress)
"r" = (
/obj/structure/machinery/door/poddoor/shutters/almayer{
	density = 0;
	dir = 2;
	id = "sslz_shutters";
	name = "\improper Landing Zone Shutters"
	},
/turf/open/floor/plating/plating_catwalk/shiva,
/area/shiva/exterior/lz2_fortress)
"t" = (
/turf/open/floor/shiva{
	icon_state = "floor3"
	},
/area/shiva/exterior/lz2_fortress)
"w" = (
/obj/item/lightstick/red/spoke/planted{
	layer = 3.1;
	pixel_x = -13;
	pixel_y = 25
	},
/obj/structure/machinery/door_control{
	id = "slz_shutters";
	pixel_x = -22
	},
/turf/open/floor/shiva{
	icon_state = "radiator_tile"
	},
/area/shiva/exterior/lz2_fortress)
"z" = (
/obj/structure/machinery/door/poddoor/shutters/almayer{
	density = 0;
	dir = 2;
	id = "slz_shutters";
	name = "\improper Landing Zone Shutters"
	},
/turf/open/floor/plating/plating_catwalk/shiva,
/area/shiva/exterior/lz2_fortress)
"B" = (
/turf/open/auto_turf/snow/layer0,
/area/shiva/exterior/cp_lz2)
"F" = (
/obj/item/lightstick/red/spoke/planted{
	layer = 3.1;
	pixel_x = -13;
	pixel_y = 25
	},
/turf/open/auto_turf/snow/layer1,
/area/shiva/exterior/cp_lz2)
"I" = (
/turf/open/auto_turf/snow/layer4,
/area/shiva/exterior/cp_lz2)
"J" = (
/obj/item/lightstick/red/spoke/planted{
	pixel_x = 12;
	pixel_y = 25
	},
/turf/open/floor/shiva{
	icon_state = "radiator_tile"
	},
/area/shiva/exterior/lz2_fortress)
"Q" = (
/obj/structure/machinery/door_control{
	id = "sslz_shutters";
	pixel_x = -22
	},
/turf/open/floor/shiva{
	dir = 1
	},
/area/shiva/exterior/lz2_fortress)
"T" = (
/obj/structure/machinery/door_control{
	id = "sslz_shutters";
	pixel_x = 25
	},
/turf/open/floor/shiva{
	icon_state = "radiator_tile"
	},
/area/shiva/exterior/lz2_fortress)
"V" = (
/turf/open/auto_turf/snow/layer2,
/area/shiva/exterior/cp_lz2)
"Z" = (
/obj/structure/machinery/door_control{
	id = "sslz_shutters";
	pixel_x = 25
	},
/turf/open/floor/shiva{
	dir = 1
	},
/area/shiva/exterior/lz2_fortress)

(1,1,1) = {"
j
a
a
a
a
a
a
I
"}
(2,1,1) = {"
j
a
a
a
a
a
a
I
"}
(3,1,1) = {"
j
w
z
i
Q
r
q
F
"}
(4,1,1) = {"
t
l
z
j
j
r
l
B
"}
(5,1,1) = {"
t
l
z
j
j
r
l
B
"}
(6,1,1) = {"
j
J
z
j
Z
r
T
o
"}
(7,1,1) = {"
j
f
a
f
a
a
a
V
"}
(8,1,1) = {"
m
a
a
a
a
a
a
V
"}
