//MAP CONVERTED BY dmm2tgm.py THIS HEADER COMMENT PREVENTS RECONVERSION, DO NOT REMOVE
"a" = (
/turf/closed/wall/rock/brown,
/area/whiskey_outpost/blackstone/underground)
"d" = (
/obj/structure/prop/rock/brown,
/turf/open/gm/dirt,
/area/whiskey_outpost/blackstone/underground/excavation_site)
"h" = (
/turf/open/gm/dirt,
/area/whiskey_outpost/blackstone/underground/excavation_site)
"w" = (
/obj/structure/prop/rock,
/turf/open/gm/dirt,
/area/whiskey_outpost/blackstone/underground/excavation_site)
"C" = (
/turf/closed/wall/mineral/sandstone/runed,
/area/whiskey_outpost/blackstone/underground/excavation_site)
"M" = (
/turf/closed/wall/mineral/sandstone/runed/decor,
/area/whiskey_outpost/blackstone/underground/excavation_site)
"N" = (
/turf/closed/wall/solaris/rock,
/area/whiskey_outpost/blackstone/underground/excavation_site)
"R" = (
/obj/effect/decal/sand_overlay/sand5/corner5{
	dir = 4
	},
/obj/structure/machinery/door/airlock/sandstone/runed{
	name = "Strange Temple"
	},
/turf/open/floor/sandstone/runed,
/area/whiskey_outpost/blackstone/underground/excavation_site)
"W" = (
/obj/effect/decal/sand_overlay/sand5,
/turf/open/floor/sandstone/runed,
/area/whiskey_outpost/blackstone/underground/excavation_site)

(1,1,1) = {"
a
a
a
a
a
a
a
"}
(2,1,1) = {"
a
a
N
C
N
C
a
"}
(3,1,1) = {"
M
W
w
h
w
C
a
"}
(4,1,1) = {"
R
W
d
w
d
N
a
"}
(5,1,1) = {"
M
W
h
d
h
C
a
"}
(6,1,1) = {"
a
a
N
C
N
C
a
"}
(7,1,1) = {"
a
a
a
a
a
a
a
"}
