//MAP CONVERTED BY dmm2tgm.py THIS HEADER COMMENT PREVENTS RECONVERSION, DO NOT REMOVE
"a" = (
/turf/template_noop,
/area/template_noop)
"f" = (
/obj/item/reagent_container/syringe/drugs,
/obj/item/reagent_container/syringe/drugs{
	pixel_x = 6;
	pixel_y = 7
	},
/obj/item/evidencebag{
	pixel_x = -6;
	pixel_y = -3
	},
/obj/item/clothing/mask/cigarette/weed{
	pixel_x = 7;
	pixel_y = -5
	},
/obj/item/clothing/mask/cigarette/weed{
	pixel_x = 7;
	pixel_y = 15
	},
/obj/item/weapon/gun/shotgun/merc{
	pixel_x = -1;
	pixel_y = 15
	},
/turf/open/jungle{
	bushes_spawn = 0;
	icon_state = "grass_impenetrable"
	},
/area/template_noop)
"l" = (
/obj/item/storage/backpack/satchel/lockable{
	pixel_y = -7
	},
/obj/item/spacecash/c500/counterfeit{
	pixel_x = -7;
	pixel_y = 13
	},
/obj/item/spacecash/c50{
	pixel_x = 10;
	pixel_y = 12
	},
/obj/item/clothing/mask/cigarette/weed{
	pixel_x = 10;
	pixel_y = 8
	},
/obj/item/paper/crumpled/bloody{
	pixel_x = 19;
	contents = "The contents are smeared with blood and impossible to make out."
	},
/turf/open/jungle{
	bushes_spawn = 0;
	icon_state = "grass_impenetrable"
	},
/area/template_noop)
"O" = (
/obj/structure/fence,
/turf/open/jungle{
	bushes_spawn = 0;
	icon_state = "grass_impenetrable"
	},
/area/template_noop)
"R" = (
/turf/open/jungle,
/area/template_noop)

(1,1,1) = {"
a
R
a
a
"}
(2,1,1) = {"
R
f
O
a
"}
(3,1,1) = {"
R
l
O
a
"}
(4,1,1) = {"
a
R
a
a
"}
