//MAP CONVERTED BY dmm2tgm.py THIS HEADER COMMENT PREVENTS RECONVERSION, DO NOT REMOVE
"ah" = (
/turf/closed/wall/solaris/reinforced,
/area/bigredv2/outside/marshal_office)
"ai" = (
/turf/closed/wall/solaris/rock,
/area/bigredv2/caves)
"aj" = (
/turf/open/mars,
/area/bigredv2/outside/n)
"at" = (
/turf/closed/wall/solaris,
/area/bigredv2/outside/marshal_office)
"aY" = (
/obj/effect/decal/cleanable/dirt,
/turf/open/floor,
/area/bigredv2/outside/marshal_office)
"aZ" = (
/obj/effect/decal/cleanable/dirt,
/obj/effect/landmark/crap_item,
/turf/open/floor,
/area/bigredv2/outside/marshal_office)
"ba" = (
/obj/structure/pipes/standard/simple/hidden/green{
	dir = 5
	},
/turf/open/floor,
/area/bigredv2/outside/marshal_office)
"bb" = (
/obj/structure/pipes/standard/simple/hidden/green{
	dir = 4
	},
/obj/effect/decal/cleanable/dirt,
/turf/open/floor,
/area/bigredv2/outside/marshal_office)
"bc" = (
/obj/structure/pipes/standard/simple/hidden/green{
	dir = 4
	},
/obj/effect/decal/cleanable/dirt,
/obj/effect/decal/cleanable/dirt,
/turf/open/floor,
/area/bigredv2/outside/marshal_office)
"bd" = (
/obj/structure/pipes/standard/simple/hidden/green{
	dir = 10
	},
/turf/open/floor,
/area/bigredv2/outside/marshal_office)
"bG" = (
/obj/structure/window/framed/solaris/reinforced,
/turf/open/floor/plating,
/area/bigredv2/outside/marshal_office)
"bL" = (
/obj/structure/window_frame/solaris,
/obj/item/shard,
/obj/item/stack/rods,
/turf/open/floor/plating,
/area/bigredv2/outside/marshal_office)
"co" = (
/obj/structure/window_frame/solaris,
/obj/item/shard,
/turf/open/floor/plating,
/area/bigredv2/outside/marshal_office)
"cp" = (
/obj/structure/window_frame/solaris,
/turf/open/floor/plating,
/area/bigredv2/outside/marshal_office)
"cs" = (
/obj/structure/pipes/standard/simple/hidden/green,
/turf/open/floor,
/area/bigredv2/outside/marshal_office)
"cD" = (
/obj/structure/machinery/light{
	dir = 1
	},
/turf/open/floor/redcorner/east,
/area/bigredv2/outside/marshal_office)
"cE" = (
/obj/structure/pipes/standard/manifold/fourway/hidden/green,
/obj/effect/landmark/crap_item,
/turf/open/floor,
/area/bigredv2/outside/marshal_office)
"cF" = (
/obj/structure/pipes/standard/simple/hidden/green{
	dir = 4
	},
/turf/open/floor,
/area/bigredv2/outside/marshal_office)
"cK" = (
/obj/structure/pipes/standard/manifold/hidden/green,
/obj/effect/decal/cleanable/dirt,
/turf/open/floor,
/area/bigredv2/outside/marshal_office)
"cL" = (
/obj/effect/decal/cleanable/dirt,
/obj/structure/pipes/standard/manifold/hidden/green{
	dir = 1
	},
/turf/open/floor,
/area/bigredv2/outside/marshal_office)
"cM" = (
/obj/structure/pipes/standard/simple/hidden/green{
	dir = 4
	},
/obj/effect/decal/cleanable/dirt,
/obj/item/clothing/shoes/black,
/turf/open/floor,
/area/bigredv2/outside/marshal_office)
"cX" = (
/obj/effect/decal/cleanable/dirt,
/obj/structure/pipes/standard/simple/hidden/green,
/obj/structure/machinery/door/airlock/multi_tile/almayer/generic{
	name = "\improper Marshal Office"
	},
/turf/open/floor,
/area/bigredv2/outside/marshal_office)
"cY" = (
/turf/open/floor,
/area/bigredv2/outside/marshal_office)
"dd" = (
/obj/effect/decal/cleanable/dirt,
/obj/structure/pipes/standard/simple/hidden/green,
/turf/open/floor,
/area/bigredv2/outside/marshal_office)
"di" = (
/obj/effect/decal/cleanable/dirt,
/obj/effect/landmark/survivor_spawner,
/turf/open/floor,
/area/bigredv2/outside/marshal_office)
"dj" = (
/turf/closed/wall/solaris/reinforced,
/area/bigredv2/outside/medical)
"dk" = (
/obj/structure/pipes/standard/simple/hidden/green,
/obj/structure/machinery/door/airlock/multi_tile/almayer/generic{
	name = "\improper Marshal Office"
	},
/turf/open/floor,
/area/bigredv2/outside/marshal_office)
"dH" = (
/obj/structure/pipes/standard/manifold/hidden/green{
	dir = 8
	},
/obj/item/ammo_casing/shell,
/turf/open/floor/dark,
/area/bigredv2/outside/marshal_office)
"dM" = (
/obj/effect/landmark/corpsespawner/prisoner,
/obj/effect/decal/cleanable/blood,
/turf/open/floor/redcorner,
/area/bigredv2/outside/marshal_office)
"eB" = (
/obj/structure/surface/table,
/obj/item/clothing/head/beret/sec/warden,
/turf/open/floor/dark,
/area/bigredv2/outside/marshal_office)
"fj" = (
/obj/structure/bed,
/turf/open/floor/dark,
/area/bigredv2/outside/marshal_office)
"fx" = (
/obj/structure/pipes/standard/simple/hidden/green,
/obj/structure/machinery/door/airlock/almayer/medical/glass/colony{
	dir = 1;
	name = "\improper Marshal Office Prison"
	},
/turf/open/floor/whitegreenfull/northeast,
/area/bigredv2/outside/marshal_office)
"fK" = (
/obj/structure/surface/table,
/obj/item/ore/diamond,
/obj/item/ore/uranium,
/turf/open/floor/bcircuit,
/area/bigredv2/outside/marshal_office)
"gl" = (
/obj/structure/closet/hydrant{
	pixel_y = 32
	},
/turf/open/floor/redcorner/east,
/area/bigredv2/outside/marshal_office)
"gm" = (
/obj/structure/machinery/camera/autoname{
	dir = 8
	},
/turf/open/floor/freezerfloor,
/area/bigredv2/outside/marshal_office)
"gp" = (
/obj/item/shard,
/turf/open/floor/redcorner/east,
/area/bigredv2/outside/marshal_office)
"hC" = (
/obj/structure/machinery/door/airlock/almayer/security/glass/colony{
	dir = 1;
	icon_state = "door_locked";
	name = "\improper Marshal Office Holding Cell"
	},
/turf/open/floor/dark,
/area/bigredv2/outside/marshal_office)
"ie" = (
/obj/structure/surface/table/reinforced,
/obj/structure/machinery/door/window/brigdoor/westright,
/turf/open/floor/vault2/west,
/area/bigredv2/outside/marshal_office)
"ih" = (
/obj/structure/pipes/standard/simple/hidden/green{
	dir = 4
	},
/turf/open/floor/dark,
/area/bigredv2/outside/marshal_office)
"jx" = (
/obj/structure/machinery/door/airlock/almayer/security/glass/colony{
	density = 0;
	dir = 1;
	icon_state = "door_open";
	name = "\improper Marshal Office Holding Cell"
	},
/turf/open/floor/dark,
/area/bigredv2/outside/marshal_office)
"jP" = (
/turf/open/mars/mars_dirt_10,
/area/bigredv2/outside/n)
"kj" = (
/obj/structure/machinery/light,
/turf/open/floor/redcorner,
/area/bigredv2/outside/marshal_office)
"kV" = (
/obj/structure/surface/table,
/obj/structure/machinery/camera/autoname{
	dir = 1
	},
/turf/open/floor/white,
/area/bigredv2/outside/marshal_office)
"li" = (
/obj/effect/decal/cleanable/dirt,
/obj/item/shard,
/turf/open/floor/redcorner/east,
/area/bigredv2/outside/marshal_office)
"lw" = (
/obj/effect/decal/cleanable/dirt,
/obj/effect/landmark/corpsespawner/prison_security,
/obj/effect/decal/cleanable/blood,
/obj/item/ammo_casing/shell,
/obj/item/weapon/gun/shotgun/pump/dual_tube/cmb,
/turf/open/floor/redcorner/west,
/area/bigredv2/outside/marshal_office)
"mp" = (
/obj/structure/pipes/standard/simple/hidden/green,
/turf/open/floor/redcorner,
/area/bigredv2/outside/marshal_office)
"mw" = (
/obj/structure/machinery/door/airlock/almayer/security/glass/colony{
	dir = 1;
	icon_state = "door_locked";
	name = "\improper Marshal Office Prison"
	},
/turf/open/floor/whitegreenfull/northeast,
/area/bigredv2/outside/marshal_office)
"mA" = (
/obj/structure/surface/table,
/turf/open/floor/white,
/area/bigredv2/outside/marshal_office)
"nl" = (
/obj/effect/decal/cleanable/dirt,
/turf/open/floor/redcorner,
/area/bigredv2/outside/marshal_office)
"nG" = (
/obj/effect/landmark/lv624/xeno_tunnel,
/turf/open/floor/asteroidfloor/north,
/area/bigredv2/outside/n)
"nH" = (
/obj/structure/surface/table,
/obj/item/device/radio,
/turf/open/floor/bcircuit,
/area/bigredv2/outside/marshal_office)
"oG" = (
/obj/effect/decal/cleanable/dirt,
/obj/item/shard,
/turf/open/floor/redcorner,
/area/bigredv2/outside/marshal_office)
"oN" = (
/obj/effect/decal/cleanable/dirt,
/obj/effect/decal/cleanable/blood{
	dir = 4;
	icon_state = "gib6"
	},
/obj/item/ammo_casing/shell,
/turf/open/floor/dark,
/area/bigredv2/outside/marshal_office)
"pd" = (
/obj/effect/decal/cleanable/dirt,
/obj/effect/decal/cleanable/dirt,
/turf/open/floor/dark,
/area/bigredv2/outside/marshal_office)
"pl" = (
/obj/structure/pipes/standard/simple/hidden/green,
/obj/structure/machinery/door/airlock/almayer/security/glass/colony{
	density = 0;
	dir = 1;
	icon_state = "door_open";
	name = "\improper Marshal Office Armory"
	},
/turf/open/floor/dark,
/area/bigredv2/outside/marshal_office)
"ps" = (
/obj/structure/pipes/standard/simple/hidden/green{
	dir = 4
	},
/turf/open/floor/redcorner/east,
/area/bigredv2/outside/marshal_office)
"pI" = (
/obj/structure/machinery/light{
	dir = 4
	},
/turf/open/floor/freezerfloor,
/area/bigredv2/outside/marshal_office)
"pM" = (
/obj/structure/pipes/vents/pump{
	dir = 1
	},
/turf/open/floor/redcorner,
/area/bigredv2/outside/marshal_office)
"pW" = (
/obj/structure/machinery/door/airlock/multi_tile/almayer/generic{
	name = "\improper Marshal Office Brig"
	},
/turf/open/floor/delivery,
/area/bigredv2/outside/marshal_office)
"qc" = (
/obj/effect/decal/cleanable/dirt,
/turf/open/floor/white,
/area/bigredv2/outside/marshal_office)
"qj" = (
/turf/open/mars/mars_dirt_13,
/area/bigredv2/outside/n)
"qB" = (
/obj/effect/decal/cleanable/dirt,
/turf/open/floor/redcorner/west,
/area/bigredv2/outside/marshal_office)
"qE" = (
/obj/effect/decal/cleanable/dirt,
/obj/item/frame/table,
/obj/structure/pipes/standard/simple/hidden/green,
/turf/open/floor/redcorner,
/area/bigredv2/outside/marshal_office)
"qJ" = (
/obj/structure/pipes/standard/simple/hidden/green,
/obj/effect/decal/cleanable/dirt,
/turf/open/floor/redcorner,
/area/bigredv2/outside/marshal_office)
"qS" = (
/turf/open/floor/asteroidwarning/north,
/area/bigredv2/outside/n)
"qZ" = (
/obj/structure/machinery/door/airlock/multi_tile/almayer/generic{
	dir = 1;
	name = "\improper Marshal Office"
	},
/turf/open/floor/red/west,
/area/bigredv2/outside/marshal_office)
"rZ" = (
/obj/item/ammo_casing/shell,
/turf/open/floor/redcorner/west,
/area/bigredv2/outside/marshal_office)
"sb" = (
/obj/structure/bed/chair{
	dir = 4
	},
/obj/effect/decal/cleanable/blood,
/turf/open/floor/white,
/area/bigredv2/outside/marshal_office)
"tk" = (
/obj/effect/decal/cleanable/dirt,
/obj/structure/machinery/computer/prisoner,
/turf/open/floor/dark,
/area/bigredv2/outside/marshal_office)
"ub" = (
/obj/structure/machinery/door/airlock/almayer/security/glass/colony{
	dir = 1;
	name = "\improper Marshal Office Checkpoint"
	},
/turf/open/floor/redfull/northwest,
/area/bigredv2/outside/marshal_office)
"um" = (
/obj/structure/pipes/standard/simple/hidden/green,
/turf/open/floor/dark,
/area/bigredv2/outside/marshal_office)
"uw" = (
/obj/structure/pipes/standard/simple/hidden/green{
	dir = 4
	},
/obj/effect/decal/cleanable/dirt,
/turf/open/floor/redcorner/east,
/area/bigredv2/outside/marshal_office)
"uA" = (
/obj/structure/surface/table,
/obj/effect/landmark/item_pool_spawner/survivor_ammo/buckshot,
/turf/open/floor/dark,
/area/bigredv2/outside/marshal_office)
"uK" = (
/obj/effect/decal/cleanable/dirt,
/turf/open/floor/dark,
/area/bigredv2/outside/marshal_office)
"uL" = (
/obj/structure/pipes/vents/pump,
/turf/open/floor/white,
/area/bigredv2/outside/marshal_office)
"uU" = (
/obj/structure/pipes/standard/simple/hidden/green,
/turf/open/floor/redcorner/east,
/area/bigredv2/outside/marshal_office)
"uX" = (
/obj/structure/bed,
/turf/open/floor/white,
/area/bigredv2/outside/marshal_office)
"vi" = (
/obj/structure/surface/rack,
/turf/open/floor/vault2/west,
/area/bigredv2/outside/marshal_office)
"wE" = (
/obj/structure/pipes/standard/simple/hidden/green{
	dir = 4
	},
/obj/structure/machinery/door_control{
	id = "Marshal Offices";
	name = "Storm Shutters";
	pixel_y = 24
	},
/turf/open/floor/redcorner/east,
/area/bigredv2/outside/marshal_office)
"wV" = (
/obj/structure/pipes/standard/simple/hidden/green{
	dir = 4
	},
/obj/structure/machinery/camera/autoname,
/turf/open/floor/redcorner/east,
/area/bigredv2/outside/marshal_office)
"xs" = (
/turf/open/floor/freezerfloor,
/area/bigredv2/outside/marshal_office)
"yj" = (
/obj/effect/landmark/hunter_secondary,
/turf/open/floor/redcorner/east,
/area/bigredv2/outside/marshal_office)
"ym" = (
/turf/open/floor/redcorner/west,
/area/bigredv2/outside/marshal_office)
"yN" = (
/turf/open/floor/white,
/area/bigredv2/outside/marshal_office)
"yO" = (
/obj/effect/decal/warning_stripes{
	icon_state = "N";
	pixel_y = 1
	},
/turf/open/floor/red,
/area/bigredv2/outside/marshal_office)
"yU" = (
/obj/structure/surface/rack,
/obj/item/weapon/gun/revolver/spearhead,
/turf/open/floor/vault2/west,
/area/bigredv2/outside/marshal_office)
"Aq" = (
/obj/structure/machinery/light{
	dir = 1
	},
/obj/item/ammo_casing/shell,
/turf/open/floor/dark,
/area/bigredv2/outside/marshal_office)
"AB" = (
/obj/structure/machinery/door/airlock/almayer/security/glass/colony{
	dir = 1;
	name = "\improper Marshal Office Evidence Room"
	},
/turf/open/floor/delivery,
/area/bigredv2/outside/marshal_office)
"BR" = (
/turf/open/mars_cave/mars_dirt_4,
/area/bigredv2/outside/n)
"BU" = (
/obj/structure/surface/table,
/obj/item/ammo_magazine/shotgun/buckshot,
/obj/structure/machinery/camera/autoname,
/turf/open/floor/dark,
/area/bigredv2/outside/marshal_office)
"Cf" = (
/obj/structure/machinery/power/apc/power/south,
/obj/structure/machinery/camera/autoname{
	dir = 1
	},
/turf/open/floor/dark,
/area/bigredv2/outside/marshal_office)
"Cg" = (
/obj/structure/machinery/computer/cameras,
/obj/structure/surface/table,
/turf/open/floor/bcircuit,
/area/bigredv2/outside/marshal_office)
"Cv" = (
/obj/item/shard,
/turf/open/floor/dark,
/area/bigredv2/outside/marshal_office)
"CL" = (
/obj/structure/surface/table,
/obj/effect/decal/cleanable/dirt,
/turf/open/floor/white,
/area/bigredv2/outside/marshal_office)
"CP" = (
/obj/structure/machinery/door/airlock/almayer/security/glass/colony{
	density = 0;
	dir = 1;
	icon_state = "door_open";
	name = "\improper Marshal Office Prison"
	},
/turf/open/floor/whitegreenfull/northeast,
/area/bigredv2/outside/marshal_office)
"Du" = (
/obj/structure/closet/l3closet/security,
/turf/open/floor/vault2/west,
/area/bigredv2/outside/marshal_office)
"DA" = (
/obj/structure/machinery/light{
	dir = 8
	},
/obj/effect/decal/warning_stripes{
	icon_state = "E";
	pixel_x = 1
	},
/turf/open/floor/red/west,
/area/bigredv2/outside/marshal_office)
"Eb" = (
/obj/structure/machinery/flasher/portable,
/turf/open/floor/vault2/west,
/area/bigredv2/outside/marshal_office)
"Ef" = (
/obj/effect/decal/cleanable/dirt,
/obj/structure/machinery/camera/autoname{
	dir = 1
	},
/turf/open/floor/redcorner,
/area/bigredv2/outside/marshal_office)
"Ei" = (
/obj/effect/landmark/static_comms/net_one,
/turf/open/floor/bcircuit,
/area/bigredv2/outside/marshal_office)
"Eu" = (
/obj/structure/surface/rack,
/obj/effect/landmark/item_pool_spawner/survivor_ammo/buckshot,
/obj/effect/landmark/item_pool_spawner/survivor_ammo/buckshot,
/turf/open/floor/dark,
/area/bigredv2/outside/marshal_office)
"EO" = (
/obj/structure/pipes/standard/simple/hidden/green,
/turf/open/floor/white,
/area/bigredv2/outside/marshal_office)
"ET" = (
/obj/structure/surface/table,
/obj/item/clothing/mask/gas,
/obj/item/clothing/mask/gas,
/turf/open/floor/dark,
/area/bigredv2/outside/marshal_office)
"EV" = (
/turf/open/floor/asteroidwarning/northwest,
/area/bigredv2/outside/n)
"Fc" = (
/obj/structure/surface/table/reinforced,
/obj/structure/machinery/door/window/brigdoor/eastleft,
/obj/item/weapon/shield/riot,
/turf/open/floor/vault2/west,
/area/bigredv2/outside/marshal_office)
"Fk" = (
/obj/effect/decal/cleanable/dirt,
/turf/open/floor/whitegreen/east,
/area/bigredv2/outside/marshal_office)
"FI" = (
/obj/effect/decal/warning_stripes{
	icon_state = "SE-out";
	pixel_x = 1;
	pixel_y = -1
	},
/turf/open/floor/red/northwest,
/area/bigredv2/outside/marshal_office)
"FR" = (
/obj/structure/surface/table,
/obj/structure/machinery/light{
	dir = 8
	},
/turf/open/floor/white,
/area/bigredv2/outside/marshal_office)
"Go" = (
/obj/structure/surface/rack,
/obj/item/ammo_magazine/revolver/spearhead,
/turf/open/floor/vault2/west,
/area/bigredv2/outside/marshal_office)
"GU" = (
/obj/effect/decal/warning_stripes{
	icon_state = "NE-out";
	pixel_x = 1;
	pixel_y = 1
	},
/turf/open/floor/red/southwest,
/area/bigredv2/outside/marshal_office)
"GV" = (
/obj/effect/decal/warning_stripes{
	icon_state = "E";
	pixel_x = 1
	},
/turf/open/floor/red/west,
/area/bigredv2/outside/marshal_office)
"JE" = (
/obj/effect/decal/cleanable/dirt,
/turf/open/floor/redcorner/east,
/area/bigredv2/outside/marshal_office)
"Kc" = (
/obj/effect/decal/cleanable/dirt,
/obj/effect/decal/cleanable/blood{
	dir = 4;
	icon_state = "gib6"
	},
/turf/open/floor/redcorner,
/area/bigredv2/outside/marshal_office)
"KI" = (
/obj/effect/decal/cleanable/dirt,
/obj/effect/landmark/corpsespawner/prisoner,
/obj/effect/decal/cleanable/blood,
/obj/item/tool/screwdriver,
/turf/open/floor/dark,
/area/bigredv2/outside/marshal_office)
"Lf" = (
/obj/structure/bed/chair{
	dir = 8
	},
/obj/effect/landmark/corpsespawner/prisoner,
/turf/open/floor/white,
/area/bigredv2/outside/marshal_office)
"Ly" = (
/obj/structure/window/framed/solaris/reinforced,
/obj/structure/machinery/door/poddoor/shutters/almayer{
	id = "Marshal Offices";
	name = "\improper Marshal Offices Shutters"
	},
/turf/open/floor/plating,
/area/bigredv2/outside/medical)
"Mi" = (
/obj/structure/closet/secure_closet/brig,
/turf/open/floor/dark,
/area/bigredv2/outside/marshal_office)
"Mx" = (
/turf/open/floor/dark,
/area/bigredv2/outside/marshal_office)
"MH" = (
/turf/open/floor/bcircuit,
/area/bigredv2/outside/marshal_office)
"Nd" = (
/obj/structure/pipes/standard/simple/hidden/green,
/turf/open/floor/delivery,
/area/bigredv2/outside/marshal_office)
"Nk" = (
/turf/open/floor/redcorner/east,
/area/bigredv2/outside/marshal_office)
"Ns" = (
/obj/structure/sink{
	pixel_y = 32
	},
/turf/open/floor/freezerfloor,
/area/bigredv2/outside/marshal_office)
"Nv" = (
/obj/structure/machinery/camera/autoname,
/obj/effect/decal/warning_stripes{
	icon_state = "SW-out";
	pixel_x = -1;
	pixel_y = -1
	},
/turf/open/floor/red/northeast,
/area/bigredv2/outside/marshal_office)
"NF" = (
/obj/structure/surface/rack,
/obj/item/clothing/accessory/storage/black_vest,
/turf/open/floor/dark,
/area/bigredv2/outside/marshal_office)
"NT" = (
/obj/structure/pipes/standard/simple/hidden/green,
/obj/effect/decal/cleanable/dirt,
/turf/open/floor/dark,
/area/bigredv2/outside/marshal_office)
"Ob" = (
/obj/effect/decal/cleanable/dirt,
/obj/effect/landmark/crap_item,
/turf/open/floor/dark,
/area/bigredv2/outside/marshal_office)
"OR" = (
/obj/structure/machinery/door_control{
	id = "Marshal Offices";
	name = "Storm Shutters";
	pixel_x = -32
	},
/turf/open/floor/redfull/northwest,
/area/bigredv2/outside/marshal_office)
"OS" = (
/obj/structure/closet/secure_closet/marshal,
/turf/open/floor/dark,
/area/bigredv2/outside/marshal_office)
"Qd" = (
/obj/structure/machinery/door/airlock/almayer/generic{
	dir = 1;
	name = "\improper Marshal Office Prison Toilet"
	},
/turf/open/floor/freezerfloor,
/area/bigredv2/outside/marshal_office)
"QE" = (
/obj/effect/landmark/survivor_spawner,
/turf/open/floor/redcorner/east,
/area/bigredv2/outside/marshal_office)
"QF" = (
/obj/structure/surface/table/reinforced,
/obj/structure/machinery/door/window/brigdoor/southright,
/turf/open/floor/vault2/west,
/area/bigredv2/outside/marshal_office)
"QL" = (
/obj/structure/machinery/door/airlock/almayer/medical/glass/colony{
	dir = 1;
	name = "\improper Marshal Office Prison"
	},
/turf/open/floor/whitegreenfull/northeast,
/area/bigredv2/outside/marshal_office)
"Rh" = (
/obj/effect/landmark/corpsespawner/prisoner,
/obj/effect/decal/cleanable/blood,
/turf/open/floor/dark,
/area/bigredv2/outside/marshal_office)
"Rl" = (
/obj/structure/pipes/standard/simple/hidden/green{
	dir = 4
	},
/turf/open/floor/red/west,
/area/bigredv2/outside/marshal_office)
"Rz" = (
/turf/open/floor/asteroidwarning/east,
/area/bigredv2/outside/n)
"RE" = (
/obj/structure/surface/rack,
/obj/structure/machinery/light{
	dir = 1
	},
/obj/item/ammo_magazine/revolver/spearhead,
/turf/open/floor/vault2/west,
/area/bigredv2/outside/marshal_office)
"RZ" = (
/obj/structure/toilet{
	dir = 4
	},
/obj/effect/landmark/monkey_spawn,
/turf/open/floor/freezerfloor,
/area/bigredv2/outside/marshal_office)
"Sj" = (
/obj/structure/closet/l3closet/security,
/obj/structure/machinery/light{
	dir = 1
	},
/turf/open/floor/vault2/west,
/area/bigredv2/outside/marshal_office)
"Sq" = (
/obj/structure/machinery/alarm{
	dir = 1;
	pixel_y = -30
	},
/turf/open/floor/redcorner,
/area/bigredv2/outside/marshal_office)
"Sw" = (
/obj/structure/surface/table,
/obj/item/ore/uranium,
/turf/open/floor/bcircuit,
/area/bigredv2/outside/marshal_office)
"ST" = (
/obj/effect/decal/cleanable/dirt,
/obj/item/shard,
/turf/open/floor/dark,
/area/bigredv2/outside/marshal_office)
"To" = (
/obj/effect/decal/cleanable/dirt,
/obj/effect/landmark/corpsespawner/prisoner,
/obj/effect/decal/cleanable/blood,
/obj/item/tool/kitchen/knife,
/turf/open/floor/redcorner,
/area/bigredv2/outside/marshal_office)
"Ty" = (
/obj/structure/machinery/deployable/barrier,
/turf/open/floor/vault2/west,
/area/bigredv2/outside/marshal_office)
"TX" = (
/obj/structure/machinery/camera/autoname{
	dir = 4
	},
/turf/open/floor/bcircuit,
/area/bigredv2/outside/marshal_office)
"Ua" = (
/obj/structure/machinery/light,
/turf/open/floor/dark,
/area/bigredv2/outside/marshal_office)
"Uc" = (
/obj/effect/decal/warning_stripes{
	icon_state = "S";
	pixel_y = -1
	},
/turf/open/floor/red/north,
/area/bigredv2/outside/marshal_office)
"Up" = (
/turf/open/floor/redcorner,
/area/bigredv2/outside/marshal_office)
"UH" = (
/obj/structure/mirror{
	icon_state = "mirror_broke";
	pixel_x = 30
	},
/obj/item/tool/soap/deluxe,
/turf/open/floor/freezerfloor,
/area/bigredv2/outside/marshal_office)
"UO" = (
/obj/structure/machinery/light{
	dir = 8
	},
/turf/open/floor/redfull/northwest,
/area/bigredv2/outside/marshal_office)
"Ve" = (
/obj/structure/pipes/standard/simple/hidden/green,
/obj/structure/machinery/door/airlock/almayer/security/glass/colony{
	dir = 1;
	icon_state = "door_locked";
	name = "\improper Marshal Office Prison"
	},
/turf/open/floor/whitegreenfull/northeast,
/area/bigredv2/outside/marshal_office)
"Vh" = (
/obj/structure/surface/rack,
/obj/item/ammo_magazine/shotgun,
/obj/effect/decal/cleanable/dirt,
/turf/open/floor/dark,
/area/bigredv2/outside/marshal_office)
"Vl" = (
/obj/structure/pipes/standard/simple/hidden/green{
	dir = 4
	},
/obj/structure/machinery/door/airlock/almayer/security/glass/colony{
	icon_state = "door_locked";
	name = "\improper Marshal Office Armory"
	},
/turf/open/floor/dark,
/area/bigredv2/outside/marshal_office)
"Vp" = (
/obj/effect/landmark/corpsespawner/prison_security,
/obj/effect/decal/cleanable/blood,
/turf/open/floor/dark,
/area/bigredv2/outside/marshal_office)
"Vv" = (
/obj/structure/machinery/light,
/turf/open/floor/bcircuit,
/area/bigredv2/outside/marshal_office)
"VG" = (
/obj/effect/decal/warning_stripes{
	icon_state = "NW-out";
	pixel_x = -1;
	pixel_y = 1
	},
/turf/open/floor/red/southeast,
/area/bigredv2/outside/marshal_office)
"VH" = (
/obj/structure/surface/rack,
/obj/item/clothing/suit/armor/riot,
/turf/open/floor/dark,
/area/bigredv2/outside/marshal_office)
"Wx" = (
/obj/effect/decal/cleanable/blood,
/obj/effect/decal/cleanable/dirt,
/turf/open/floor/white,
/area/bigredv2/outside/marshal_office)
"Xg" = (
/obj/structure/machinery/computer/secure_data,
/obj/structure/surface/table,
/turf/open/floor/dark,
/area/bigredv2/outside/marshal_office)
"Xl" = (
/obj/structure/surface/table,
/turf/open/floor/redfull/northwest,
/area/bigredv2/outside/marshal_office)
"XD" = (
/obj/structure/pipes/vents/pump,
/obj/effect/decal/cleanable/dirt,
/turf/open/floor/dark,
/area/bigredv2/outside/marshal_office)
"XI" = (
/obj/structure/surface/rack,
/obj/item/weapon/gun/shotgun/pump/dual_tube/cmb,
/turf/open/floor/dark,
/area/bigredv2/outside/marshal_office)
"XM" = (
/obj/structure/pipes/standard/simple/hidden/green,
/obj/effect/decal/cleanable/dirt,
/obj/item/ammo_casing/shell,
/turf/open/floor/redcorner,
/area/bigredv2/outside/marshal_office)
"Yv" = (
/obj/structure/machinery/light{
	dir = 4
	},
/turf/open/floor/whitegreen/east,
/area/bigredv2/outside/marshal_office)
"Zw" = (
/obj/structure/bed/chair/office/dark{
	dir = 4
	},
/turf/open/floor/redfull/northwest,
/area/bigredv2/outside/marshal_office)
"ZB" = (
/obj/effect/decal/warning_stripes{
	icon_state = "W";
	layer = 2.5;
	pixel_x = -1
	},
/turf/open/floor/red/east,
/area/bigredv2/outside/marshal_office)
"ZN" = (
/obj/effect/decal/cleanable/dirt,
/obj/effect/landmark/good_item,
/turf/open/floor/redcorner,
/area/bigredv2/outside/marshal_office)

(1,1,1) = {"
qc
yN
yN
QL
yN
yN
mw
yj
aY
kj
ah
MH
TX
MH
MH
at
Rl
qZ
ah
ah
ah
dj
"}
(2,1,1) = {"
yN
qc
qc
at
uX
uX
ah
JE
aY
Up
ah
MH
Mx
Mx
Mx
at
ps
Up
bG
Mx
Mi
dj
"}
(3,1,1) = {"
mA
qc
Wx
at
at
at
ah
JE
aY
Up
ah
Cg
Mx
Mx
Mx
AB
ps
Kc
jx
Mx
Ua
dj
"}
(4,1,1) = {"
mA
qc
qc
at
FR
kV
ah
JE
aZ
Up
ah
fK
nH
Sw
Vv
at
ps
To
bG
Mx
fj
dj
"}
(5,1,1) = {"
Lf
uL
EO
fx
EO
EO
Ve
uU
ba
Ef
ah
at
at
at
at
at
wE
nl
ah
ah
ah
dj
"}
(6,1,1) = {"
sb
yN
yN
at
uX
uX
ah
Nk
bb
nl
ah
FI
GV
DA
GU
Mx
ps
nl
bG
Mx
Mi
dj
"}
(7,1,1) = {"
mA
yN
qc
at
at
at
ah
Nk
bb
ZN
ah
Uc
MH
Ei
yO
Mx
wV
nl
hC
Mx
Ua
dj
"}
(8,1,1) = {"
CL
yN
yN
at
FR
kV
ah
Nk
bc
nl
ah
Uc
MH
MH
yO
Mx
uw
oG
bL
Mx
fj
dj
"}
(9,1,1) = {"
qc
qc
qc
QL
yN
yN
CP
Nk
bc
dM
ah
Nv
ZB
ZB
VG
Mx
uw
Up
ah
ah
ah
dj
"}
(10,1,1) = {"
Yv
Fk
Fk
at
uX
uX
ah
Nk
bb
kj
ah
Mx
Mx
Mx
Mx
Mx
uw
Up
bG
Mx
Mi
dj
"}
(11,1,1) = {"
ah
Ns
xs
at
at
at
ah
Nk
bb
nl
pW
ym
qB
qB
lw
rZ
bb
Up
jx
Mx
Ua
dj
"}
(12,1,1) = {"
ah
UH
gm
Qd
pI
RZ
ah
Nk
bd
qJ
Nd
mp
qJ
qJ
XM
cs
cE
pM
bG
Rh
fj
dj
"}
(13,1,1) = {"
ah
ah
ah
ah
ah
ah
ah
ah
ah
ah
ah
bG
ie
bG
ah
gl
cF
Sq
ah
ah
ah
dj
"}
(14,1,1) = {"
ai
ai
Rz
nG
ah
Eb
Ty
Ty
Ty
ah
OS
Mx
Mx
ET
bG
JE
bc
Up
bL
Mx
Mi
dj
"}
(15,1,1) = {"
aj
aj
aj
qS
ah
Sj
Mx
Mx
Mx
ah
uA
Mx
Mx
ET
bG
QE
bc
oG
hC
Mx
Ua
dj
"}
(16,1,1) = {"
aj
aj
aj
qS
ah
Du
Mx
NF
Mx
ah
uA
Mx
uK
Mx
QF
JE
bb
nl
bG
Mx
fj
dj
"}
(17,1,1) = {"
aj
aj
qj
qS
ah
Du
uK
XI
Mx
ah
BU
oN
Ob
VH
co
li
bb
nl
ah
ah
ah
dj
"}
(18,1,1) = {"
aj
aj
jP
ai
ah
vi
uK
Vh
Cf
ah
eB
KI
ST
VH
cp
gp
cF
nl
ub
OR
UO
Ly
"}
(19,1,1) = {"
aj
qj
BR
ai
ah
Go
uK
Eu
Ua
ah
Aq
uK
pd
Cv
bL
Nk
bb
nl
bG
Xl
Zw
Ly
"}
(20,1,1) = {"
qj
BR
ai
ai
ah
yU
uK
XD
um
pl
um
um
dH
NT
pl
uU
cK
nl
ah
bG
bG
dj
"}
(21,1,1) = {"
EV
ai
ai
ai
ah
RE
Mx
uK
Mx
ah
Xg
Vp
ih
tk
ah
Nk
cL
qE
cX
dd
dd
dk
"}
(22,1,1) = {"
qS
ah
ah
ah
ah
ah
ah
Fc
ah
ah
ah
bL
Vl
bG
ah
cD
cM
nl
cY
cY
di
cY
"}
