//MAP CONVERTED BY dmm2tgm.py THIS HEADER COMMENT PREVENTS RECONVERSION, DO NOT REMOVE
"ah" = (
/turf/closed/wall/solaris/reinforced,
/area/bigredv2/outside/marshal_office)
"ai" = (
/turf/closed/wall/solaris/rock,
/area/bigredv2/caves)
"aj" = (
/turf/open/mars,
/area/bigredv2/outside/n)
"at" = (
/turf/closed/wall/solaris,
/area/bigredv2/outside/marshal_office)
"aY" = (
/obj/effect/decal/cleanable/dirt,
/turf/open/floor,
/area/bigredv2/outside/marshal_office)
"aZ" = (
/obj/effect/decal/cleanable/dirt,
/obj/effect/landmark/crap_item,
/turf/open/floor,
/area/bigredv2/outside/marshal_office)
"ba" = (
/obj/structure/pipes/standard/simple/hidden/green{
	dir = 5
	},
/turf/open/floor,
/area/bigredv2/outside/marshal_office)
"bb" = (
/obj/structure/pipes/standard/simple/hidden/green{
	dir = 4
	},
/obj/effect/decal/cleanable/dirt,
/turf/open/floor,
/area/bigredv2/outside/marshal_office)
"bc" = (
/obj/structure/pipes/standard/simple/hidden/green{
	dir = 4
	},
/obj/effect/decal/cleanable/dirt,
/obj/effect/decal/cleanable/dirt,
/turf/open/floor,
/area/bigredv2/outside/marshal_office)
"bd" = (
/obj/structure/pipes/standard/simple/hidden/green{
	dir = 10
	},
/turf/open/floor,
/area/bigredv2/outside/marshal_office)
"bG" = (
/obj/structure/window/framed/solaris/reinforced,
/turf/open/floor/plating,
/area/bigredv2/outside/marshal_office)
"bL" = (
/obj/structure/window_frame/solaris,
/obj/item/shard,
/obj/item/stack/rods,
/turf/open/floor/plating,
/area/bigredv2/outside/marshal_office)
"co" = (
/obj/structure/window_frame/solaris,
/obj/item/shard,
/turf/open/floor/plating,
/area/bigredv2/outside/marshal_office)
"cp" = (
/obj/structure/window_frame/solaris,
/turf/open/floor/plating,
/area/bigredv2/outside/marshal_office)
"cs" = (
/obj/structure/pipes/standard/simple/hidden/green,
/turf/open/floor,
/area/bigredv2/outside/marshal_office)
"cE" = (
/obj/structure/pipes/standard/manifold/fourway/hidden/green,
/obj/effect/landmark/crap_item,
/turf/open/floor,
/area/bigredv2/outside/marshal_office)
"cF" = (
/obj/structure/pipes/standard/simple/hidden/green{
	dir = 4
	},
/turf/open/floor,
/area/bigredv2/outside/marshal_office)
"cK" = (
/obj/structure/pipes/standard/manifold/hidden/green,
/obj/effect/decal/cleanable/dirt,
/turf/open/floor,
/area/bigredv2/outside/marshal_office)
"cL" = (
/obj/effect/decal/cleanable/dirt,
/obj/structure/pipes/standard/manifold/hidden/green{
	dir = 1
	},
/turf/open/floor,
/area/bigredv2/outside/marshal_office)
"cM" = (
/obj/structure/pipes/standard/simple/hidden/green{
	dir = 4
	},
/obj/effect/decal/cleanable/dirt,
/obj/item/clothing/shoes/black,
/turf/open/floor,
/area/bigredv2/outside/marshal_office)
"cX" = (
/obj/effect/decal/cleanable/dirt,
/obj/structure/pipes/standard/simple/hidden/green,
/obj/structure/machinery/door/airlock/multi_tile/almayer/generic{
	name = "\improper Marshal Office"
	},
/turf/open/floor,
/area/bigredv2/outside/marshal_office)
"cY" = (
/turf/open/floor,
/area/bigredv2/outside/marshal_office)
"dd" = (
/obj/effect/decal/cleanable/dirt,
/obj/structure/pipes/standard/simple/hidden/green,
/turf/open/floor,
/area/bigredv2/outside/marshal_office)
"di" = (
/obj/effect/decal/cleanable/dirt,
/obj/effect/landmark/survivor_spawner,
/turf/open/floor,
/area/bigredv2/outside/marshal_office)
"dj" = (
/turf/closed/wall/solaris/reinforced,
/area/bigredv2/outside/medical)
"dk" = (
/obj/structure/pipes/standard/simple/hidden/green,
/obj/structure/machinery/door/airlock/multi_tile/almayer/generic{
	name = "\improper Marshal Office"
	},
/turf/open/floor,
/area/bigredv2/outside/marshal_office)
"dn" = (
/obj/structure/pipes/standard/simple/hidden/green,
/obj/structure/machinery/door/airlock/almayer/security/glass/colony{
	density = 0;
	dir = 1;
	icon_state = "door_open";
	name = "\improper Marshal Office Armory"
	},
/turf/open/floor/dark,
/area/bigredv2/outside/marshal_office)
"dy" = (
/obj/structure/pipes/standard/simple/hidden/green,
/obj/structure/machinery/door/airlock/almayer/security/glass/colony{
	dir = 1;
	icon_state = "door_locked";
	name = "\improper Marshal Office Prison"
	},
/turf/open/floor/whitegreenfull/northeast,
/area/bigredv2/outside/marshal_office)
"dA" = (
/obj/effect/decal/cleanable/dirt,
/obj/effect/decal/cleanable/blood{
	dir = 4;
	icon_state = "gib6"
	},
/obj/item/ammo_casing/shell,
/turf/open/floor/dark,
/area/bigredv2/outside/marshal_office)
"fc" = (
/obj/structure/machinery/light,
/turf/open/floor/dark,
/area/bigredv2/outside/marshal_office)
"ff" = (
/obj/structure/surface/table,
/obj/item/ore/diamond,
/obj/item/ore/uranium,
/turf/open/floor/bcircuit,
/area/bigredv2/outside/marshal_office)
"fl" = (
/obj/structure/machinery/light{
	dir = 4
	},
/turf/open/floor/freezerfloor,
/area/bigredv2/outside/marshal_office)
"fn" = (
/obj/effect/landmark/corpsespawner/prisoner,
/obj/effect/decal/cleanable/blood,
/turf/open/floor/dark,
/area/bigredv2/outside/marshal_office)
"ft" = (
/turf/open/floor/freezerfloor,
/area/bigredv2/outside/marshal_office)
"gh" = (
/obj/structure/bed/chair{
	dir = 4
	},
/obj/effect/decal/cleanable/blood,
/turf/open/floor/white,
/area/bigredv2/outside/marshal_office)
"gM" = (
/obj/structure/bed/chair/office/dark{
	dir = 4
	},
/turf/open/floor/redfull/northwest,
/area/bigredv2/outside/marshal_office)
"hy" = (
/obj/structure/surface/table,
/obj/structure/machinery/camera/autoname{
	dir = 1
	},
/turf/open/floor/white,
/area/bigredv2/outside/marshal_office)
"hJ" = (
/obj/structure/pipes/vents/pump,
/turf/open/floor/white,
/area/bigredv2/outside/marshal_office)
"iZ" = (
/turf/open/floor/asteroidwarning/north,
/area/bigredv2/outside/n)
"jp" = (
/obj/structure/pipes/vents/pump,
/obj/effect/decal/cleanable/dirt,
/turf/open/floor/dark,
/area/bigredv2/outside/marshal_office)
"jr" = (
/obj/structure/machinery/door/airlock/almayer/security/glass/colony{
	dir = 1;
	icon_state = "door_locked";
	name = "\improper Marshal Office Prison"
	},
/turf/open/floor/whitegreenfull/northeast,
/area/bigredv2/outside/marshal_office)
"js" = (
/obj/structure/pipes/standard/simple/hidden/green{
	dir = 4
	},
/obj/effect/decal/cleanable/dirt,
/turf/open/floor/redcorner/east,
/area/bigredv2/outside/marshal_office)
"kk" = (
/obj/structure/pipes/standard/simple/hidden/green,
/turf/open/floor/delivery,
/area/bigredv2/outside/marshal_office)
"kr" = (
/obj/effect/decal/cleanable/dirt,
/obj/effect/decal/cleanable/dirt,
/turf/open/floor/dark,
/area/bigredv2/outside/marshal_office)
"kE" = (
/turf/open/mars/mars_dirt_13,
/area/bigredv2/outside/n)
"kV" = (
/obj/structure/machinery/door/airlock/almayer/security/glass/colony{
	dir = 1;
	icon_state = "door_locked";
	name = "\improper Marshal Office Holding Cell"
	},
/turf/open/floor/dark,
/area/bigredv2/outside/marshal_office)
"mv" = (
/obj/effect/decal/cleanable/dirt,
/obj/structure/machinery/computer/prisoner,
/turf/open/floor/dark,
/area/bigredv2/outside/marshal_office)
"mD" = (
/obj/structure/machinery/light{
	dir = 8
	},
/obj/effect/decal/warning_stripes{
	icon_state = "E";
	pixel_x = 1
	},
/turf/open/floor/red/west,
/area/bigredv2/outside/marshal_office)
"nk" = (
/obj/effect/decal/cleanable/dirt,
/obj/effect/landmark/good_item,
/turf/open/floor/redcorner,
/area/bigredv2/outside/marshal_office)
"nn" = (
/obj/structure/pipes/standard/simple/hidden/green,
/turf/open/floor/redcorner/east,
/area/bigredv2/outside/marshal_office)
"nr" = (
/obj/structure/surface/table,
/obj/item/ammo_magazine/shotgun/buckshot,
/obj/structure/machinery/camera/autoname,
/turf/open/floor/dark,
/area/bigredv2/outside/marshal_office)
"nt" = (
/obj/structure/pipes/standard/simple/hidden/green,
/obj/effect/decal/cleanable/dirt,
/obj/item/ammo_casing/shell,
/turf/open/floor/redcorner,
/area/bigredv2/outside/marshal_office)
"nx" = (
/obj/structure/machinery/light{
	dir = 8
	},
/turf/open/floor/redfull/northwest,
/area/bigredv2/outside/marshal_office)
"nC" = (
/obj/structure/pipes/standard/simple/hidden/green{
	dir = 4
	},
/obj/structure/machinery/door_control{
	id = "Marshal Offices";
	name = "Storm Shutters";
	pixel_y = 24
	},
/turf/open/floor/redcorner/east,
/area/bigredv2/outside/marshal_office)
"nD" = (
/obj/structure/pipes/vents/pump{
	dir = 1
	},
/turf/open/floor/redcorner,
/area/bigredv2/outside/marshal_office)
"nH" = (
/obj/effect/decal/cleanable/dirt,
/turf/open/floor/redcorner/west,
/area/bigredv2/outside/marshal_office)
"nJ" = (
/turf/open/floor/redcorner/east,
/area/bigredv2/outside/marshal_office)
"nY" = (
/obj/effect/landmark/lv624/xeno_tunnel,
/turf/open/floor/asteroidfloor/north,
/area/bigredv2/outside/n)
"oS" = (
/obj/structure/pipes/standard/manifold/hidden/green{
	dir = 8
	},
/obj/item/ammo_casing/shell,
/turf/open/floor/dark,
/area/bigredv2/outside/marshal_office)
"pW" = (
/obj/structure/pipes/standard/simple/hidden/green{
	dir = 4
	},
/turf/open/floor/red/west,
/area/bigredv2/outside/marshal_office)
"pX" = (
/obj/structure/closet/l3closet/security,
/turf/open/floor/vault2/west,
/area/bigredv2/outside/marshal_office)
"qf" = (
/obj/structure/surface/rack,
/obj/item/ammo_magazine/shotgun,
/obj/effect/decal/cleanable/dirt,
/turf/open/floor/dark,
/area/bigredv2/outside/marshal_office)
"qg" = (
/obj/effect/decal/cleanable/dirt,
/obj/item/shard,
/turf/open/floor/redcorner/east,
/area/bigredv2/outside/marshal_office)
"ra" = (
/obj/structure/bed/chair{
	dir = 8
	},
/obj/effect/landmark/corpsespawner/prisoner,
/turf/open/floor/white,
/area/bigredv2/outside/marshal_office)
"rd" = (
/obj/effect/decal/warning_stripes{
	icon_state = "S";
	pixel_y = -1
	},
/turf/open/floor/red/north,
/area/bigredv2/outside/marshal_office)
"rs" = (
/obj/item/shard,
/turf/open/floor/redcorner/east,
/area/bigredv2/outside/marshal_office)
"rD" = (
/obj/structure/surface/rack,
/obj/item/ammo_magazine/revolver/cmb,
/turf/open/floor/vault2/west,
/area/bigredv2/outside/marshal_office)
"rK" = (
/obj/structure/machinery/flasher/portable,
/turf/open/floor/vault2/west,
/area/bigredv2/outside/marshal_office)
"rN" = (
/obj/item/ammo_casing/shell,
/turf/open/floor/redcorner/west,
/area/bigredv2/outside/marshal_office)
"st" = (
/obj/structure/pipes/standard/simple/hidden/green{
	dir = 4
	},
/turf/open/floor/dark,
/area/bigredv2/outside/marshal_office)
"sv" = (
/turf/open/floor/asteroidwarning/northwest,
/area/bigredv2/outside/n)
"sW" = (
/obj/structure/surface/table,
/turf/open/floor/redfull/northwest,
/area/bigredv2/outside/marshal_office)
"tg" = (
/obj/effect/landmark/static_comms/net_one,
/turf/open/floor/bcircuit,
/area/bigredv2/outside/marshal_office)
"tj" = (
/obj/effect/decal/warning_stripes{
	icon_state = "NW-out";
	pixel_x = -1;
	pixel_y = 1
	},
/turf/open/floor/red/southeast,
/area/bigredv2/outside/marshal_office)
"tx" = (
/obj/effect/landmark/hunter_secondary,
/turf/open/floor/redcorner/east,
/area/bigredv2/outside/marshal_office)
"tP" = (
/obj/structure/machinery/door/airlock/almayer/security/glass/colony{
	density = 0;
	dir = 1;
	icon_state = "door_open";
	name = "\improper Marshal Office Holding Cell"
	},
/turf/open/floor/dark,
/area/bigredv2/outside/marshal_office)
"tV" = (
/obj/effect/decal/warning_stripes{
	icon_state = "W";
	layer = 2.5;
	pixel_x = -1
	},
/turf/open/floor/red/east,
/area/bigredv2/outside/marshal_office)
"ud" = (
/obj/structure/machinery/light{
	dir = 1
	},
/obj/item/ammo_casing/shell,
/turf/open/floor/dark,
/area/bigredv2/outside/marshal_office)
"uH" = (
/obj/structure/machinery/computer/secure_data,
/obj/structure/surface/table,
/turf/open/floor/dark,
/area/bigredv2/outside/marshal_office)
"uJ" = (
/obj/effect/decal/warning_stripes{
	icon_state = "E";
	pixel_x = 1
	},
/turf/open/floor/red/west,
/area/bigredv2/outside/marshal_office)
"vm" = (
/obj/structure/surface/rack,
/turf/open/floor/vault2/west,
/area/bigredv2/outside/marshal_office)
"vD" = (
/obj/structure/surface/table,
/obj/effect/landmark/item_pool_spawner/survivor_ammo/buckshot,
/turf/open/floor/dark,
/area/bigredv2/outside/marshal_office)
"vO" = (
/obj/structure/machinery/computer/cameras,
/obj/structure/surface/table,
/turf/open/floor/bcircuit,
/area/bigredv2/outside/marshal_office)
"wa" = (
/obj/effect/decal/warning_stripes{
	icon_state = "SE-out";
	pixel_x = 1;
	pixel_y = -1
	},
/turf/open/floor/red/northwest,
/area/bigredv2/outside/marshal_office)
"wo" = (
/obj/structure/surface/rack,
/obj/item/weapon/gun/revolver/cmb,
/turf/open/floor/vault2/west,
/area/bigredv2/outside/marshal_office)
"xi" = (
/turf/open/floor/dark,
/area/bigredv2/outside/marshal_office)
"xG" = (
/obj/structure/surface/table/reinforced,
/obj/structure/machinery/door/window/brigdoor/eastleft,
/obj/item/weapon/shield/riot,
/turf/open/floor/vault2/west,
/area/bigredv2/outside/marshal_office)
"xV" = (
/turf/open/floor/white,
/area/bigredv2/outside/marshal_office)
"ye" = (
/obj/structure/pipes/standard/simple/hidden/green{
	dir = 4
	},
/obj/structure/machinery/camera/autoname,
/turf/open/floor/redcorner/east,
/area/bigredv2/outside/marshal_office)
"yr" = (
/obj/item/shard,
/turf/open/floor/dark,
/area/bigredv2/outside/marshal_office)
"yA" = (
/turf/open/floor/redcorner,
/area/bigredv2/outside/marshal_office)
"yY" = (
/obj/structure/pipes/standard/simple/hidden/green{
	dir = 4
	},
/obj/structure/machinery/door/airlock/almayer/security/glass/colony{
	icon_state = "door_locked";
	name = "\improper Marshal Office Armory"
	},
/turf/open/floor/dark,
/area/bigredv2/outside/marshal_office)
"zo" = (
/obj/structure/surface/table,
/obj/item/ore/uranium,
/turf/open/floor/bcircuit,
/area/bigredv2/outside/marshal_office)
"Ao" = (
/turf/open/mars_cave/mars_dirt_4,
/area/bigredv2/outside/n)
"AF" = (
/turf/open/floor/bcircuit,
/area/bigredv2/outside/marshal_office)
"AK" = (
/obj/effect/decal/cleanable/dirt,
/obj/structure/machinery/camera/autoname{
	dir = 1
	},
/turf/open/floor/redcorner,
/area/bigredv2/outside/marshal_office)
"Be" = (
/obj/effect/decal/cleanable/dirt,
/turf/open/floor/dark,
/area/bigredv2/outside/marshal_office)
"Bl" = (
/obj/structure/closet/l3closet/security,
/obj/structure/machinery/light{
	dir = 1
	},
/turf/open/floor/vault2/west,
/area/bigredv2/outside/marshal_office)
"Bv" = (
/obj/effect/landmark/corpsespawner/prisoner,
/obj/effect/decal/cleanable/blood,
/turf/open/floor/redcorner,
/area/bigredv2/outside/marshal_office)
"Bx" = (
/obj/structure/bed,
/turf/open/floor/white,
/area/bigredv2/outside/marshal_office)
"Dt" = (
/obj/structure/surface/table/reinforced,
/obj/structure/machinery/door/window/brigdoor/southright,
/turf/open/floor/vault2/west,
/area/bigredv2/outside/marshal_office)
"DN" = (
/obj/structure/surface/rack,
/obj/effect/landmark/item_pool_spawner/survivor_ammo/buckshot,
/obj/effect/landmark/item_pool_spawner/survivor_ammo/buckshot,
/turf/open/floor/dark,
/area/bigredv2/outside/marshal_office)
"DO" = (
/obj/structure/toilet{
	dir = 4
	},
/obj/effect/landmark/monkey_spawn,
/turf/open/floor/freezerfloor,
/area/bigredv2/outside/marshal_office)
"DV" = (
/obj/structure/pipes/standard/simple/hidden/green,
/turf/open/floor/dark,
/area/bigredv2/outside/marshal_office)
"Er" = (
/obj/structure/machinery/camera/autoname,
/obj/effect/decal/warning_stripes{
	icon_state = "SW-out";
	pixel_x = -1;
	pixel_y = -1
	},
/turf/open/floor/red/northeast,
/area/bigredv2/outside/marshal_office)
"Ez" = (
/obj/effect/decal/cleanable/dirt,
/obj/effect/decal/cleanable/blood{
	dir = 4;
	icon_state = "gib6"
	},
/turf/open/floor/redcorner,
/area/bigredv2/outside/marshal_office)
"EO" = (
/obj/structure/surface/rack,
/obj/item/clothing/accessory/storage/black_vest,
/turf/open/floor/dark,
/area/bigredv2/outside/marshal_office)
"Fm" = (
/obj/structure/machinery/camera/autoname{
	dir = 8
	},
/turf/open/floor/freezerfloor,
/area/bigredv2/outside/marshal_office)
"Ft" = (
/obj/structure/surface/rack,
/obj/item/clothing/suit/armor/riot,
/turf/open/floor/dark,
/area/bigredv2/outside/marshal_office)
"FF" = (
/obj/effect/decal/cleanable/dirt,
/obj/effect/landmark/corpsespawner/prisoner,
/obj/effect/decal/cleanable/blood,
/obj/item/tool/screwdriver,
/turf/open/floor/dark,
/area/bigredv2/outside/marshal_office)
"Gj" = (
/obj/structure/closet/secure_closet/marshal,
/turf/open/floor/dark,
/area/bigredv2/outside/marshal_office)
"He" = (
/obj/structure/pipes/standard/simple/hidden/green,
/obj/effect/decal/cleanable/dirt,
/turf/open/floor/dark,
/area/bigredv2/outside/marshal_office)
"Hh" = (
/obj/structure/machinery/light,
/turf/open/floor/redcorner,
/area/bigredv2/outside/marshal_office)
"HK" = (
/obj/structure/mirror{
	icon_state = "mirror_broke";
	pixel_x = 30
	},
/obj/item/tool/soap/deluxe,
/turf/open/floor/freezerfloor,
/area/bigredv2/outside/marshal_office)
"HN" = (
/obj/structure/pipes/standard/simple/hidden/green,
/obj/effect/decal/cleanable/dirt,
/turf/open/floor/redcorner,
/area/bigredv2/outside/marshal_office)
"HX" = (
/obj/effect/decal/cleanable/dirt,
/obj/effect/landmark/corpsespawner/prisoner,
/obj/effect/decal/cleanable/blood,
/obj/item/tool/kitchen/knife,
/turf/open/floor/redcorner,
/area/bigredv2/outside/marshal_office)
"IT" = (
/obj/structure/surface/table/reinforced,
/obj/structure/machinery/door/window/brigdoor/westright,
/turf/open/floor/vault2/west,
/area/bigredv2/outside/marshal_office)
"Jv" = (
/obj/effect/decal/cleanable/blood,
/obj/effect/decal/cleanable/dirt,
/turf/open/floor/white,
/area/bigredv2/outside/marshal_office)
"JF" = (
/obj/effect/decal/cleanable/dirt,
/obj/item/shard,
/turf/open/floor/redcorner,
/area/bigredv2/outside/marshal_office)
"JZ" = (
/obj/structure/surface/table,
/obj/item/clothing/head/beret/sec/warden,
/turf/open/floor/dark,
/area/bigredv2/outside/marshal_office)
"Kt" = (
/obj/structure/machinery/camera/autoname{
	dir = 4
	},
/turf/open/floor/bcircuit,
/area/bigredv2/outside/marshal_office)
"Ky" = (
/obj/structure/machinery/alarm{
	dir = 1;
	pixel_y = -30
	},
/turf/open/floor/redcorner,
/area/bigredv2/outside/marshal_office)
"KQ" = (
/obj/structure/machinery/door/airlock/almayer/generic{
	dir = 1;
	name = "\improper Marshal Office Prison Toilet"
	},
/turf/open/floor/freezerfloor,
/area/bigredv2/outside/marshal_office)
"Ml" = (
/obj/structure/pipes/standard/simple/hidden/green,
/turf/open/floor/redcorner,
/area/bigredv2/outside/marshal_office)
"MO" = (
/obj/effect/decal/cleanable/dirt,
/obj/effect/landmark/crap_item,
/turf/open/floor/dark,
/area/bigredv2/outside/marshal_office)
"MX" = (
/obj/structure/closet/secure_closet/brig,
/turf/open/floor/dark,
/area/bigredv2/outside/marshal_office)
"Na" = (
/obj/structure/machinery/door/airlock/almayer/security/glass/colony{
	dir = 1;
	name = "\improper Marshal Office Checkpoint"
	},
/turf/open/floor/redfull/northwest,
/area/bigredv2/outside/marshal_office)
"NF" = (
/obj/effect/decal/cleanable/dirt,
/obj/item/shard,
/turf/open/floor/dark,
/area/bigredv2/outside/marshal_office)
"NG" = (
/obj/effect/decal/cleanable/dirt,
/obj/item/frame/table,
/obj/structure/pipes/standard/simple/hidden/green,
/turf/open/floor/redcorner,
/area/bigredv2/outside/marshal_office)
"NH" = (
/obj/structure/machinery/deployable/barrier,
/turf/open/floor/vault2/west,
/area/bigredv2/outside/marshal_office)
"NN" = (
/obj/structure/surface/table,
/obj/effect/decal/cleanable/dirt,
/turf/open/floor/white,
/area/bigredv2/outside/marshal_office)
"Oa" = (
/obj/structure/surface/rack,
/obj/item/weapon/gun/shotgun/pump/dual_tube/cmb,
/turf/open/floor/dark,
/area/bigredv2/outside/marshal_office)
"Oi" = (
/obj/structure/pipes/standard/simple/hidden/green,
/obj/structure/machinery/door/airlock/almayer/medical/glass/colony{
	dir = 1;
	name = "\improper Marshal Office Prison"
	},
/turf/open/floor/whitegreenfull/northeast,
/area/bigredv2/outside/marshal_office)
"Ou" = (
/turf/open/floor/asteroidwarning/east,
/area/bigredv2/outside/n)
"Py" = (
/obj/structure/bed,
/turf/open/floor/dark,
/area/bigredv2/outside/marshal_office)
"PF" = (
/obj/effect/landmark/corpsespawner/prison_security,
/obj/effect/decal/cleanable/blood,
/turf/open/floor/dark,
/area/bigredv2/outside/marshal_office)
"PK" = (
/obj/effect/decal/warning_stripes{
	icon_state = "N";
	pixel_y = 1
	},
/turf/open/floor/red,
/area/bigredv2/outside/marshal_office)
"Qn" = (
/obj/structure/machinery/light{
	dir = 1
	},
/turf/open/floor/redcorner/east,
/area/bigredv2/outside/marshal_office)
"Qo" = (
/turf/open/floor/redcorner/west,
/area/bigredv2/outside/marshal_office)
"QM" = (
/obj/effect/decal/cleanable/dirt,
/turf/open/floor/whitegreen/east,
/area/bigredv2/outside/marshal_office)
"QP" = (
/obj/effect/landmark/survivor_spawner,
/turf/open/floor/redcorner/east,
/area/bigredv2/outside/marshal_office)
"QR" = (
/obj/effect/decal/warning_stripes{
	icon_state = "NE-out";
	pixel_x = 1;
	pixel_y = 1
	},
/turf/open/floor/red/southwest,
/area/bigredv2/outside/marshal_office)
"RK" = (
/obj/structure/machinery/door/airlock/almayer/security/glass/colony{
	density = 0;
	dir = 1;
	icon_state = "door_open";
	name = "\improper Marshal Office Prison"
	},
/turf/open/floor/whitegreenfull/northeast,
/area/bigredv2/outside/marshal_office)
"RY" = (
/obj/structure/machinery/power/apc/power/south,
/obj/structure/machinery/camera/autoname{
	dir = 1
	},
/turf/open/floor/dark,
/area/bigredv2/outside/marshal_office)
"Sc" = (
/obj/structure/window/framed/solaris/reinforced,
/obj/structure/machinery/door/poddoor/shutters/almayer{
	id = "Marshal Offices";
	name = "\improper Marshal Offices Shutters"
	},
/turf/open/floor/plating,
/area/bigredv2/outside/medical)
"Ss" = (
/obj/structure/surface/table,
/obj/item/clothing/mask/gas,
/obj/item/clothing/mask/gas,
/turf/open/floor/dark,
/area/bigredv2/outside/marshal_office)
"SD" = (
/obj/structure/machinery/door/airlock/multi_tile/almayer/generic{
	dir = 1;
	name = "\improper Marshal Office"
	},
/turf/open/floor/red/west,
/area/bigredv2/outside/marshal_office)
"SK" = (
/obj/effect/decal/cleanable/dirt,
/turf/open/floor/white,
/area/bigredv2/outside/marshal_office)
"TH" = (
/obj/structure/surface/table,
/turf/open/floor/white,
/area/bigredv2/outside/marshal_office)
"TJ" = (
/obj/structure/machinery/door/airlock/multi_tile/almayer/generic{
	name = "\improper Marshal Office Brig"
	},
/turf/open/floor/delivery,
/area/bigredv2/outside/marshal_office)
"UA" = (
/obj/structure/machinery/door_control{
	id = "Marshal Offices";
	name = "Storm Shutters";
	pixel_x = -32
	},
/turf/open/floor/redfull/northwest,
/area/bigredv2/outside/marshal_office)
"UH" = (
/obj/structure/sink{
	pixel_y = 32
	},
/turf/open/floor/freezerfloor,
/area/bigredv2/outside/marshal_office)
"Vp" = (
/obj/structure/machinery/door/airlock/almayer/medical/glass/colony{
	dir = 1;
	name = "\improper Marshal Office Prison"
	},
/turf/open/floor/whitegreenfull/northeast,
/area/bigredv2/outside/marshal_office)
"VA" = (
/obj/structure/pipes/standard/simple/hidden/green{
	dir = 4
	},
/turf/open/floor/redcorner/east,
/area/bigredv2/outside/marshal_office)
"Wk" = (
/obj/structure/machinery/door/airlock/almayer/security/glass/colony{
	dir = 1;
	name = "\improper Marshal Office Evidence Room"
	},
/turf/open/floor/delivery,
/area/bigredv2/outside/marshal_office)
"WU" = (
/turf/open/mars/mars_dirt_10,
/area/bigredv2/outside/n)
"WZ" = (
/obj/structure/closet/hydrant{
	pixel_y = 32
	},
/turf/open/floor/redcorner/east,
/area/bigredv2/outside/marshal_office)
"XJ" = (
/obj/structure/surface/table,
/obj/structure/machinery/light{
	dir = 8
	},
/turf/open/floor/white,
/area/bigredv2/outside/marshal_office)
"YD" = (
/obj/structure/surface/table,
/obj/item/device/radio,
/turf/open/floor/bcircuit,
/area/bigredv2/outside/marshal_office)
"Za" = (
/obj/structure/pipes/standard/simple/hidden/green,
/turf/open/floor/white,
/area/bigredv2/outside/marshal_office)
"Zh" = (
/obj/effect/decal/cleanable/dirt,
/turf/open/floor/redcorner,
/area/bigredv2/outside/marshal_office)
"Zk" = (
/obj/structure/machinery/light{
	dir = 4
	},
/turf/open/floor/whitegreen/east,
/area/bigredv2/outside/marshal_office)
"Zm" = (
/obj/structure/machinery/light,
/turf/open/floor/bcircuit,
/area/bigredv2/outside/marshal_office)
"Zq" = (
/obj/effect/decal/cleanable/dirt,
/obj/effect/landmark/corpsespawner/prison_security,
/obj/effect/decal/cleanable/blood,
/obj/item/ammo_casing/shell,
/obj/item/weapon/gun/shotgun/pump/dual_tube/cmb,
/turf/open/floor/redcorner/west,
/area/bigredv2/outside/marshal_office)
"Zr" = (
/obj/structure/surface/rack,
/obj/structure/machinery/light{
	dir = 1
	},
/obj/item/ammo_magazine/revolver/cmb,
/turf/open/floor/vault2/west,
/area/bigredv2/outside/marshal_office)
"Zv" = (
/obj/effect/decal/cleanable/dirt,
/turf/open/floor/redcorner/east,
/area/bigredv2/outside/marshal_office)

(1,1,1) = {"
SK
xV
xV
Vp
xV
xV
jr
tx
aY
Hh
ah
AF
Kt
AF
AF
at
pW
SD
ah
ah
ah
dj
"}
(2,1,1) = {"
xV
SK
SK
at
Bx
Bx
ah
Zv
aY
yA
ah
AF
xi
xi
xi
at
VA
yA
bG
xi
MX
dj
"}
(3,1,1) = {"
TH
SK
Jv
at
at
at
ah
Zv
aY
yA
ah
vO
xi
xi
xi
Wk
VA
Ez
tP
xi
fc
dj
"}
(4,1,1) = {"
TH
SK
SK
at
XJ
hy
ah
Zv
aZ
yA
ah
ff
YD
zo
Zm
at
VA
HX
bG
xi
Py
dj
"}
(5,1,1) = {"
ra
hJ
Za
Oi
Za
Za
dy
nn
ba
AK
ah
at
at
at
at
at
nC
Zh
ah
ah
ah
dj
"}
(6,1,1) = {"
gh
xV
xV
at
Bx
Bx
ah
nJ
bb
Zh
ah
wa
uJ
mD
QR
xi
VA
Zh
bG
xi
MX
dj
"}
(7,1,1) = {"
TH
xV
SK
at
at
at
ah
nJ
bb
nk
ah
rd
AF
tg
PK
xi
ye
Zh
kV
xi
fc
dj
"}
(8,1,1) = {"
NN
xV
xV
at
XJ
hy
ah
nJ
bc
Zh
ah
rd
AF
AF
PK
xi
js
JF
bL
xi
Py
dj
"}
(9,1,1) = {"
SK
SK
SK
Vp
xV
xV
RK
nJ
bc
Bv
ah
Er
tV
tV
tj
xi
js
yA
ah
ah
ah
dj
"}
(10,1,1) = {"
Zk
QM
QM
at
Bx
Bx
ah
nJ
bb
Hh
ah
xi
xi
xi
xi
xi
js
yA
bG
xi
MX
dj
"}
(11,1,1) = {"
ah
UH
ft
at
at
at
ah
nJ
bb
Zh
TJ
Qo
nH
nH
Zq
rN
bb
yA
tP
xi
fc
dj
"}
(12,1,1) = {"
ah
HK
Fm
KQ
fl
DO
ah
nJ
bd
HN
kk
Ml
HN
HN
nt
cs
cE
nD
bG
fn
Py
dj
"}
(13,1,1) = {"
ah
ah
ah
ah
ah
ah
ah
ah
ah
ah
ah
bG
IT
bG
ah
WZ
cF
Ky
ah
ah
ah
dj
"}
(14,1,1) = {"
ai
ai
Ou
nY
ah
rK
NH
NH
NH
ah
Gj
xi
xi
Ss
bG
Zv
bc
yA
bL
xi
MX
dj
"}
(15,1,1) = {"
aj
aj
aj
iZ
ah
Bl
xi
xi
xi
ah
vD
xi
xi
Ss
bG
QP
bc
JF
kV
xi
fc
dj
"}
(16,1,1) = {"
aj
aj
aj
iZ
ah
pX
xi
EO
xi
ah
vD
xi
Be
xi
Dt
Zv
bb
Zh
bG
xi
Py
dj
"}
(17,1,1) = {"
aj
aj
kE
iZ
ah
pX
Be
Oa
xi
ah
nr
dA
MO
Ft
co
qg
bb
Zh
ah
ah
ah
dj
"}
(18,1,1) = {"
aj
aj
WU
ai
ah
vm
Be
qf
RY
ah
JZ
FF
NF
Ft
cp
rs
cF
Zh
Na
UA
nx
Sc
"}
(19,1,1) = {"
aj
kE
Ao
ai
ah
rD
Be
DN
fc
ah
ud
Be
kr
yr
bL
nJ
bb
Zh
bG
sW
gM
Sc
"}
(20,1,1) = {"
kE
Ao
ai
ai
ah
wo
Be
jp
DV
dn
DV
DV
oS
He
dn
nn
cK
Zh
ah
bG
bG
dj
"}
(21,1,1) = {"
sv
ai
ai
ai
ah
Zr
xi
Be
xi
ah
uH
PF
st
mv
ah
nJ
cL
NG
cX
dd
dd
dk
"}
(22,1,1) = {"
iZ
ah
ah
ah
ah
ah
ah
xG
ah
ah
ah
bL
yY
bG
ah
Qn
cM
Zh
cY
cY
di
cY
"}
