//MAP CONVERTED BY dmm2tgm.py THIS HEADER COMMENT PREVENTS RECONVERSION, DO NOT REMOVE
"ae" = (
/turf/open/mars_cave/mars_cave_2,
/area/bigredv2/outside/lz2_south_cas)
"aC" = (
/turf/open/mars_cave/mars_dirt_5,
/area/bigredv2/caves_sw)
"be" = (
/turf/open/mars_cave/mars_cave_20,
/area/bigredv2/caves_sw)
"bP" = (
/obj/item/prop/helmetgarb/spent_buckshot,
/turf/open/mars_cave/mars_cave_17,
/area/bigredv2/outside/lz2_south_cas)
"bW" = (
/turf/open/mars_cave/mars_cave_14,
/area/bigredv2/caves_sw)
"cC" = (
/obj/item/shard{
	pixel_x = 11;
	pixel_y = 8
	},
/turf/open/floor/plating/platingdmg3/west,
/area/bigredv2/caves/mining)
"cH" = (
/obj/structure/machinery/door/poddoor/two_tile{
	name = "\improper Eta Tunnel Lockdown"
	},
/turf/open/floor/asteroidfloor/north,
/area/bigredv2/outside/lz2_south_cas)
"cR" = (
/turf/closed/wall/solaris/rock,
/area/bigredv2/caves)
"dx" = (
/turf/open/mars_cave,
/area/bigredv2/caves_research)
"eu" = (
/turf/open/mars_cave/mars_dirt_7,
/area/bigredv2/outside/lz2_south_cas)
"ff" = (
/turf/open/mars_cave/mars_cave_2,
/area/bigredv2/caves_research)
"fH" = (
/obj/effect/decal/cleanable/blood{
	base_icon = 'icons/obj/items/weapons/grenade.dmi';
	desc = "An expended M55C tear gas grenade that was used for nonlethal riot control. These used to be used on USCM ships until they found out that marines are already used to teargas so the U.S.S Re-education made a better model through 'extensive trials' that works on marines, which is now the M66 used by MPs today. Being now utterly useless to marines and phased out by the M66, M55Cs were spread around the colonies across the UA galaxy like salt to be used on poor colonists instead.";
	icon = 'icons/obj/items/weapons/grenade.dmi';
	icon_state = "grenade_custom";
	name = "M55C Teargas grenade"
	},
/turf/open/floor/plating/platingdmg3/west,
/area/bigredv2/caves/mining)
"iv" = (
/turf/open/floor/plating/platingdmg3/west,
/area/bigredv2/caves/mining)
"iE" = (
/obj/structure/machinery/light/double{
	dir = 4
	},
/turf/open/floor/plating/platingdmg3/west,
/area/bigredv2/caves/mining)
"iY" = (
/obj/effect/landmark/structure_spawner/setup/distress/xeno_weed_node,
/turf/open/mars_cave/mars_dirt_7,
/area/bigredv2/outside/lz2_south_cas)
"jf" = (
/obj/structure/surface/rack,
/obj/item/restraint/handcuffs{
	pixel_x = 1;
	pixel_y = 5
	},
/obj/item/clothing/suit/armor/riot,
/obj/item/clothing/head/helmet/riot{
	pixel_y = 11
	},
/turf/open/floor/plating/platingdmg3/west,
/area/bigredv2/caves/mining)
"jF" = (
/turf/open/mars_cave/mars_cave_19,
/area/bigredv2/caves_sw)
"jO" = (
/turf/open/mars_cave/mars_cave_23,
/area/bigredv2/outside/lz2_south_cas)
"kV" = (
/obj/effect/landmark/structure_spawner/setup/distress/xeno_weed_node,
/turf/open/mars_cave/mars_cave_2,
/area/bigredv2/caves_research)
"ls" = (
/obj/structure/surface/table/reinforced/prison,
/obj/item/prop/helmetgarb/riot_shield{
	pixel_y = -15
	},
/obj/item/weapon/gun/launcher/grenade/m81/m79{
	pixel_x = -3;
	pixel_y = 12
	},
/obj/item/explosive/grenade/high_explosive/airburst/starshell{
	pixel_x = -11;
	pixel_y = 1
	},
/obj/item/restraint/handcuffs{
	pixel_x = 1;
	pixel_y = 5
	},
/turf/open/floor/plating/platingdmg3/west,
/area/bigredv2/caves/mining)
"lB" = (
/turf/open/mars_cave/mars_cave_11,
/area/bigredv2/outside/lz2_south_cas)
"mg" = (
/turf/open/mars_cave/mars_cave_15,
/area/bigredv2/caves_sw)
"mk" = (
/turf/open/mars_cave/mars_cave_6,
/area/bigredv2/caves_research)
"ml" = (
/turf/open/mars_cave/mars_cave_7,
/area/bigredv2/outside/lz2_south_cas)
"nP" = (
/turf/open/mars_cave/mars_cave_15,
/area/bigredv2/outside/lz2_south_cas)
"nU" = (
/obj/structure/surface/table/reinforced/prison,
/obj/item/weapon/shield/riot,
/turf/open/floor/plating/platingdmg3/west,
/area/bigredv2/caves/mining)
"pd" = (
/turf/open/mars_cave/mars_dirt_7,
/area/bigredv2/caves_sw)
"pE" = (
/obj/effect/decal/cleanable/blood{
	dir = 4;
	icon_state = "gib6";
	pixel_y = 20
	},
/turf/open/floor/plating/platingdmg3/west,
/area/bigredv2/caves/mining)
"rA" = (
/obj/structure/surface/table/reinforced/prison,
/obj/item/paper_bundle,
/obj/item/restraint/handcuffs{
	pixel_y = -3
	},
/turf/open/floor/plating/platingdmg3/west,
/area/bigredv2/caves/mining)
"rJ" = (
/turf/open/mars_cave/mars_cave_16,
/area/bigredv2/outside/lz2_south_cas)
"sy" = (
/obj/item/trash/cigbutt,
/obj/item/shard{
	pixel_x = 9;
	pixel_y = -5
	},
/turf/open/mars_cave/mars_cave_17,
/area/bigredv2/outside/lz2_south_cas)
"tG" = (
/obj/effect/landmark/structure_spawner/xvx_hive/xeno_door,
/obj/effect/landmark/structure_spawner/setup/distress/xeno_door,
/turf/open/mars_cave/mars_cave_2,
/area/bigredv2/caves_sw)
"vl" = (
/turf/open/mars_cave/mars_cave_14,
/area/bigredv2/outside/lz2_south_cas)
"vs" = (
/obj/structure/window/framed/solaris/reinforced,
/turf/open/floor/plating/platingdmg3/west,
/area/bigredv2/caves/mining)
"vy" = (
/turf/open/mars_cave/mars_cave_11,
/area/bigredv2/caves_research)
"wo" = (
/turf/open/mars_cave/mars_cave_9,
/area/bigredv2/caves_sw)
"xY" = (
/turf/open/mars_cave/mars_cave_2,
/area/bigredv2/caves_sw)
"ye" = (
/turf/open/mars_cave/mars_cave_13,
/area/bigredv2/outside/lz2_south_cas)
"yj" = (
/obj/item/clothing/suit/storage/CMB,
/obj/structure/closet/secure_closet/marshal,
/obj/structure/machinery/light/double,
/turf/open/floor/plating/platingdmg3/west,
/area/bigredv2/caves/mining)
"yw" = (
/turf/closed/wall/solaris/reinforced,
/area/bigredv2/caves)
"zf" = (
/obj/structure/surface/table/reinforced/prison,
/obj/item/weapon/gun/revolver/spearhead,
/obj/item/device/flashlight/lamp/on{
	pixel_x = -5;
	pixel_y = 17
	},
/obj/item/clothing/mask/cigarette/cigar/havana,
/obj/item/shard,
/turf/open/floor/plating/platingdmg3/west,
/area/bigredv2/caves/mining)
"Ce" = (
/obj/structure/surface/table/reinforced/prison,
/obj/structure/machinery/door/window{
	dir = 1
	},
/turf/open/floor/plating/platingdmg3/west,
/area/bigredv2/caves/mining)
"Ch" = (
/obj/effect/landmark/corpsespawner/ua_riot,
/obj/effect/decal/cleanable/blood,
/turf/open/floor/plating/platingdmg3/west,
/area/bigredv2/caves/mining)
"CX" = (
/obj/effect/landmark/structure_spawner/setup/distress/xeno_weed_node,
/turf/open/mars_cave/mars_dirt_4,
/area/bigredv2/caves_sw)
"Dp" = (
/obj/effect/decal/cleanable/blood{
	icon_state = "gib6"
	},
/turf/open/floor/plating/platingdmg3/west,
/area/bigredv2/caves/mining)
"Dw" = (
/turf/open/mars_cave/mars_dirt_4,
/area/bigredv2/outside/lz2_south_cas)
"ET" = (
/turf/open/mars_cave/mars_cave_17,
/area/bigredv2/outside/lz2_south_cas)
"EV" = (
/obj/structure/window_frame/solaris/reinforced,
/obj/item/shard{
	pixel_x = -9;
	pixel_y = 8
	},
/obj/item/shard{
	pixel_x = 5;
	pixel_y = -9
	},
/obj/item/shard,
/turf/open/floor/plating/platingdmg3/west,
/area/bigredv2/caves/mining)
"Fm" = (
/obj/structure/closet/secure_closet/marshal,
/obj/item/clothing/suit/storage/CMB,
/turf/open/floor/plating/platingdmg3/west,
/area/bigredv2/caves/mining)
"Gy" = (
/obj/effect/landmark/crap_item,
/turf/open/mars_cave/mars_cave_7,
/area/bigredv2/caves_research)
"GS" = (
/obj/effect/landmark/structure_spawner/setup/distress/xeno_weed_node,
/turf/open/mars_cave/mars_cave_15,
/area/bigredv2/caves_sw)
"GV" = (
/turf/open/mars_cave/mars_cave_16,
/area/bigredv2/caves_sw)
"Ie" = (
/obj/structure/bed/chair{
	dir = 8
	},
/turf/open/floor/plating/platingdmg3/west,
/area/bigredv2/caves/mining)
"Ik" = (
/obj/structure/machinery/door/airlock/almayer/security/glass/colony{
	name = "\improper Marshals Mining Security Post"
	},
/turf/open/floor/plating/platingdmg3/west,
/area/bigredv2/caves/mining)
"IT" = (
/obj/structure/machinery/light/double{
	dir = 1
	},
/turf/open/mars_cave/mars_cave_7,
/area/bigredv2/outside/lz2_south_cas)
"Jd" = (
/obj/structure/surface/table/reinforced/prison,
/obj/structure/machinery/computer/cameras{
	dir = 4
	},
/turf/open/floor/plating/platingdmg3/west,
/area/bigredv2/caves/mining)
"Jg" = (
/turf/open/mars_cave/mars_cave_13,
/area/bigredv2/caves_sw)
"JC" = (
/turf/open/mars_cave/mars_dirt_6,
/area/bigredv2/outside/lz2_south_cas)
"JV" = (
/turf/closed/wall/wood,
/area/bigredv2/outside/lz2_south_cas)
"Ke" = (
/turf/open/floor/plating/burnt_platingdmg3/west,
/area/bigredv2/caves/mining)
"Ma" = (
/turf/open/floor/asteroidfloor/north,
/area/bigredv2/outside/lz2_south_cas)
"MT" = (
/obj/structure/bed/chair{
	dir = 8
	},
/obj/effect/landmark/corpsespawner/security,
/obj/effect/decal/cleanable/blood,
/turf/open/floor/plating/platingdmg3/west,
/area/bigredv2/caves/mining)
"Ni" = (
/obj/item/shard{
	icon_state = "small"
	},
/turf/open/mars_cave/mars_cave_17,
/area/bigredv2/outside/lz2_south_cas)
"Ns" = (
/obj/effect/landmark/crap_item,
/turf/open/mars_cave/mars_cave_13,
/area/bigredv2/outside/lz2_south_cas)
"Od" = (
/obj/structure/surface/table/reinforced/prison,
/obj/effect/decal/cleanable/blood{
	dir = 8;
	icon_state = "gib6";
	layer = 4;
	pixel_y = 3
	},
/obj/item/newspaper,
/obj/item/shard{
	pixel_x = -8;
	pixel_y = 7
	},
/turf/open/floor/plating/platingdmg3/west,
/area/bigredv2/caves/mining)
"PS" = (
/turf/open/mars_cave/mars_cave_17,
/area/bigredv2/caves_sw)
"Qh" = (
/obj/item/weapon/broken_bottle,
/turf/open/floor/plating/platingdmg3/west,
/area/bigredv2/caves/mining)
"Qo" = (
/obj/structure/reagent_dispensers/peppertank{
	pixel_x = -32
	},
/obj/effect/decal/cleanable/blood{
	base_icon = 'icons/obj/items/weapons/grenade.dmi';
	desc = "An expended M55C tear gas grenade that was used for nonlethal riot control. These used to be used on USCM ships until they found out that marines are already used to teargas so the U.S.S Re-education made a better model through 'extensive trials' that works on marines, which is now the M66 used by MPs today. Being now utterly useless to marines and phased out by the M66, M55Cs were spread around the colonies across the UA galaxy like salt to be used on poor colonists instead.";
	icon = 'icons/obj/items/weapons/grenade.dmi';
	icon_state = "grenade_custom";
	name = "M55C Teargas grenade"
	},
/turf/open/floor/plating/platingdmg3/west,
/area/bigredv2/caves/mining)
"QT" = (
/obj/effect/landmark/structure_spawner/setup/distress/xeno_weed_node,
/turf/open/mars_cave/mars_cave_2,
/area/bigredv2/caves_sw)
"Si" = (
/obj/structure/surface/rack,
/obj/item/clothing/suit/storage/marine/veteran/ua_riot,
/obj/item/clothing/suit/storage/marine/veteran/ua_riot,
/obj/item/clothing/under/marine/ua_riot,
/turf/open/floor/plating/platingdmg3/west,
/area/bigredv2/caves/mining)
"TS" = (
/turf/open/mars_cave/mars_dirt_6,
/area/bigredv2/caves_sw)
"UB" = (
/obj/structure/machinery/light/double,
/turf/open/mars_cave/mars_cave_5,
/area/bigredv2/outside/lz2_south_cas)
"UZ" = (
/turf/open/mars_cave/mars_dirt_4,
/area/bigredv2/caves_sw)
"VR" = (
/turf/closed/wall/solaris/reinforced,
/area/bigredv2/caves/mining)
"VV" = (
/turf/open/mars_cave/mars_cave_10,
/area/bigredv2/caves_research)
"XA" = (
/turf/open/mars_cave/mars_cave_7,
/area/bigredv2/caves_sw)
"Ya" = (
/obj/item/clothing/head/helmet/riot,
/turf/open/floor/plating/burnt_platingdmg3/west,
/area/bigredv2/caves/mining)
"Zg" = (
/obj/structure/window_frame/solaris/reinforced,
/obj/item/shard,
/turf/open/floor/plating/platingdmg3/west,
/area/bigredv2/caves/mining)
"Zl" = (
/turf/open/mars_cave/mars_cave_20,
/area/bigredv2/outside/lz2_south_cas)
"Zu" = (
/obj/structure/surface/table/reinforced/prison,
/obj/item/explosive/grenade/slug/baton{
	dir = 1;
	pixel_x = 6;
	pixel_y = 6
	},
/obj/item/explosive/grenade/slug/baton{
	dir = 4;
	pixel_x = 9;
	pixel_y = -4
	},
/obj/item/explosive/grenade/high_explosive/airburst/hornet_shell{
	pixel_x = -6;
	pixel_y = 6
	},
/obj/item/explosive/grenade/high_explosive/airburst{
	pixel_y = 8
	},
/obj/item/storage/box/packet/baton_slug{
	pixel_x = -7;
	pixel_y = -3
	},
/turf/open/floor/plating/platingdmg3/west,
/area/bigredv2/caves/mining)

(1,1,1) = {"
cR
cR
cR
cR
cR
JV
IT
Ns
ye
UB
VR
rA
Jd
Qo
fH
yj
VR
cR
cR
cR
"}
(2,1,1) = {"
cR
cR
cR
cR
cR
ae
nP
Dw
Dw
bP
EV
Od
MT
Dp
pE
Fm
VR
cR
cR
cR
"}
(3,1,1) = {"
cR
eu
Zl
cR
yw
ae
nP
JC
eu
sy
Zg
zf
cC
Qh
Ya
jf
VR
cR
cR
cR
"}
(4,1,1) = {"
jO
eu
eu
yw
yw
yw
vl
eu
iY
Ni
Ce
Ie
Ch
iv
Ke
Si
VR
cR
cR
cR
"}
(5,1,1) = {"
nP
Dw
Dw
cH
Ma
cH
Dw
JC
eu
ET
vs
iE
iv
Zu
ls
nU
VR
cR
cR
cR
"}
(6,1,1) = {"
nP
Dw
Dw
Ma
Ma
Ma
Dw
Dw
Dw
ET
VR
VR
Ik
VR
VR
VR
VR
cR
cR
cR
"}
(7,1,1) = {"
ae
rJ
rJ
yw
yw
yw
GV
wo
UZ
PS
xY
xY
xY
cR
cR
cR
cR
cR
cR
cR
"}
(8,1,1) = {"
lB
ml
ml
cR
yw
cR
cR
xY
GV
xY
xY
xY
xY
xY
cR
cR
cR
cR
cR
cR
"}
(9,1,1) = {"
ET
ae
cR
cR
cR
cR
cR
xY
xY
QT
xY
xY
xY
xY
Jg
cR
cR
cR
cR
cR
"}
(10,1,1) = {"
ET
ae
ae
cR
cR
cR
cR
cR
xY
XA
XA
XA
XA
mg
UZ
cR
cR
cR
cR
cR
"}
(11,1,1) = {"
ET
ae
ae
ml
ml
cR
cR
cR
cR
XA
XA
XA
XA
GS
UZ
aC
cR
cR
cR
cR
"}
(12,1,1) = {"
ae
ye
ye
ae
ml
ae
cR
cR
cR
cR
cR
XA
XA
mg
aC
aC
cR
cR
cR
cR
"}
(13,1,1) = {"
nP
Dw
eu
ET
ye
ye
cR
cR
cR
cR
cR
cR
xY
mg
aC
aC
cR
cR
cR
cR
"}
(14,1,1) = {"
cR
cR
cR
vl
Dw
Dw
ET
cR
cR
cR
cR
cR
xY
mg
UZ
aC
cR
cR
cR
cR
"}
(15,1,1) = {"
cR
cR
cR
UZ
pd
pd
PS
cR
cR
cR
cR
xY
xY
mg
pd
UZ
cR
cR
cR
cR
"}
(16,1,1) = {"
cR
cR
cR
cR
UZ
UZ
PS
xY
cR
cR
cR
xY
xY
GS
UZ
pd
cR
cR
cR
cR
"}
(17,1,1) = {"
cR
cR
cR
cR
UZ
jF
xY
xY
xY
cR
cR
xY
xY
mg
UZ
cR
cR
cR
cR
cR
"}
(18,1,1) = {"
xY
cR
cR
TS
UZ
PS
xY
xY
cR
cR
cR
xY
xY
xY
GV
cR
cR
cR
cR
cR
"}
(19,1,1) = {"
xY
cR
cR
cR
jF
xY
xY
xY
cR
cR
cR
xY
xY
xY
xY
cR
cR
cR
cR
cR
"}
(20,1,1) = {"
xY
xY
xY
xY
xY
Jg
Jg
cR
cR
cR
xY
xY
QT
xY
xY
cR
cR
cR
cR
cR
"}
(21,1,1) = {"
PS
xY
xY
Jg
bW
UZ
UZ
cR
cR
cR
xY
xY
xY
xY
xY
cR
cR
cR
cR
cR
"}
(22,1,1) = {"
PS
xY
mg
UZ
UZ
aC
aC
cR
cR
cR
tG
tG
tG
tG
tG
cR
cR
cR
cR
cR
"}
(23,1,1) = {"
be
Jg
bW
UZ
pd
UZ
aC
cR
cR
cR
cR
xY
xY
xY
Jg
cR
cR
cR
cR
cR
"}
(24,1,1) = {"
UZ
UZ
UZ
pd
jF
wo
UZ
UZ
cR
cR
cR
xY
xY
mg
pd
cR
cR
cR
cR
cR
"}
(25,1,1) = {"
UZ
UZ
pd
UZ
PS
mg
pd
UZ
cR
cR
cR
xY
Jg
Jg
pd
pd
cR
cR
cR
cR
"}
(26,1,1) = {"
jF
GV
GV
GV
xY
cR
UZ
UZ
cR
cR
cR
cR
UZ
CX
pd
pd
cR
cR
cR
cR
"}
(27,1,1) = {"
PS
xY
xY
xY
cR
cR
cR
cR
cR
cR
cR
cR
UZ
pd
pd
UZ
cR
cR
cR
cR
"}
(28,1,1) = {"
PS
xY
xY
xY
cR
cR
cR
cR
cR
cR
cR
cR
wo
UZ
UZ
jF
xY
cR
cR
cR
"}
(29,1,1) = {"
xY
xY
xY
xY
xY
cR
cR
cR
cR
cR
cR
cR
xY
GV
GV
xY
xY
cR
cR
cR
"}
(30,1,1) = {"
xY
xY
xY
xY
xY
cR
cR
cR
cR
cR
cR
cR
cR
xY
QT
xY
xY
cR
cR
cR
"}
(31,1,1) = {"
cR
xY
xY
xY
xY
cR
cR
cR
cR
cR
cR
cR
cR
xY
xY
xY
xY
xY
cR
cR
"}
(32,1,1) = {"
cR
cR
xY
cR
cR
cR
cR
cR
cR
cR
cR
cR
cR
xY
xY
xY
xY
xY
cR
cR
"}
(33,1,1) = {"
cR
cR
cR
cR
cR
cR
cR
cR
cR
cR
cR
cR
cR
xY
xY
xY
xY
cR
cR
cR
"}
(34,1,1) = {"
cR
cR
cR
cR
cR
cR
cR
cR
cR
cR
cR
cR
cR
xY
xY
xY
xY
cR
cR
cR
"}
(35,1,1) = {"
cR
cR
cR
cR
cR
cR
cR
cR
cR
cR
cR
cR
cR
cR
tG
tG
tG
cR
cR
cR
"}
(36,1,1) = {"
cR
cR
cR
cR
cR
cR
cR
cR
cR
cR
cR
cR
cR
cR
ff
ff
ff
ff
cR
cR
"}
(37,1,1) = {"
cR
cR
cR
cR
cR
cR
cR
cR
cR
cR
cR
cR
cR
ff
ff
kV
ff
ff
ff
ff
"}
(38,1,1) = {"
cR
cR
cR
cR
cR
cR
cR
cR
cR
cR
cR
cR
ff
ff
ff
ff
ff
ff
ff
ff
"}
(39,1,1) = {"
cR
cR
cR
cR
cR
cR
cR
cR
cR
cR
cR
cR
ff
ff
ff
ff
ff
ff
ff
kV
"}
(40,1,1) = {"
cR
cR
cR
cR
cR
cR
cR
cR
cR
cR
cR
cR
ff
ff
ff
ff
ff
mk
ff
dx
"}
(41,1,1) = {"
cR
cR
cR
cR
cR
cR
cR
cR
cR
cR
cR
ff
ff
ff
Gy
ff
ff
ff
ff
ff
"}
(42,1,1) = {"
yw
yw
yw
yw
cR
cR
cR
cR
cR
cR
ff
ff
ff
VV
kV
ff
ff
dx
vy
cR
"}
