//MAP CONVERTED BY dmm2tgm.py THIS HEADER COMMENT PREVENTS RECONVERSION, DO NOT REMOVE
"aa" = (
/obj/structure/barricade/wooden{
	desc = "This barricade is heavily reinforced. Nothing short of blasting it open seems like it'll do the trick, that or melting the breams supporting it...";
	dir = 8;
	health = 25000
	},
/turf/open/floor/plating,
/area/bigredv2/outside/cargo)
"ad" = (
/obj/structure/pipes/standard/simple/hidden/green,
/turf/open/floor,
/area/bigredv2/outside/cargo)
"ae" = (
/obj/structure/largecrate,
/turf/open/floor,
/area/bigredv2/outside/cargo)
"af" = (
/obj/effect/decal/cleanable/dirt,
/turf/open/floor,
/area/bigredv2/outside/cargo)
"ag" = (
/obj/structure/largecrate,
/obj/effect/decal/cleanable/dirt,
/turf/open/floor,
/area/bigredv2/outside/cargo)
"ah" = (
/obj/structure/closet/firecloset/full,
/turf/open/floor,
/area/bigredv2/outside/cargo)
"ai" = (
/turf/closed/wall/solaris,
/area/bigredv2/outside/cargo)
"aj" = (
/obj/structure/surface/table,
/obj/effect/spawner/random/tool,
/obj/effect/landmark/item_pool_spawner/survivor_ammo/buckshot,
/turf/open/floor,
/area/bigredv2/outside/cargo)
"ak" = (
/obj/structure/window/framed/solaris,
/turf/open/floor/plating,
/area/bigredv2/outside/cargo)
"am" = (
/obj/structure/largecrate/cow,
/turf/open/floor,
/area/bigredv2/outside/cargo)
"an" = (
/obj/effect/decal/cleanable/blood,
/turf/open/floor,
/area/bigredv2/outside/cargo)
"ap" = (
/obj/structure/closet/emcloset,
/turf/open/floor,
/area/bigredv2/outside/cargo)
"aq" = (
/obj/structure/surface/table,
/obj/effect/spawner/random/toolbox,
/obj/structure/pipes/vents/pump{
	dir = 4
	},
/obj/effect/landmark/item_pool_spawner/survivor_ammo/buckshot,
/turf/open/floor,
/area/bigredv2/outside/cargo)
"ar" = (
/obj/structure/pipes/standard/simple/hidden/green{
	dir = 4
	},
/obj/effect/decal/cleanable/dirt,
/turf/open/floor,
/area/bigredv2/outside/cargo)
"as" = (
/obj/structure/pipes/standard/simple/hidden/green{
	dir = 10
	},
/obj/effect/decal/cleanable/dirt,
/turf/open/floor,
/area/bigredv2/outside/cargo)
"at" = (
/obj/effect/decal/cleanable/dirt,
/obj/item/tool/lighter/random,
/turf/open/floor,
/area/bigredv2/outside/cargo)
"au" = (
/obj/structure/pipes/standard/simple/hidden/green,
/obj/effect/decal/cleanable/dirt,
/turf/open/floor,
/area/bigredv2/outside/cargo)
"av" = (
/turf/open/floor,
/area/bigredv2/outside/cargo)
"aw" = (
/obj/structure/pipes/standard/simple/hidden/green{
	dir = 6
	},
/turf/open/floor,
/area/bigredv2/outside/cargo)
"ax" = (
/obj/structure/pipes/standard/simple/hidden/green{
	dir = 4
	},
/turf/open/floor,
/area/bigredv2/outside/cargo)
"az" = (
/obj/structure/machinery/autolathe,
/turf/open/floor,
/area/bigredv2/outside/cargo)
"aA" = (
/obj/structure/machinery/light,
/turf/open/floor,
/area/bigredv2/outside/cargo)
"aB" = (
/obj/structure/machinery/light{
	dir = 8
	},
/turf/open/floor,
/area/bigredv2/outside/cargo)
"aE" = (
/obj/structure/window/framed/solaris,
/obj/structure/machinery/door/poddoor/shutters/almayer{
	dir = 4;
	id = "Cargonia";
	name = "\improper Cargo Shutters"
	},
/turf/open/floor/plating,
/area/bigredv2/outside/cargo)
"aI" = (
/obj/structure/pipes/standard/manifold/hidden/green{
	dir = 1
	},
/turf/open/floor,
/area/bigredv2/outside/cargo)
"aN" = (
/obj/structure/machinery/light{
	dir = 1
	},
/turf/open/floor,
/area/bigredv2/outside/cargo)
"aV" = (
/obj/effect/decal/cleanable/dirt,
/obj/structure/pipes/standard/manifold/hidden/green{
	dir = 8
	},
/turf/open/floor,
/area/bigredv2/outside/cargo)
"bb" = (
/obj/effect/decal/cleanable/dirt,
/obj/structure/pipes/standard/simple/hidden/green,
/turf/open/floor,
/area/bigredv2/outside/cargo)
"bm" = (
/obj/item/device/flashlight,
/obj/item/reagent_container/spray/cleaner,
/turf/open/floor,
/area/bigredv2/outside/cargo)
"bp" = (
/obj/structure/pipes/standard/manifold/hidden/green,
/turf/open/floor,
/area/bigredv2/outside/cargo)
"bs" = (
/obj/effect/decal/cleanable/dirt,
/obj/structure/pipes/standard/simple/hidden/green{
	dir = 4
	},
/turf/open/floor,
/area/bigredv2/outside/cargo)
"bt" = (
/obj/effect/decal/cleanable/dirt,
/obj/structure/pipes/vents/pump{
	dir = 8
	},
/turf/open/floor,
/area/bigredv2/outside/cargo)
"bv" = (
/obj/structure/pipes/standard/manifold/hidden/green{
	dir = 8
	},
/turf/open/floor,
/area/bigredv2/outside/cargo)
"bB" = (
/obj/effect/decal/cleanable/dirt,
/obj/item/device/megaphone,
/turf/open/floor,
/area/bigredv2/outside/cargo)
"bD" = (
/obj/effect/decal/cleanable/dirt,
/obj/effect/decal/cleanable/dirt,
/turf/open/floor,
/area/bigredv2/outside/cargo)
"bG" = (
/obj/structure/surface/table,
/obj/effect/spawner/random/bomb_supply,
/obj/effect/spawner/random/tool,
/obj/effect/spawner/random/tool,
/obj/structure/machinery/light{
	dir = 4
	},
/turf/open/floor,
/area/bigredv2/outside/cargo)
"bH" = (
/obj/structure/machinery/camera/autoname{
	dir = 4
	},
/turf/open/floor,
/area/bigredv2/outside/cargo)
"bO" = (
/obj/structure/machinery/door_control{
	id = "Cargonia";
	name = "Storm Shutters";
	pixel_x = 32
	},
/turf/open/floor,
/area/bigredv2/outside/cargo)
"bS" = (
/obj/structure/pipes/standard/simple/hidden/green{
	dir = 5
	},
/turf/open/floor,
/area/bigredv2/outside/cargo)
"bZ" = (
/obj/structure/reagent_dispensers/watertank,
/turf/open/floor,
/area/bigredv2/outside/cargo)
"cd" = (
/obj/structure/reagent_dispensers/fueltank,
/turf/open/floor,
/area/bigredv2/outside/cargo)
"cf" = (
/obj/structure/bed/chair/office/dark,
/turf/open/floor,
/area/bigredv2/outside/cargo)
"cg" = (
/obj/structure/surface/table,
/obj/effect/spawner/random/tech_supply,
/obj/effect/spawner/random/tool,
/obj/effect/spawner/random/tool,
/turf/open/floor,
/area/bigredv2/outside/cargo)
"ch" = (
/obj/structure/surface/table,
/turf/open/floor,
/area/bigredv2/outside/cargo)
"ci" = (
/obj/structure/surface/table,
/obj/item/device/radio,
/obj/structure/pipes/vents/pump{
	dir = 1
	},
/turf/open/floor,
/area/bigredv2/outside/cargo)
"cj" = (
/obj/structure/machinery/computer/ordercomp,
/turf/open/floor,
/area/bigredv2/outside/cargo)
"ck" = (
/obj/structure/machinery/camera/autoname{
	dir = 1
	},
/turf/open/floor,
/area/bigredv2/outside/cargo)
"cl" = (
/obj/structure/barricade/wooden{
	desc = "This barricade is heavily reinforced. Nothing short of blasting it open seems like it'll do the trick, that or melting the breams supporting it...";
	health = 25000
	},
/turf/open/floor,
/area/bigredv2/outside/cargo)
"cm" = (
/obj/structure/pipes/standard/simple/hidden/green,
/obj/structure/barricade/wooden{
	desc = "This barricade is heavily reinforced. Nothing short of blasting it open seems like it'll do the trick, that or melting the breams supporting it...";
	health = 25000
	},
/turf/open/floor,
/area/bigredv2/outside/cargo)
"cn" = (
/obj/structure/surface/table,
/obj/effect/spawner/random/toolbox,
/obj/effect/spawner/random/tool,
/obj/structure/pipes/standard/simple/hidden/green,
/turf/open/floor,
/area/bigredv2/outside/cargo)
"co" = (
/obj/structure/surface/table,
/obj/effect/spawner/random/toolbox,
/obj/effect/spawner/random/tool,
/turf/open/floor,
/area/bigredv2/outside/cargo)
"cp" = (
/obj/structure/surface/table,
/obj/effect/spawner/random/toolbox,
/turf/open/floor,
/area/bigredv2/outside/cargo)
"cq" = (
/obj/structure/surface/table,
/obj/effect/spawner/random/tool,
/obj/effect/spawner/random/tool,
/obj/effect/spawner/random/bomb_supply,
/obj/effect/spawner/random/bomb_supply,
/obj/effect/landmark/item_pool_spawner/survivor_ammo/buckshot,
/turf/open/floor,
/area/bigredv2/outside/cargo)
"cr" = (
/obj/structure/surface/table,
/obj/effect/spawner/random/bomb_supply,
/obj/effect/spawner/random/bomb_supply,
/obj/effect/spawner/random/tool,
/obj/effect/landmark/item_pool_spawner/survivor_ammo/buckshot,
/turf/open/floor,
/area/bigredv2/outside/cargo)
"cs" = (
/obj/structure/surface/table,
/obj/effect/spawner/random/bomb_supply,
/obj/effect/spawner/random/bomb_supply,
/turf/open/floor,
/area/bigredv2/outside/cargo)
"ct" = (
/obj/structure/reagent_dispensers/fueltank,
/obj/structure/machinery/light{
	dir = 4
	},
/turf/open/floor,
/area/bigredv2/outside/cargo)
"cu" = (
/obj/structure/window/framed/solaris,
/obj/structure/machinery/door/poddoor/shutters/almayer{
	id = "Cargonia";
	name = "\improper Cargo Shutters"
	},
/turf/open/floor/plating,
/area/bigredv2/outside/cargo)
"cv" = (
/turf/closed/wall/solaris/reinforced,
/area/bigredv2/outside/engineering)
"fe" = (
/obj/structure/pipes/standard/simple/hidden/green{
	dir = 4
	},
/obj/effect/decal/cleanable/dirt,
/turf/open/floor/bot/north,
/area/bigredv2/outside/cargo)
"fj" = (
/obj/structure/cargo_container/kelland/right,
/turf/open/floor/bot/north,
/area/bigredv2/outside/cargo)
"hQ" = (
/turf/open/floor/floor4,
/area/bigredv2/outside/cargo)
"ju" = (
/obj/structure/cargo_container/watatsumi/right,
/turf/open/floor/bot/north,
/area/bigredv2/outside/cargo)
"kO" = (
/obj/structure/largecrate,
/turf/open/floor/bot/north,
/area/bigredv2/outside/cargo)
"nh" = (
/turf/open/floor/delivery,
/area/bigredv2/outside/cargo)
"pl" = (
/obj/effect/decal/cleanable/dirt,
/obj/structure/cargo_container/watatsumi/leftmid,
/turf/open/floor/bot/north,
/area/bigredv2/outside/cargo)
"qx" = (
/obj/structure/pipes/standard/simple/hidden/green{
	dir = 9
	},
/turf/open/floor/bot/north,
/area/bigredv2/outside/cargo)
"ra" = (
/turf/open/floor/loadingarea/east,
/area/bigredv2/outside/cargo)
"rh" = (
/obj/structure/largecrate/random/barrel,
/turf/open/floor/bot/north,
/area/bigredv2/outside/cargo)
"rm" = (
/obj/effect/decal/cleanable/dirt,
/turf/open/floor/floor4,
/area/bigredv2/outside/cargo)
"rM" = (
/obj/structure/machinery/light{
	dir = 8
	},
/turf/open/floor/loadingarea,
/area/bigredv2/outside/cargo)
"sh" = (
/obj/structure/pipes/standard/simple/hidden/green{
	dir = 4
	},
/obj/effect/decal/cleanable/dirt,
/obj/structure/cargo_container/kelland/right,
/turf/open/floor/bot/north,
/area/bigredv2/outside/cargo)
"ss" = (
/obj/structure/barricade/wooden{
	desc = "This barricade is heavily reinforced. Nothing short of blasting it open seems like it'll do the trick, that or melting the breams supporting it...";
	dir = 8;
	health = 25000
	},
/turf/open/floor/delivery,
/area/bigredv2/outside/cargo)
"tO" = (
/obj/structure/pipes/standard/simple/hidden/green{
	dir = 4
	},
/obj/structure/machinery/door/airlock/almayer/security/glass/colony{
	name = "\improper Cargo Bay Security"
	},
/turf/open/floor/delivery,
/area/bigredv2/outside/cargo)
"uJ" = (
/turf/open/floor/bot/north,
/area/bigredv2/outside/cargo)
"vu" = (
/obj/structure/filingcabinet,
/obj/structure/machinery/light{
	dir = 1
	},
/turf/open/floor,
/area/bigredv2/outside/cargo)
"wt" = (
/obj/structure/pipes/standard/simple/hidden/green,
/obj/structure/machinery/door/airlock/almayer/engineering/colony{
	dir = 1;
	name = "\improper Cargo Bay Quartermaster"
	},
/turf/open/floor/delivery,
/area/bigredv2/outside/cargo)
"xd" = (
/obj/structure/pipes/standard/simple/hidden/green,
/obj/structure/machinery/door/airlock/multi_tile/almayer/generic{
	name = "\improper Cargo Offices"
	},
/turf/open/floor/delivery,
/area/bigredv2/outside/cargo)
"xB" = (
/obj/structure/pipes/standard/simple/hidden/green,
/turf/open/floor/delivery,
/area/bigredv2/outside/engineering)
"xU" = (
/obj/structure/pipes/standard/simple/hidden/green{
	dir = 9
	},
/obj/structure/cargo_container/kelland/right,
/turf/open/floor/bot/north,
/area/bigredv2/outside/cargo)
"zb" = (
/obj/structure/pipes/standard/simple/hidden/green{
	dir = 4
	},
/obj/structure/cargo_container/arious/right,
/turf/open/floor/bot/north,
/area/bigredv2/outside/cargo)
"zs" = (
/obj/effect/decal/cleanable/dirt,
/obj/structure/largecrate,
/turf/open/floor/bot/north,
/area/bigredv2/outside/cargo)
"Cg" = (
/obj/structure/pipes/standard/simple/hidden/green{
	dir = 4
	},
/obj/effect/decal/cleanable/dirt,
/obj/structure/cargo_container/kelland/left,
/turf/open/floor/bot/north,
/area/bigredv2/outside/cargo)
"Cl" = (
/obj/effect/decal/cleanable/dirt,
/obj/structure/reagent_dispensers/fueltank,
/turf/open/floor,
/area/bigredv2/outside/cargo)
"DF" = (
/obj/effect/decal/cleanable/dirt,
/obj/effect/landmark/good_item,
/turf/open/floor/bot/north,
/area/bigredv2/outside/cargo)
"DM" = (
/obj/effect/decal/cleanable/dirt,
/obj/structure/surface/table,
/obj/structure/machinery/light{
	dir = 4
	},
/obj/effect/spawner/random/toolbox,
/turf/open/floor,
/area/bigredv2/outside/cargo)
"DX" = (
/obj/structure/machinery/power/apc/power/north,
/turf/open/floor,
/area/bigredv2/outside/cargo)
"EQ" = (
/obj/structure/pipes/standard/simple/hidden/green{
	dir = 4
	},
/turf/open/floor/delivery,
/area/bigredv2/outside/cargo)
"Gk" = (
/turf/open/floor/loadingarea,
/area/bigredv2/outside/cargo)
"GQ" = (
/obj/structure/pipes/vents/pump{
	dir = 8
	},
/turf/open/floor,
/area/bigredv2/outside/cargo)
"HN" = (
/obj/structure/cargo_container/watatsumi/rightmid,
/turf/open/floor/bot/north,
/area/bigredv2/outside/cargo)
"Ic" = (
/obj/structure/largecrate/random/barrel,
/turf/open/floor,
/area/bigredv2/outside/cargo)
"IC" = (
/obj/structure/pipes/standard/simple/hidden/green{
	dir = 4
	},
/obj/structure/cargo_container/kelland/left,
/turf/open/floor/bot/north,
/area/bigredv2/outside/cargo)
"Ja" = (
/obj/effect/decal/cleanable/dirt,
/obj/structure/surface/table,
/obj/effect/spawner/random/tool,
/turf/open/floor,
/area/bigredv2/outside/cargo)
"Jh" = (
/obj/structure/cargo_container/grant/rightmid,
/turf/open/floor/bot/north,
/area/bigredv2/outside/cargo)
"Jo" = (
/obj/structure/filingcabinet,
/turf/open/floor,
/area/bigredv2/outside/cargo)
"JZ" = (
/obj/structure/pipes/standard/simple/hidden/green{
	dir = 4
	},
/turf/open/floor/loadingarea/east,
/area/bigredv2/outside/cargo)
"KO" = (
/obj/structure/pipes/standard/simple/hidden/green{
	dir = 5
	},
/obj/structure/cargo_container/arious/rightmid,
/turf/open/floor/bot/north,
/area/bigredv2/outside/cargo)
"Lg" = (
/obj/structure/surface/table,
/obj/effect/spawner/random/bomb_supply,
/turf/open/floor,
/area/bigredv2/outside/cargo)
"Lj" = (
/obj/structure/surface/table,
/obj/item/stack/sheet/glass{
	amount = 30
	},
/turf/open/floor,
/area/bigredv2/outside/cargo)
"Mr" = (
/obj/effect/landmark/corpsespawner/security/marshal,
/turf/open/floor,
/area/bigredv2/outside/cargo)
"Oc" = (
/obj/structure/machinery/light{
	dir = 8
	},
/obj/structure/surface/table,
/obj/effect/spawner/random/tool,
/turf/open/floor,
/area/bigredv2/outside/cargo)
"Ot" = (
/obj/structure/pipes/standard/simple/hidden/green,
/obj/structure/largecrate/random/barrel,
/turf/open/floor/bot/north,
/area/bigredv2/outside/cargo)
"Ow" = (
/obj/structure/pipes/standard/simple/hidden/green{
	dir = 4
	},
/turf/open/floor/floor4,
/area/bigredv2/outside/cargo)
"Pd" = (
/obj/effect/decal/cleanable/dirt,
/obj/structure/closet/crate/trashcart,
/turf/open/floor/bot/north,
/area/bigredv2/outside/cargo)
"Rd" = (
/obj/structure/machinery/door/airlock/multi_tile/almayer/generic{
	name = "\improper Engineering Complex"
	},
/turf/open/floor/delivery,
/area/bigredv2/outside/engineering)
"Rk" = (
/obj/structure/machinery/door/airlock/almayer/engineering/colony{
	name = "\improper Cargo Bay Quartermaster"
	},
/turf/open/floor/delivery,
/area/bigredv2/outside/cargo)
"TP" = (
/obj/structure/cargo_container/grant/right,
/turf/open/floor/bot/north,
/area/bigredv2/outside/cargo)
"Vg" = (
/turf/open/floor/loadingarea/west,
/area/bigredv2/outside/cargo)
"Vo" = (
/obj/structure/largecrate/cow,
/turf/open/floor/loadingarea,
/area/bigredv2/outside/cargo)
"Wf" = (
/obj/structure/pipes/standard/simple/hidden/green,
/obj/structure/machinery/light{
	dir = 4
	},
/turf/open/floor,
/area/bigredv2/outside/cargo)
"Wh" = (
/obj/structure/cargo_container/grant/left,
/turf/open/floor/bot/north,
/area/bigredv2/outside/cargo)
"WA" = (
/obj/structure/largecrate,
/obj/structure/pipes/standard/simple/hidden/green{
	dir = 4
	},
/turf/open/floor/bot/north,
/area/bigredv2/outside/cargo)
"WN" = (
/obj/item/reagent_container/spray/cleaner,
/obj/structure/pipes/standard/simple/hidden/green,
/turf/open/floor/floor4,
/area/bigredv2/outside/cargo)
"WU" = (
/obj/structure/cargo_container/kelland/left,
/turf/open/floor/bot/north,
/area/bigredv2/outside/cargo)
"Xz" = (
/obj/structure/machinery/door/airlock/multi_tile/almayer/generic{
	dir = 1;
	name = "\improper Cargo Bay"
	},
/turf/open/floor/delivery,
/area/bigredv2/outside/cargo)
"Zq" = (
/obj/structure/cargo_container/arious/leftmid,
/turf/open/floor/bot/north,
/area/bigredv2/outside/cargo)

(1,1,1) = {"
aa
aa
aa
ai
aE
aE
aE
ai
ai
ai
EQ
Xz
ai
ai
ai
ai
Rk
ai
ai
"}
(2,1,1) = {"
nh
ss
nh
ai
av
av
av
ai
Lg
aB
ax
av
bH
Oc
ai
aN
av
cg
ai
"}
(3,1,1) = {"
av
av
av
rM
Zq
rh
av
ak
Lj
hQ
Ow
hQ
hQ
av
ai
av
cf
ch
cu
"}
(4,1,1) = {"
ad
ad
au
ad
KO
zs
av
ak
Ic
hQ
aI
bb
WN
ad
wt
ad
ad
ci
cu
"}
(5,1,1) = {"
ae
av
av
Gk
zb
DF
av
ai
av
hQ
Ow
hQ
rm
Cl
ak
Jo
af
cj
cu
"}
(6,1,1) = {"
af
an
av
am
aI
ad
ad
wt
ad
Wf
bp
Mr
Ja
DM
ak
Jo
av
av
cu
"}
(7,1,1) = {"
ag
av
av
Gk
WA
Pd
uJ
ai
ai
ai
EQ
Xz
ai
ai
ai
vu
av
ck
ai
"}
(8,1,1) = {"
av
av
av
av
ar
af
av
af
av
av
ax
af
aB
ae
ai
ak
Rk
ak
ai
"}
(9,1,1) = {"
av
av
av
Gk
fe
Wh
av
pl
uJ
av
ax
bB
av
av
av
av
av
aA
cv
"}
(10,1,1) = {"
ap
av
aw
ad
qx
Jh
av
HN
rh
av
aI
ad
ad
ad
bS
af
av
cl
Rd
"}
(11,1,1) = {"
ap
av
ax
Vo
uJ
TP
av
ju
kO
av
ax
av
av
av
aI
ad
ad
cm
xB
"}
(12,1,1) = {"
ah
av
GQ
av
av
av
av
av
av
av
bs
bD
ra
av
JZ
av
av
cn
cv
"}
(13,1,1) = {"
ai
ai
ai
ai
ak
ak
ak
ai
aN
av
bt
bD
uJ
av
IC
af
av
co
cv
"}
(14,1,1) = {"
aj
aq
az
ai
av
av
av
ai
DX
av
af
bD
WU
av
sh
af
av
cp
cv
"}
(15,1,1) = {"
af
ar
aA
ai
af
af
av
ai
av
af
af
af
fj
av
Cg
av
av
aj
cv
"}
(16,1,1) = {"
af
as
ad
xd
au
aV
ad
xd
ad
au
bv
au
Ot
ad
xU
av
av
cq
cv
"}
(17,1,1) = {"
av
at
af
nh
af
ar
av
nh
av
af
bs
av
Vg
av
Vg
av
av
cr
cv
"}
(18,1,1) = {"
av
av
av
ai
aN
ax
av
ai
av
bm
ax
av
av
av
av
av
av
cs
cv
"}
(19,1,1) = {"
ak
ak
ai
ai
ak
tO
ak
ai
av
av
ax
bG
bO
av
bZ
cd
cd
ct
cv
"}
