//MAP CONVERTED BY dmm2tgm.py THIS HEADER COMMENT PREVENTS RECONVERSION, DO NOT REMOVE
"ab" = (
/turf/closed/wall/solaris/reinforced,
/area/bigredv2/outside/admin_building)
"ad" = (
/obj/structure/window/framed/solaris,
/turf/open/floor/plating,
/area/bigredv2/outside/admin_building)
"ae" = (
/turf/closed/wall/solaris,
/area/bigredv2/outside/admin_building)
"ak" = (
/obj/structure/window_frame/solaris,
/obj/item/shard,
/turf/open/floor/plating,
/area/bigredv2/outside/admin_building)
"ap" = (
/obj/structure/flora/jungle/plantbot1{
	pixel_y = 10
	},
/turf/open/jungle,
/area/bigredv2/outside/admin_building)
"as" = (
/obj/item/ammo_magazine/rifle/rubber{
	current_rounds = 0;
	pixel_y = 11
	},
/turf/open/floor/wood,
/area/bigredv2/outside/admin_building)
"at" = (
/obj/structure/bed/chair/comfy/black,
/turf/open/floor/carpet,
/area/bigredv2/outside/admin_building)
"au" = (
/obj/effect/landmark/corpsespawner/wygoon,
/turf/open/floor/carpet,
/area/bigredv2/outside/admin_building)
"aB" = (
/obj/structure/surface/table,
/obj/structure/prop/server_equipment/laptop/on,
/turf/open/floor/carpet,
/area/bigredv2/outside/admin_building)
"aC" = (
/obj/structure/bed/chair/comfy/blue{
	dir = 8
	},
/turf/open/floor/carpet,
/area/bigredv2/outside/admin_building)
"aD" = (
/obj/effect/acid_hole,
/turf/closed/wall/solaris,
/area/bigredv2/outside/admin_building)
"aJ" = (
/obj/structure/bed/chair/comfy/blue{
	dir = 4
	},
/turf/open/floor/carpet,
/area/bigredv2/outside/admin_building)
"aL" = (
/obj/structure/reagent_dispensers/fueltank,
/turf/open/floor/carpet,
/area/bigredv2/outside/admin_building)
"aO" = (
/obj/item/storage/secure/briefcase,
/turf/open/floor/carpet,
/area/bigredv2/outside/admin_building)
"aQ" = (
/turf/open/floor/carpet,
/area/bigredv2/outside/admin_building)
"aS" = (
/obj/item/ammo_magazine/rifle/rubber{
	current_rounds = 3;
	pixel_x = -3;
	pixel_y = -6
	},
/turf/open/floor/carpet,
/area/bigredv2/outside/admin_building)
"aV" = (
/obj/structure/surface/table,
/obj/item/ammo_magazine/rifle/rubber,
/turf/open/floor/carpet,
/area/bigredv2/outside/admin_building)
"aW" = (
/obj/effect/decal/cleanable/blood,
/obj/item/tool/weldingtool,
/turf/open/floor/carpet,
/area/bigredv2/outside/admin_building)
"ba" = (
/obj/structure/surface/table,
/obj/structure/pipes/vents/pump{
	dir = 4
	},
/obj/item/clothing/head/helmet/marine/veteran/pmc/leader,
/turf/open/floor/carpet,
/area/bigredv2/outside/admin_building)
"bb" = (
/obj/structure/bed/chair/comfy/blue{
	dir = 8
	},
/obj/structure/pipes/standard/simple/hidden/green{
	dir = 4
	},
/obj/effect/landmark/corpsespawner/wygoon,
/turf/open/floor/carpet,
/area/bigredv2/outside/admin_building)
"bc" = (
/obj/structure/pipes/standard/simple/hidden/green{
	dir = 4
	},
/obj/effect/decal/cleanable/blood,
/turf/open/floor/carpet,
/area/bigredv2/outside/admin_building)
"bp" = (
/obj/structure/machinery/vending/coffee,
/turf/open/floor,
/area/bigredv2/outside/admin_building)
"bs" = (
/obj/structure/window/framed/solaris/reinforced,
/obj/structure/machinery/door/poddoor/shutters/almayer{
	id = "Operations";
	name = "\improper Operations Shutters"
	},
/turf/open/floor/plating,
/area/bigredv2/outside/admin_building)
"dp" = (
/obj/item/ammo_magazine/rifle/rubber{
	current_rounds = 0;
	pixel_x = -6;
	pixel_y = -4
	},
/turf/open/floor/carpet,
/area/bigredv2/outside/admin_building)
"fy" = (
/obj/structure/machinery/light{
	dir = 4
	},
/obj/item/storage/toolbox/syndicate,
/turf/open/floor/darkred2/east,
/area/bigredv2/outside/admin_building)
"fR" = (
/obj/effect/landmark/corpsespawner/wygoon,
/turf/open/floor/wood,
/area/bigredv2/outside/admin_building)
"gb" = (
/obj/structure/pipes/standard/manifold/hidden/green,
/turf/open/floor/dark,
/area/bigredv2/outside/admin_building)
"gc" = (
/obj/structure/barricade/metal/wired{
	dir = 4
	},
/obj/item/ammo_magazine/pistol/rubber{
	current_rounds = 0
	},
/turf/open/floor/wood,
/area/bigredv2/outside/admin_building)
"gI" = (
/obj/structure/platform_decoration{
	dir = 4
	},
/turf/open/floor/dark,
/area/bigredv2/outside/admin_building)
"gW" = (
/obj/structure/pipes/standard/simple/hidden/green{
	dir = 4
	},
/obj/structure/machinery/door/airlock/almayer/command/colony{
	name = "\improper Operations Office"
	},
/turf/open/floor/wood,
/area/bigredv2/outside/admin_building)
"jq" = (
/obj/item/weapon/gun/rifle/m41a/corporate{
	current_mag = /obj/item/ammo_magazine/rifle/rubber;
	desc = "A Weyland-Yutani creation, this M41A MK2 comes equipped in corporate white. Uses 10x24mm caseless ammunition. It seems to be pretty battered and broken up.";
	name = "battered M41A pulse rifle MK2";
	pixel_x = 4
	},
/turf/open/floor/carpet,
/area/bigredv2/outside/admin_building)
"jH" = (
/obj/structure/machinery/door/airlock/almayer/command/colony{
	dir = 1;
	name = "\improper Operations Meeting Room"
	},
/turf/open/floor/delivery,
/area/bigredv2/outside/admin_building)
"kt" = (
/obj/structure/pipes/standard/simple/hidden/green{
	dir = 4
	},
/turf/open/floor/darkredcorners2,
/area/bigredv2/outside/admin_building)
"kv" = (
/obj/structure/barricade/metal/wired{
	dir = 4
	},
/turf/open/floor/wood,
/area/bigredv2/outside/admin_building)
"kY" = (
/obj/structure/pipes/standard/simple/hidden/green,
/obj/effect/landmark/crap_item,
/turf/open/floor/darkred2/west,
/area/bigredv2/outside/admin_building)
"mw" = (
/obj/item/ammo_box/magazine{
	num_of_magazines = 2
	},
/obj/item/ammo_magazine/rifle{
	current_rounds = 0;
	pixel_x = -8;
	pixel_y = 13
	},
/obj/item/ammo_magazine/rifle{
	current_rounds = 0;
	pixel_x = 14;
	pixel_y = 17
	},
/turf/open/floor/wood,
/area/bigredv2/outside/admin_building)
"oS" = (
/obj/item/ammo_magazine/rifle{
	current_rounds = 0;
	pixel_x = -9;
	pixel_y = 7
	},
/turf/open/floor/wood,
/area/bigredv2/outside/admin_building)
"pQ" = (
/obj/structure/window/framed/solaris/reinforced,
/obj/structure/machinery/door/poddoor/shutters/almayer{
	dir = 4;
	id = "Operations";
	name = "\improper Operations Shutters"
	},
/turf/open/floor/plating,
/area/bigredv2/outside/admin_building)
"sr" = (
/obj/structure/platform{
	dir = 8
	},
/turf/open/floor/dark,
/area/bigredv2/outside/admin_building)
"vx" = (
/obj/item/ammo_magazine/rifle{
	current_rounds = 0;
	pixel_x = -8;
	pixel_y = 9
	},
/obj/structure/pipes/standard/simple/hidden/green{
	dir = 4
	},
/turf/open/floor/wood,
/area/bigredv2/outside/admin_building)
"vR" = (
/turf/open/floor/darkred2/east,
/area/bigredv2/outside/admin_building)
"wH" = (
/obj/item/ammo_box/magazine/ext{
	num_of_magazines = 1
	},
/turf/open/floor/wood,
/area/bigredv2/outside/admin_building)
"xr" = (
/obj/effect/spawner/random/toolbox,
/obj/structure/platform_decoration,
/turf/open/floor/dark,
/area/bigredv2/outside/admin_building)
"xV" = (
/obj/structure/barricade/sandbags/wired,
/turf/open/floor/darkred2/east,
/area/bigredv2/outside/admin_building)
"za" = (
/obj/structure/pipes/standard/simple/hidden/green{
	dir = 4
	},
/obj/structure/machinery/door/airlock/almayer/command/colony{
	name = "\improper Operations Meeting Room"
	},
/obj/structure/pipes/standard/simple/hidden/green{
	dir = 4
	},
/turf/open/floor,
/area/bigredv2/outside/admin_building)
"zv" = (
/obj/structure/pipes/standard/simple/hidden/green{
	dir = 4
	},
/turf/open/floor/darkred2/east,
/area/bigredv2/outside/admin_building)
"zF" = (
/obj/structure/machinery/light{
	dir = 8
	},
/obj/item/ammo_magazine/rifle{
	current_rounds = 0;
	pixel_x = -2;
	pixel_y = -10
	},
/obj/item/ammo_box/magazine/m4a3{
	num_of_magazines = 2
	},
/turf/open/floor/wood,
/area/bigredv2/outside/admin_building)
"AC" = (
/obj/item/ammo_magazine/pistol/rubber{
	current_rounds = 0
	},
/turf/open/floor/carpet,
/area/bigredv2/outside/admin_building)
"Br" = (
/obj/structure/surface/table,
/obj/item/storage/firstaid/regular/empty,
/turf/open/floor/carpet,
/area/bigredv2/outside/admin_building)
"BL" = (
/obj/structure/barricade/metal/wired{
	dir = 4;
	icon_state = "metal_2"
	},
/turf/open/floor/wood,
/area/bigredv2/outside/admin_building)
"BW" = (
/obj/structure/platform,
/obj/structure/flora/jungle/planttop1{
	pixel_y = 10
	},
/turf/open/floor/dark,
/area/bigredv2/outside/admin_building)
"Ce" = (
/obj/structure/pipes/standard/simple/hidden/green{
	dir = 4
	},
/turf/open/floor/dark,
/area/bigredv2/outside/admin_building)
"EC" = (
/obj/effect/landmark/survivor_spawner,
/obj/structure/platform_decoration{
	dir = 1
	},
/turf/open/floor/dark,
/area/bigredv2/outside/admin_building)
"EL" = (
/obj/structure/surface/table,
/obj/item/device/radio/marine,
/obj/item/weapon/gun/pistol/m4a3/training{
	name = "dented M4A3 service pistol"
	},
/obj/item/ammo_magazine/pistol/rubber,
/turf/open/floor/carpet,
/area/bigredv2/outside/admin_building)
"Fi" = (
/obj/structure/platform{
	dir = 1
	},
/turf/open/floor/dark,
/area/bigredv2/outside/admin_building)
"Fp" = (
/obj/structure/pipes/standard/manifold/hidden/green{
	dir = 8
	},
/turf/open/floor/darkred2/west,
/area/bigredv2/outside/admin_building)
"Gx" = (
/turf/open/floor/darkred2/southwest,
/area/bigredv2/outside/admin_building)
"GR" = (
/obj/structure/pipes/standard/simple/hidden/green,
/obj/structure/machinery/light{
	dir = 8
	},
/turf/open/floor/darkred2/west,
/area/bigredv2/outside/admin_building)
"HY" = (
/obj/structure/platform_decoration{
	dir = 8
	},
/obj/effect/decal/cleanable/blood/xeno,
/turf/open/floor/dark,
/area/bigredv2/outside/admin_building)
"Js" = (
/obj/item/device/radio/intercom{
	freerange = 1;
	frequency = 1469;
	name = "General Listening Channel";
	pixel_x = 30
	},
/turf/open/floor/darkred2/southeast,
/area/bigredv2/outside/admin_building)
"Jt" = (
/obj/effect/decal/cleanable/blood,
/turf/open/floor/dark,
/area/bigredv2/outside/admin_building)
"Jy" = (
/turf/open/floor/darkred2,
/area/bigredv2/outside/admin_building)
"JM" = (
/obj/structure/pipes/standard/simple/hidden/green,
/obj/effect/decal/cleanable/blood/xeno,
/turf/open/floor/darkredcorners2/west,
/area/bigredv2/outside/admin_building)
"Li" = (
/obj/item/ammo_magazine/rifle{
	current_rounds = 0
	},
/turf/open/floor/wood,
/area/bigredv2/outside/admin_building)
"Nz" = (
/obj/structure/pipes/standard/simple/hidden/green,
/turf/open/floor/darkred2/west,
/area/bigredv2/outside/admin_building)
"NX" = (
/turf/open/floor/dark,
/area/bigredv2/outside/admin_building)
"Od" = (
/obj/structure/machinery/light{
	dir = 8
	},
/obj/effect/decal/cleanable/blood{
	icon_state = "gib6"
	},
/turf/open/floor/wood,
/area/bigredv2/outside/admin_building)
"Qf" = (
/obj/structure/platform{
	dir = 4
	},
/turf/open/floor/dark,
/area/bigredv2/outside/admin_building)
"RN" = (
/obj/structure/pipes/standard/simple/hidden/green,
/obj/structure/barricade/sandbags/wired,
/turf/open/floor/darkred2/west,
/area/bigredv2/outside/admin_building)
"Sz" = (
/obj/item/ammo_magazine/rifle/rubber{
	current_rounds = 0;
	pixel_x = 5;
	pixel_y = -5
	},
/turf/open/floor/carpet,
/area/bigredv2/outside/admin_building)
"WP" = (
/turf/open/floor/wood,
/area/bigredv2/outside/admin_building)
"Xw" = (
/obj/structure/pipes/standard/simple/hidden/green{
	dir = 4
	},
/obj/effect/decal/cleanable/blood/xeno,
/turf/open/floor/darkred2,
/area/bigredv2/outside/admin_building)
"Ze" = (
/obj/item/ammo_magazine/pistol/rubber{
	current_rounds = 0
	},
/turf/open/floor/wood,
/area/bigredv2/outside/admin_building)

(1,1,1) = {"
pQ
ab
ab
ab
ab
ab
ab
ab
ab
ab
"}
(2,1,1) = {"
Jy
aD
Od
fR
as
WP
Li
zF
wH
ab
"}
(3,1,1) = {"
Jy
ak
dp
AC
aJ
aO
aJ
aQ
mw
bp
"}
(4,1,1) = {"
Jy
ak
at
aB
EL
Br
aV
ba
WP
oS
"}
(5,1,1) = {"
Jy
ae
jq
aC
aQ
aC
Sz
bb
WP
WP
"}
(6,1,1) = {"
NX
jH
au
aW
aL
aS
aQ
bc
WP
Ze
"}
(7,1,1) = {"
Jy
ae
BL
kv
kv
gc
kv
vx
WP
WP
"}
(8,1,1) = {"
Jy
ae
ae
ad
ad
ad
ae
za
ae
ae
"}
(9,1,1) = {"
JM
GR
Nz
Fp
RN
Nz
kY
gb
Gx
bs
"}
(10,1,1) = {"
xr
Qf
HY
Ce
NX
Jt
NX
Ce
NX
bs
"}
(11,1,1) = {"
BW
ap
Fi
kt
xV
fy
vR
zv
Js
bs
"}
(12,1,1) = {"
EC
sr
gI
Xw
ae
ae
ae
gW
ae
ae
"}
