//MAP CONVERTED BY dmm2tgm.py THIS HEADER COMMENT PREVENTS RECONVERSION, DO NOT REMOVE
"aF" = (
/obj/effect/decal/cleanable/dirt,
/turf/open/floor/asteroidwarning/southeast,
/area/bigredv2/outside/filtration_cave_cas)
"aN" = (
/obj/structure/surface/table/almayer,
/obj/structure/machinery/computer/secure_data{
	dir = 8
	},
/turf/open/floor,
/area/bigred/ground/security)
"aV" = (
/obj/effect/decal/cleanable/dirt,
/turf/open/floor/asteroidfloor/north,
/area/bigredv2/outside/filtration_cave_cas)
"bx" = (
/obj/structure/surface/table/almayer,
/obj/item/device/motiondetector,
/turf/open/floor,
/area/bigred/ground/security)
"cI" = (
/obj/structure/surface/table/almayer,
/obj/structure/phone_base/colony_net/rotary{
	phone_category = "Solaris Ridge";
	phone_color = "red";
	phone_id = "Filtration Checkpoint"
	},
/turf/open/floor/greengrid,
/area/bigred/ground/security)
"dZ" = (
/obj/effect/decal/cleanable/dirt,
/turf/open/floor/asteroidwarning/east,
/area/bigredv2/outside/se)
"ev" = (
/obj/structure/machinery/light{
	dir = 1
	},
/obj/effect/decal/cleanable/dirt,
/turf/open/floor/asteroidwarning/northwest,
/area/bigredv2/outside/filtration_cave_cas)
"ge" = (
/obj/structure/closet/secure_closet/marshal,
/turf/open/floor/greengrid,
/area/bigred/ground/security)
"gF" = (
/obj/effect/decal/cleanable/dirt,
/turf/open/floor/asteroidwarning/northwest,
/area/bigredv2/outside/filtration_cave_cas)
"hR" = (
/obj/effect/decal/cleanable/dirt,
/obj/structure/blocker/forcefield/multitile_vehicles,
/turf/open/floor/asteroidwarning/southeast,
/area/bigredv2/outside/filtration_cave_cas)
"kN" = (
/obj/effect/decal/cleanable/dirt,
/obj/structure/blocker/forcefield/multitile_vehicles,
/turf/open/floor/asteroidwarning/east,
/area/bigredv2/outside/filtration_cave_cas)
"kO" = (
/turf/open/floor/asteroidwarning/west,
/area/bigredv2/outside/filtration_cave_cas)
"kX" = (
/turf/closed/wall/solaris/reinforced,
/area/bigred/ground/security)
"ld" = (
/obj/effect/decal/cleanable/dirt,
/obj/structure/machinery/door/poddoor/almayer/closed{
	dir = 4;
	id = "filtration";
	name = "Filtration Lockdown"
	},
/turf/open/floor/delivery,
/area/bigredv2/outside/filtration_cave_cas)
"lK" = (
/turf/open/floor/asteroidwarning,
/area/bigredv2/outside/filtration_cave_cas)
"lY" = (
/obj/effect/decal/cleanable/dirt,
/turf/open/floor/asteroidwarning,
/area/bigredv2/outside/filtration_cave_cas)
"mU" = (
/obj/item/tool/warning_cone,
/turf/open/floor/asteroidwarning/north,
/area/bigredv2/outside/filtration_cave_cas)
"nN" = (
/turf/open/floor/asteroidwarning/southwest,
/area/bigredv2/outside/filtration_cave_cas)
"oG" = (
/obj/structure/blocker/forcefield/multitile_vehicles,
/turf/open/mars_cave/mars_cave_2,
/area/bigredv2/outside/filtration_cave_cas)
"oT" = (
/turf/closed/wall/solaris/reinforced,
/area/bigredv2/outside/filtration_cave_cas)
"pV" = (
/obj/structure/surface/table/almayer,
/obj/effect/spawner/random/tool,
/turf/open/floor,
/area/bigred/ground/security)
"qy" = (
/obj/item/device/radio,
/obj/structure/surface/table/almayer,
/turf/open/floor,
/area/bigred/ground/security)
"qG" = (
/obj/effect/decal/cleanable/dirt,
/turf/open/floor/asteroidwarning/north,
/area/bigredv2/outside/filtration_cave_cas)
"rD" = (
/obj/structure/machinery/camera/autoname{
	dir = 8
	},
/turf/open/floor,
/area/bigred/ground/security)
"rF" = (
/obj/structure/machinery/deployable/barrier,
/turf/open/floor/greengrid,
/area/bigred/ground/security)
"ts" = (
/obj/effect/landmark/hunter_primary,
/obj/structure/blocker/forcefield/multitile_vehicles,
/turf/open/floor/asteroidwarning/northeast,
/area/bigredv2/outside/filtration_cave_cas)
"tK" = (
/obj/structure/machinery/door/airlock/almayer/security/glass/colony{
	icon_state = "door_locked";
	name = "\improper Checkpoint Office"
	},
/turf/open/floor,
/area/bigred/ground/security)
"ub" = (
/obj/structure/surface/table/almayer,
/obj/item/restraint/handcuffs,
/turf/open/floor,
/area/bigred/ground/security)
"uk" = (
/obj/effect/decal/cleanable/dirt,
/turf/open/floor,
/area/bigred/ground/security)
"uF" = (
/obj/structure/surface/table/almayer,
/obj/effect/spawner/random/technology_scanner,
/turf/open/floor/greengrid,
/area/bigred/ground/security)
"vH" = (
/obj/effect/decal/cleanable/blood,
/turf/open/floor,
/area/bigred/ground/security)
"vO" = (
/obj/structure/surface/rack,
/obj/item/stack/sheet/metal/small_stack,
/turf/open/floor,
/area/bigred/ground/security)
"wQ" = (
/obj/effect/decal/cleanable/dirt,
/turf/open/floor/asteroidwarning/east,
/area/bigredv2/outside/filtration_cave_cas)
"xa" = (
/turf/open/floor/greengrid,
/area/bigred/ground/security)
"xj" = (
/obj/structure/bed/chair/office/light{
	dir = 4
	},
/turf/open/floor,
/area/bigred/ground/security)
"xr" = (
/obj/structure/surface/rack,
/obj/item/clothing/mask/gas,
/obj/item/device/flashlight,
/obj/structure/machinery/light{
	dir = 4
	},
/turf/open/floor,
/area/bigred/ground/security)
"ze" = (
/turf/open/floor/asteroidwarning/southeast,
/area/bigredv2/outside/se)
"AY" = (
/turf/open/floor,
/area/bigred/ground/security)
"Bb" = (
/obj/structure/machinery/light{
	dir = 1
	},
/turf/open/floor/asteroidwarning/north,
/area/bigredv2/outside/filtration_cave_cas)
"FH" = (
/turf/open/floor/asteroidwarning/east,
/area/bigredv2/outside/se)
"GB" = (
/obj/effect/landmark/crap_item,
/turf/open/floor/asteroidwarning/northeast,
/area/bigredv2/outside/filtration_cave_cas)
"Hf" = (
/obj/item/tool/warning_cone,
/turf/open/floor/asteroidwarning/northeast,
/area/bigredv2/outside/se)
"Hm" = (
/obj/structure/machinery/door/poddoor/almayer/closed{
	dir = 4;
	id = "filtration";
	name = "Filtration Lockdown"
	},
/turf/open/floor/delivery,
/area/bigredv2/outside/filtration_cave_cas)
"Hq" = (
/obj/structure/machinery/power/apc/no_power/north,
/turf/open/floor,
/area/bigred/ground/security)
"IB" = (
/obj/structure/machinery/camera/autoname,
/turf/open/floor/asteroidwarning/north,
/area/bigredv2/outside/filtration_cave_cas)
"IS" = (
/obj/structure/filingcabinet,
/turf/open/floor/greengrid,
/area/bigred/ground/security)
"KO" = (
/obj/item/trash/sosjerky,
/obj/effect/decal/cleanable/dirt,
/turf/open/floor,
/area/bigred/ground/security)
"LX" = (
/obj/structure/machinery/light{
	dir = 8
	},
/obj/effect/decal/cleanable/dirt,
/turf/open/floor,
/area/bigred/ground/security)
"Mq" = (
/obj/structure/surface/table/almayer,
/turf/open/floor/greengrid,
/area/bigred/ground/security)
"MC" = (
/obj/effect/decal/cleanable/dirt,
/turf/open/floor/asteroidwarning/southwest,
/area/bigredv2/outside/filtration_cave_cas)
"NQ" = (
/obj/structure/largecrate,
/turf/open/floor/greengrid,
/area/bigred/ground/security)
"NU" = (
/obj/structure/machinery/light{
	dir = 8
	},
/obj/structure/machinery/vending/security,
/turf/open/floor,
/area/bigred/ground/security)
"Pf" = (
/obj/effect/decal/cleanable/blood,
/obj/effect/spawner/gibspawner/human,
/turf/open/floor,
/area/bigred/ground/security)
"PS" = (
/turf/open/mars,
/area/bigredv2/outside/se)
"Ql" = (
/obj/effect/decal/cleanable/dirt,
/turf/open/floor/asteroidwarning/west,
/area/bigredv2/outside/filtration_cave_cas)
"Qo" = (
/obj/structure/blocker/forcefield/multitile_vehicles,
/turf/closed/wall/solaris/reinforced,
/area/bigred/ground/security)
"Sr" = (
/obj/structure/machinery/camera/autoname{
	dir = 8
	},
/obj/structure/surface/rack,
/obj/effect/spawner/random/toolbox,
/turf/open/floor,
/area/bigred/ground/security)
"SF" = (
/obj/structure/window/framed/solaris/reinforced,
/turf/open/floor/plating,
/area/bigred/ground/security)
"Td" = (
/obj/structure/machinery/door/airlock/almayer/security/glass/colony{
	dir = 1;
	name = "\improper Checkpoint Office"
	},
/obj/structure/blocker/forcefield/multitile_vehicles,
/turf/open/floor/delivery,
/area/bigred/ground/security)
"Vn" = (
/obj/structure/surface/table/almayer,
/obj/item/ashtray/bronze,
/obj/item/trash/cigbutt/cigarbutt,
/turf/open/floor/greengrid,
/area/bigred/ground/security)
"Vv" = (
/turf/open/floor/asteroidfloor/north,
/area/bigredv2/outside/filtration_cave_cas)
"VI" = (
/obj/structure/largecrate,
/turf/open/floor,
/area/bigred/ground/security)
"XM" = (
/obj/structure/machinery/door/airlock/almayer/security/glass/colony{
	dir = 1;
	name = "\improper Checkpoint Office"
	},
/turf/open/floor/delivery,
/area/bigred/ground/security)
"Yo" = (
/obj/structure/surface/rack,
/obj/item/storage/firstaid,
/turf/open/floor,
/area/bigred/ground/security)
"YZ" = (
/obj/structure/surface/table/almayer,
/obj/structure/machinery/computer/cameras/wooden_tv{
	dir = 8
	},
/turf/open/floor/greengrid,
/area/bigred/ground/security)
"ZK" = (
/obj/effect/landmark/crap_item,
/obj/structure/machinery/light{
	dir = 4
	},
/turf/open/floor,
/area/bigred/ground/security)
"ZL" = (
/turf/open/floor/asteroidwarning/north,
/area/bigredv2/outside/filtration_cave_cas)

(1,1,1) = {"
PS
Hf
dZ
FH
ze
kX
kX
kX
kX
kX
kX
kX
kX
Qo
"}
(2,1,1) = {"
oT
Hm
Hm
Hm
Hm
kX
IS
LX
qy
bx
ub
NU
rF
Qo
"}
(3,1,1) = {"
oT
ev
kO
Ql
MC
SF
cI
AY
KO
uk
uk
AY
rF
Qo
"}
(4,1,1) = {"
oT
GB
wQ
wQ
aF
SF
Vn
xj
uk
AY
uk
uk
AY
Td
"}
(5,1,1) = {"
oT
Hm
Hm
ld
ld
kX
YZ
aN
rD
AY
uk
AY
ge
Qo
"}
(6,1,1) = {"
oT
gF
kO
kO
nN
kX
kX
kX
kX
tK
kX
kX
kX
Qo
"}
(7,1,1) = {"
oT
IB
Vv
aV
lY
kX
VI
VI
AY
uk
AY
pV
Mq
Qo
"}
(8,1,1) = {"
oT
ZL
Vv
aV
lY
kX
Hq
AY
uk
uk
AY
AY
uF
Qo
"}
(9,1,1) = {"
oT
qG
aV
Vv
lK
XM
uk
uk
AY
AY
uk
AY
xa
Qo
"}
(10,1,1) = {"
oT
Bb
Vv
Vv
lK
kX
AY
Pf
vH
AY
uk
uk
xa
Qo
"}
(11,1,1) = {"
oT
mU
Vv
aV
lY
kX
vH
ZK
Sr
Yo
vO
xr
NQ
Qo
"}
(12,1,1) = {"
oG
ts
kN
kN
hR
Qo
Qo
Qo
Qo
Qo
Qo
Qo
Qo
Qo
"}
