//MAP CONVERTED BY dmm2tgm.py THIS HEADER COMMENT PREVENTS RECONVERSION, DO NOT REMOVE
"a" = (
/obj/effect/decal/cleanable/dirt{
	layer = 2.52
	},
/obj/structure/machinery/door/poddoor/railing{
	density = 0;
	dir = 2
	},
/turf/open/floor/almayer/edge/smooth,
/area/golden_arrow/hangar_shuttle/upper)
"g" = (
/obj/effect/decal/warning_stripes{
	icon_state = "E";
	pixel_x = 1
	},
/obj/effect/decal/warning_stripes{
	icon_state = "SW-out"
	},
/obj/structure/cable/heavyduty{
	icon_state = "1-2"
	},
/obj/structure/machinery/gear{
	id = "garrow_hangar_elevator"
	},
/turf/open/floor/almayer/edge/smooth/corner,
/area/golden_arrow/hangar_shuttle/upper)
"i" = (
/obj/structure/machinery/door/poddoor/railing{
	density = 0
	},
/turf/open/floor/almayer/edge/smooth{
	dir = 1
	},
/area/golden_arrow/hangar_shuttle/upper)
"p" = (
/obj/effect/decal/warning_stripes{
	icon_state = "SE-out";
	pixel_x = 1
	},
/obj/effect/decal/cleanable/dirt{
	layer = 2.52
	},
/obj/structure/pipes/standard/simple/hidden/supply,
/obj/structure/machinery/gear{
	id = "garrow_hangar_elevator"
	},
/turf/open/floor/almayer/edge/smooth/corner{
	dir = 4
	},
/area/golden_arrow/hangar_shuttle/upper)
"u" = (
/obj/effect/decal/warning_stripes{
	icon_state = "E";
	pixel_x = 1
	},
/obj/structure/cable/heavyduty{
	icon_state = "1-2"
	},
/obj/structure/machinery/door/poddoor/railing{
	density = 0;
	dir = 8
	},
/turf/open/floor/almayer/edge/smooth{
	dir = 8
	},
/area/golden_arrow/hangar_shuttle/upper)
"z" = (
/obj/docking_port/stationary/trijent_elevator/shipmap_elevator/hangar{
	roundstart_template = /datum/map_template/shuttle/trijent_elevator/golden_arrow/hangar;
	name = "Hangar";
	id = "garrow_hangar_elevator";
	elevator_network = "ArrowHangar";
	airlock_area = /area/golden_arrow/hangar_shuttle/upper;
	load_post_roundstart = 1
	},
/turf/open/floor/almayer/empty/golden_arrow/hangar,
/area/golden_arrow/hangar_shuttle/upper)
"A" = (
/turf/open/floor/almayer/empty/golden_arrow/hangar,
/area/golden_arrow/hangar_shuttle/upper)
"J" = (
/obj/structure/pipes/standard/simple/hidden/supply,
/obj/structure/machinery/door/poddoor/railing{
	density = 0;
	dir = 4
	},
/turf/open/floor/almayer/edge/smooth{
	dir = 4
	},
/area/golden_arrow/hangar_shuttle/upper)
"L" = (
/obj/structure/pipes/vents/scrubber{
	dir = 8
	},
/obj/structure/machinery/door/poddoor/railing{
	density = 0
	},
/turf/open/floor/almayer/edge/smooth{
	dir = 1
	},
/area/golden_arrow/hangar_shuttle/upper)
"N" = (
/obj/structure/pipes/standard/manifold/hidden/supply{
	dir = 4
	},
/obj/structure/machinery/door/poddoor/railing{
	density = 0;
	dir = 4
	},
/turf/open/floor/almayer/edge/smooth{
	dir = 4
	},
/area/golden_arrow/hangar_shuttle/upper)
"Q" = (
/obj/effect/decal/warning_stripes{
	icon_state = "E";
	pixel_x = 1
	},
/obj/effect/decal/warning_stripes{
	icon_state = "NW-out";
	pixel_y = 1
	},
/obj/structure/cable/heavyduty{
	icon_state = "1-2"
	},
/obj/structure/machinery/gear{
	id = "garrow_hangar_elevator"
	},
/turf/open/floor/almayer/edge/smooth/corner{
	dir = 8
	},
/area/golden_arrow/hangar_shuttle/upper)
"V" = (
/obj/effect/decal/warning_stripes{
	icon_state = "NE-out";
	pixel_y = 1;
	pixel_x = 1
	},
/obj/structure/pipes/standard/manifold/hidden/supply{
	dir = 8
	},
/obj/structure/machinery/gear{
	id = "garrow_hangar_elevator"
	},
/turf/open/floor/almayer/edge/smooth/corner{
	dir = 1
	},
/area/golden_arrow/hangar_shuttle/upper)

(1,1,1) = {"
p
J
N
J
V
"}
(2,1,1) = {"
a
A
A
z
L
"}
(3,1,1) = {"
a
A
A
A
i
"}
(4,1,1) = {"
g
u
u
u
Q
"}
