//MAP CONVERTED BY dmm2tgm.py THIS HEADER COMMENT PREVENTS RECONVERSION, DO NOT REMOVE
"bA" = (
/obj/structure/machinery/colony_floodlight,
/turf/open/gm/grass/grass1,
/area/lv624/ground/jungle/central_jungle)
"dF" = (
/obj/structure/filingcabinet/medical,
/turf/open/floor,
/area/lv624/lazarus/fitness)
"gU" = (
/obj/structure/surface/rack,
/obj/effect/landmark/item_pool_spawner/survivor_ammo/buckshot,
/turf/open/floor/whitepurplecorner/east,
/area/lv624/lazarus/fitness)
"hr" = (
/obj/structure/machinery/vending/cola,
/turf/open/floor/whitepurplecorner/east,
/area/lv624/lazarus/fitness)
"ic" = (
/turf/open/gm/grass/grass2,
/area/lv624/ground/jungle/central_jungle)
"iv" = (
/obj/item/toy/inflatable_duck,
/turf/open/gm/river,
/area/lv624/lazarus/fitness)
"iJ" = (
/turf/open/gm/dirtgrassborder/grassdirt_corner/south_east,
/area/lv624/ground/colony/north_nexus_road)
"je" = (
/turf/open/floor/whitepurplecorner/east,
/area/lv624/lazarus/fitness)
"jq" = (
/obj/structure/reagent_dispensers/water_cooler/stacks,
/turf/open/floor/whitepurplecorner/east,
/area/lv624/lazarus/fitness)
"jU" = (
/obj/structure/sign/safety/water{
	pixel_x = 7;
	pixel_y = 26
	},
/obj/structure/surface/table,
/obj/item/storage/box/cups,
/turf/open/floor/whitepurplecorner/east,
/area/lv624/lazarus/fitness)
"kF" = (
/obj/structure/surface/rack,
/obj/effect/landmark/item_pool_spawner/survivor_ammo/buckshot,
/obj/item/storage/firstaid/regular,
/turf/open/floor/whitepurplecorner/east,
/area/lv624/lazarus/fitness)
"ma" = (
/obj/structure/flora/grass/tallgrass/jungle/corner{
	dir = 9
	},
/turf/open/gm/grass/grass1,
/area/lv624/ground/jungle/central_jungle)
"ov" = (
/obj/structure/machinery/light{
	dir = 8
	},
/turf/open/floor/whitepurplecorner/east,
/area/lv624/lazarus/fitness)
"qa" = (
/obj/effect/landmark/good_item,
/turf/open/floor/whitepurplecorner/east,
/area/lv624/lazarus/fitness)
"rn" = (
/obj/structure/closet/athletic_mixed,
/obj/structure/machinery/light{
	dir = 8
	},
/turf/open/floor/whitepurplecorner/east,
/area/lv624/lazarus/fitness)
"sa" = (
/obj/item/tool/soap,
/turf/open/floor/barber/west,
/area/lv624/lazarus/fitness)
"sA" = (
/turf/closed/wall,
/area/lv624/lazarus/fitness)
"tC" = (
/obj/effect/landmark/good_item,
/turf/open/floor/barber/west,
/area/lv624/lazarus/fitness)
"uf" = (
/obj/item/clothing/under/shorts/red,
/obj/structure/surface/rack,
/obj/item/clothing/mask/snorkel,
/obj/item/clothing/mask/snorkel,
/obj/item/clothing/mask/snorkel,
/turf/open/floor/whitepurplecorner/east,
/area/lv624/lazarus/fitness)
"wj" = (
/turf/open/gm/dirt,
/area/lv624/ground/colony/south_medbay_road)
"wH" = (
/obj/structure/flora/bush/ausbushes/genericbush,
/turf/open/gm/grass/grass1,
/area/lv624/ground/jungle/east_central_jungle)
"wO" = (
/obj/structure/flora/grass/tallgrass/jungle/corner{
	dir = 8
	},
/turf/open/gm/grass/grass1,
/area/lv624/ground/jungle/central_jungle)
"xt" = (
/obj/structure/flora/grass/tallgrass/jungle/corner{
	dir = 5
	},
/turf/open/gm/grass/grass1,
/area/lv624/ground/jungle/central_jungle)
"xS" = (
/turf/open/gm/grass/grass1,
/area/lv624/ground/colony/south_medbay_road)
"yb" = (
/obj/structure/machinery/light{
	dir = 4
	},
/turf/open/floor/whitepurplecorner/east,
/area/lv624/lazarus/fitness)
"yO" = (
/obj/item/toy/beach_ball,
/turf/open/gm/river,
/area/lv624/lazarus/fitness)
"Bv" = (
/obj/structure/machinery/light{
	dir = 4
	},
/obj/structure/machinery/cm_vending/sorted/medical/wall_med/limited{
	pixel_x = 29
	},
/turf/open/floor/whitepurplecorner/east,
/area/lv624/lazarus/fitness)
"Cf" = (
/obj/effect/decal/cleanable/blood/splatter,
/turf/open/floor/whitepurplecorner/east,
/area/lv624/lazarus/fitness)
"Cv" = (
/obj/structure/prop/static_tank/water,
/turf/open/floor/whitepurplecorner/east,
/area/lv624/lazarus/fitness)
"DW" = (
/obj/structure/closet/crate/secure/hydrosec,
/turf/open/floor/whitepurplecorner/east,
/area/lv624/lazarus/fitness)
"Ez" = (
/turf/open/floor,
/area/lv624/lazarus/fitness)
"EG" = (
/turf/open/gm/river,
/area/lv624/lazarus/fitness)
"Fx" = (
/obj/structure/window_frame/colony,
/obj/item/shard,
/turf/open/floor/plating,
/area/lv624/lazarus/fitness)
"Gf" = (
/turf/open/gm/dirtgrassborder/grassdirt_corner2/south_west,
/area/lv624/ground/colony/south_medbay_road)
"Ir" = (
/obj/structure/machinery/vending/snack,
/turf/open/floor/whitepurplecorner/east,
/area/lv624/lazarus/fitness)
"IL" = (
/obj/item/shard,
/turf/open/floor/whitepurplecorner/east,
/area/lv624/lazarus/fitness)
"Jk" = (
/obj/structure/flora/grass/tallgrass/jungle/corner{
	dir = 10
	},
/turf/open/gm/grass/grass1,
/area/lv624/ground/jungle/central_jungle)
"JM" = (
/obj/effect/landmark/crap_item,
/turf/open/gm/grass/grass1,
/area/lv624/ground/colony/south_medbay_road)
"KS" = (
/obj/structure/fence,
/turf/open/gm/grass/grass1,
/area/lv624/ground/colony/north_nexus_road)
"Mn" = (
/obj/structure/machinery/door/airlock/multi_tile/almayer/generic{
	dir = 1;
	name = "\improper Leisure Dome";
	req_access_txt = "100"
	},
/turf/open/floor/whitepurple/northeast,
/area/lv624/lazarus/fitness)
"NC" = (
/turf/open/gm/grass/grass1,
/area/lv624/ground/jungle/central_jungle)
"Of" = (
/obj/structure/machinery/atm{
	name = "Weyland-Yutani Automatic Teller Machine";
	pixel_x = -30
	},
/obj/structure/machinery/light{
	dir = 8
	},
/turf/open/floor/whitepurplecorner/east,
/area/lv624/lazarus/fitness)
"Ot" = (
/obj/structure/window_frame/colony,
/turf/open/floor/plating,
/area/lv624/lazarus/fitness)
"Ou" = (
/obj/effect/landmark/survivor_spawner,
/turf/open/gm/river,
/area/lv624/lazarus/fitness)
"Pw" = (
/turf/open/gm/dirt,
/area/lv624/ground/colony/north_nexus_road)
"Rh" = (
/obj/effect/decal/remains/human,
/obj/structure/machinery/power/apc/no_power/north,
/turf/open/floor/whitepurplecorner/east,
/area/lv624/lazarus/fitness)
"RA" = (
/obj/structure/surface/rack,
/obj/effect/decal/cleanable/dirt,
/obj/item/clothing/under/swimsuit/black,
/obj/item/clothing/under/swimsuit/blue{
	pixel_x = 7
	},
/obj/item/clothing/under/swimsuit/red{
	pixel_x = -7
	},
/turf/open/floor/whitepurplecorner/east,
/area/lv624/lazarus/fitness)
"Td" = (
/obj/structure/machinery/colony_floodlight,
/turf/open/gm/grass/grass1,
/area/lv624/ground/colony/south_medbay_road)
"Ua" = (
/obj/structure/flora/grass/tallgrass/jungle,
/turf/open/gm/grass/grass1,
/area/lv624/ground/jungle/central_jungle)
"Uh" = (
/turf/open/floor/barber/west,
/area/lv624/lazarus/fitness)
"UB" = (
/obj/item/clothing/under/shorts/red,
/obj/structure/surface/rack,
/obj/item/clothing/under/shorts/green{
	pixel_x = 1;
	pixel_y = 7
	},
/obj/item/clothing/under/shorts/grey{
	pixel_x = -1;
	pixel_y = -8
	},
/turf/open/floor/whitepurplecorner/east,
/area/lv624/lazarus/fitness)
"Vb" = (
/turf/open/gm/dirtgrassborder/south,
/area/lv624/ground/colony/south_medbay_road)
"Vo" = (
/obj/structure/window/framed/colony,
/turf/open/floor/plating,
/area/lv624/lazarus/fitness)
"Wj" = (
/turf/open/gm/grass/grass1,
/area/lv624/ground/jungle/east_central_jungle)
"WP" = (
/obj/item/device/radio/intercom{
	freerange = 1;
	frequency = 1469;
	name = "General Listening Channel";
	pixel_y = 30
	},
/turf/open/floor/whitepurplecorner/east,
/area/lv624/lazarus/fitness)
"WV" = (
/turf/open/gm/dirtgrassborder/grassdirt_corner2/south_east,
/area/lv624/ground/colony/north_nexus_road)
"Xt" = (
/obj/structure/machinery/door/airlock/almayer/medical/glass/colony{
	dir = 1;
	name = "\improper Leisure Dome";
	req_access_txt = "100";
	req_one_access = null
	},
/turf/open/floor/whitepurple/northeast,
/area/lv624/lazarus/fitness)
"Xz" = (
/obj/structure/closet/athletic_mixed,
/obj/structure/machinery/light{
	dir = 4
	},
/turf/open/floor/whitepurplecorner/east,
/area/lv624/lazarus/fitness)
"Zk" = (
/obj/effect/decal/cleanable/blood/splatter,
/turf/open/floor/whitepurple/northeast,
/area/lv624/lazarus/fitness)
"Zo" = (
/obj/effect/landmark/good_item,
/turf/open/gm/river,
/area/lv624/lazarus/fitness)
"ZM" = (
/obj/structure/fence,
/turf/open/gm/dirtgrassborder/south,
/area/lv624/ground/colony/south_medbay_road)

(1,1,1) = {"
ZM
xS
Td
xS
xS
Vo
Ez
dF
Vo
NC
Jk
Ua
Ua
xt
bA
"}
(2,1,1) = {"
ZM
xS
xS
JM
xS
sA
Zk
Mn
sA
sA
NC
Jk
wO
ma
NC
"}
(3,1,1) = {"
ZM
sA
Vo
Ot
Vo
sA
Rh
Cf
je
sA
Vo
Vo
Ot
sA
NC
"}
(4,1,1) = {"
Vb
Vo
Cv
IL
je
ov
je
je
je
ov
DW
je
gU
Fx
ic
"}
(5,1,1) = {"
Gf
Vo
jq
je
Uh
Uh
Uh
sa
Uh
Uh
Uh
je
kF
Vo
NC
"}
(6,1,1) = {"
wj
sA
jU
je
Uh
EG
EG
EG
Zo
EG
Uh
je
gU
sA
NC
"}
(7,1,1) = {"
sA
sA
je
je
Uh
EG
yO
EG
EG
EG
Uh
je
je
sA
sA
"}
(8,1,1) = {"
Vo
Of
je
je
tC
EG
EG
Ou
EG
EG
Uh
je
je
rn
Vo
"}
(9,1,1) = {"
Xt
je
je
je
Uh
EG
EG
EG
EG
EG
Uh
je
je
je
Xt
"}
(10,1,1) = {"
Ot
yb
je
je
Uh
EG
EG
iv
EG
EG
Uh
je
je
Xz
Vo
"}
(11,1,1) = {"
sA
sA
je
je
Uh
EG
EG
EG
EG
EG
Uh
je
je
sA
sA
"}
(12,1,1) = {"
Pw
sA
je
je
Uh
EG
Ou
EG
EG
EG
Uh
je
RA
sA
Wj
"}
(13,1,1) = {"
WV
Fx
hr
qa
Uh
Uh
Uh
Uh
Uh
Uh
Uh
qa
uf
Vo
Wj
"}
(14,1,1) = {"
iJ
Vo
Ir
je
je
yb
je
je
je
Bv
je
je
UB
Vo
Wj
"}
(15,1,1) = {"
KS
sA
Ot
Vo
Vo
sA
WP
je
je
sA
Vo
Vo
Vo
sA
wH
"}
