//MAP CONVERTED BY dmm2tgm.py THIS HEADER COMMENT PREVENTS RECONVERSION, DO NOT REMOVE
"aG" = (
/obj/structure/window_frame/colony,
/turf/open/floor/plating,
/area/lv624/lazarus/fitness)
"bo" = (
/obj/effect/landmark/crap_item,
/obj/effect/decal/cleanable/dirt,
/turf/open/floor/white,
/area/lv624/lazarus/fitness)
"bL" = (
/obj/structure/surface/rack,
/obj/item/storage/firstaid/o2,
/turf/open/floor/whitepurplecorner/east,
/area/lv624/lazarus/fitness)
"cK" = (
/obj/effect/decal/cleanable/blood/splatter,
/turf/open/floor/whitepurplecorner/east,
/area/lv624/lazarus/fitness)
"dh" = (
/obj/item/toy/beach_ball/holoball,
/obj/effect/decal/warning_stripes,
/obj/effect/decal/cleanable/dirt,
/turf/open/floor/white,
/area/lv624/lazarus/fitness)
"dm" = (
/obj/structure/surface/rack,
/obj/item/weapon/baseballbat,
/obj/item/weapon/baseballbat{
	pixel_x = -6;
	pixel_y = 2
	},
/turf/open/floor/whitepurplecorner/east,
/area/lv624/lazarus/fitness)
"du" = (
/obj/structure/machinery/atm{
	name = "Weyland-Yutani Automatic Teller Machine";
	pixel_x = -30
	},
/obj/effect/decal/cleanable/dirt,
/turf/open/floor/whitepurplecorner/east,
/area/lv624/lazarus/fitness)
"fv" = (
/obj/effect/landmark/survivor_spawner,
/turf/open/floor,
/area/lv624/lazarus/fitness)
"fV" = (
/turf/closed/wall,
/area/lv624/lazarus/fitness)
"gt" = (
/obj/structure/machinery/light,
/turf/open/floor/whitepurplecorner/east,
/area/lv624/lazarus/fitness)
"hr" = (
/obj/structure/surface/rack,
/obj/effect/landmark/item_pool_spawner/survivor_ammo/buckshot,
/turf/open/floor/whitepurplecorner/east,
/area/lv624/lazarus/fitness)
"hL" = (
/turf/open/floor/warnwhite/north,
/area/lv624/lazarus/fitness)
"iG" = (
/obj/effect/decal/cleanable/blood/splatter,
/obj/structure/machinery/light{
	dir = 1
	},
/obj/effect/landmark/corpsespawner/colonist/random/burst,
/turf/open/floor/whitepurplecorner/east,
/area/lv624/lazarus/fitness)
"iN" = (
/obj/structure/barricade/handrail,
/turf/open/floor,
/area/lv624/lazarus/fitness)
"jA" = (
/obj/structure/window_frame/colony,
/obj/item/shard{
	pixel_x = 9;
	pixel_y = -6
	},
/turf/open/floor/plating,
/area/lv624/lazarus/fitness)
"jM" = (
/turf/open/floor/warnwhite,
/area/lv624/lazarus/fitness)
"kg" = (
/turf/open/floor/whitepurplecorner/east,
/area/lv624/lazarus/fitness)
"kj" = (
/obj/structure/holohoop{
	dir = 8
	},
/turf/open/floor/warnwhite/east,
/area/lv624/lazarus/fitness)
"ku" = (
/obj/structure/machinery/conveyor{
	dir = 8;
	id = "lv_gym_1";
	name = "treadmill"
	},
/obj/item/reagent_container/food/drinks/cans/waterbottle{
	pixel_x = 8;
	pixel_y = 7
	},
/turf/open/floor/whitepurplecorner/east,
/area/lv624/lazarus/fitness)
"lq" = (
/turf/open/gm/dirtgrassborder/grassdirt_corner2/south_east,
/area/lv624/ground/colony/north_nexus_road)
"nc" = (
/obj/structure/surface/table/almayer,
/obj/item/reagent_container/food/drinks/cans/waterbottle{
	pixel_x = -5
	},
/obj/effect/spawner/random/toy,
/turf/open/floor/whitepurplecorner/east,
/area/lv624/lazarus/fitness)
"nl" = (
/obj/structure/machinery/colony_floodlight,
/turf/open/gm/grass/grass1,
/area/lv624/ground/jungle/central_jungle)
"nx" = (
/obj/structure/machinery/conveyor{
	dir = 8;
	id = "lv_gym_2";
	name = "treadmill"
	},
/turf/open/floor/whitepurplecorner/east,
/area/lv624/lazarus/fitness)
"oi" = (
/obj/structure/machinery/conveyor_switch{
	id = "lv_gym_1";
	name = "treadmill switch";
	pixel_x = 8;
	pixel_y = 7
	},
/obj/structure/machinery/conveyor_switch{
	id = "lv_gym_2";
	name = "treadmill switch";
	pixel_x = -8;
	pixel_y = -4
	},
/turf/open/floor/whitepurplecorner/east,
/area/lv624/lazarus/fitness)
"oT" = (
/obj/structure/reagent_dispensers/watertank,
/turf/open/floor/whitepurplecorner/east,
/area/lv624/lazarus/fitness)
"pq" = (
/obj/structure/filingcabinet/medical,
/turf/open/floor,
/area/lv624/lazarus/fitness)
"pW" = (
/obj/structure/surface/rack,
/obj/item/tool/mop,
/obj/item/clothing/under/shorts/black{
	pixel_x = 2;
	pixel_y = 2
	},
/obj/effect/landmark/item_pool_spawner/survivor_ammo/buckshot,
/turf/open/floor/whitepurplecorner/east,
/area/lv624/lazarus/fitness)
"qV" = (
/turf/open/floor/warnwhite/southwest,
/area/lv624/lazarus/fitness)
"ry" = (
/obj/item/clothing/under/shorts/red,
/obj/structure/surface/rack,
/obj/item/clothing/under/shorts/green{
	pixel_x = 1;
	pixel_y = 7
	},
/obj/item/clothing/under/shorts/grey{
	pixel_x = -1;
	pixel_y = -8
	},
/turf/open/floor/whitepurplecorner/east,
/area/lv624/lazarus/fitness)
"sx" = (
/obj/structure/window/framed/colony,
/turf/open/floor/plating,
/area/lv624/lazarus/fitness)
"tY" = (
/turf/open/gm/dirt,
/area/lv624/ground/colony/south_medbay_road)
"ux" = (
/obj/effect/landmark/crap_item,
/turf/open/gm/grass/grass1,
/area/lv624/ground/colony/south_medbay_road)
"uF" = (
/obj/structure/barricade/handrail{
	dir = 4
	},
/obj/structure/machinery/light{
	dir = 1
	},
/turf/open/floor,
/area/lv624/lazarus/fitness)
"uY" = (
/obj/structure/barricade/handrail{
	dir = 4
	},
/obj/structure/barricade/handrail,
/obj/effect/decal/cleanable/dirt,
/turf/open/floor,
/area/lv624/lazarus/fitness)
"vZ" = (
/obj/structure/flora/grass/tallgrass/jungle,
/turf/open/gm/grass/grass1,
/area/lv624/ground/jungle/central_jungle)
"wL" = (
/turf/open/gm/dirtgrassborder/south,
/area/lv624/ground/colony/south_medbay_road)
"wW" = (
/obj/structure/machinery/conveyor{
	dir = 8;
	id = "lv_gym_2";
	name = "treadmill"
	},
/obj/effect/landmark/item_pool_spawner/survivor_ammo/buckshot,
/turf/open/floor/whitepurplecorner/east,
/area/lv624/lazarus/fitness)
"Ap" = (
/obj/structure/machinery/door/airlock/almayer/medical/glass/colony{
	dir = 1;
	name = "\improper Leisure Dome";
	req_access_txt = "100";
	req_one_access = null
	},
/turf/open/floor/whitepurple/northeast,
/area/lv624/lazarus/fitness)
"Aq" = (
/obj/structure/flora/grass/tallgrass/jungle/corner{
	dir = 9
	},
/turf/open/gm/grass/grass1,
/area/lv624/ground/jungle/central_jungle)
"AA" = (
/obj/structure/bed/chair,
/turf/open/floor/whitepurplecorner/east,
/area/lv624/lazarus/fitness)
"AC" = (
/obj/effect/spawner/gibspawner/robot,
/obj/effect/decal/cleanable/blood/oil,
/turf/open/floor/whitepurple/northeast,
/area/lv624/lazarus/fitness)
"AM" = (
/obj/structure/holohoop{
	dir = 4
	},
/turf/open/floor/warnwhite/west,
/area/lv624/lazarus/fitness)
"Bj" = (
/obj/structure/machinery/light{
	dir = 1
	},
/obj/effect/decal/cleanable/dirt,
/turf/open/floor/whitepurplecorner/east,
/area/lv624/lazarus/fitness)
"Bl" = (
/turf/open/gm/grass/grass2,
/area/lv624/ground/jungle/central_jungle)
"BE" = (
/obj/structure/window_frame/colony,
/obj/item/shard{
	pixel_x = -11;
	pixel_y = 13
	},
/turf/open/floor/plating,
/area/lv624/lazarus/fitness)
"BR" = (
/obj/structure/closet/lasertag/blue,
/obj/item/tool/crowbar,
/turf/open/floor/whitepurplecorner/east,
/area/lv624/lazarus/fitness)
"Cw" = (
/obj/item/device/radio/intercom{
	freerange = 1;
	frequency = 1469;
	name = "General Listening Channel";
	pixel_y = 30
	},
/obj/effect/decal/cleanable/dirt,
/turf/open/floor/whitepurplecorner/east,
/area/lv624/lazarus/fitness)
"CO" = (
/obj/structure/machinery/colony_floodlight,
/turf/open/gm/grass/grass1,
/area/lv624/ground/colony/south_medbay_road)
"DM" = (
/turf/open/gm/grass/grass1,
/area/lv624/ground/jungle/central_jungle)
"Ed" = (
/turf/open/floor/warnwhite/northeast,
/area/lv624/lazarus/fitness)
"EN" = (
/obj/structure/surface/rack,
/obj/item/clothing/under/shorts/blue,
/obj/item/clothing/suit/redtag{
	pixel_x = 2;
	pixel_y = -5
	},
/obj/effect/decal/cleanable/dirt,
/turf/open/floor/whitepurplecorner/east,
/area/lv624/lazarus/fitness)
"Ge" = (
/obj/structure/barricade/handrail{
	dir = 4
	},
/turf/open/floor,
/area/lv624/lazarus/fitness)
"Gm" = (
/obj/structure/machinery/vending/cola,
/turf/open/floor/whitepurplecorner/east,
/area/lv624/lazarus/fitness)
"Gq" = (
/obj/effect/landmark/crap_item,
/obj/effect/decal/cleanable/dirt,
/turf/open/floor/whitepurplecorner/east,
/area/lv624/lazarus/fitness)
"GO" = (
/obj/structure/machinery/door/airlock/multi_tile/almayer/generic{
	dir = 1;
	name = "\improper Leisure Dome";
	req_access_txt = "100"
	},
/obj/effect/decal/cleanable/dirt,
/turf/open/floor/whitepurple/northeast,
/area/lv624/lazarus/fitness)
"Hz" = (
/obj/structure/fence,
/turf/open/gm/grass/grass1,
/area/lv624/ground/colony/north_nexus_road)
"HC" = (
/turf/open/floor/warnwhite/southeast,
/area/lv624/lazarus/fitness)
"In" = (
/turf/open/floor,
/area/lv624/lazarus/fitness)
"IA" = (
/turf/open/floor/white,
/area/lv624/lazarus/fitness)
"Ja" = (
/obj/structure/machinery/power/apc/no_power/north,
/turf/open/floor/whitepurplecorner/east,
/area/lv624/lazarus/fitness)
"JV" = (
/obj/structure/closet/boxinggloves,
/obj/effect/landmark/item_pool_spawner/survivor_ammo/buckshot,
/turf/open/floor/whitepurplecorner/east,
/area/lv624/lazarus/fitness)
"LB" = (
/obj/structure/fence,
/turf/open/gm/dirtgrassborder/south,
/area/lv624/ground/colony/south_medbay_road)
"LG" = (
/obj/structure/flora/bush/ausbushes/genericbush,
/turf/open/gm/grass/grass1,
/area/lv624/ground/jungle/east_central_jungle)
"MI" = (
/obj/effect/decal/cleanable/blood/splatter,
/obj/effect/decal/cleanable/dirt,
/obj/effect/decal/cleanable/dirt,
/turf/open/floor/whitepurplecorner/east,
/area/lv624/lazarus/fitness)
"MR" = (
/obj/structure/closet/crate/secure/hydrosec,
/turf/open/floor/whitepurplecorner/east,
/area/lv624/lazarus/fitness)
"Nm" = (
/obj/effect/decal/cleanable/dirt,
/obj/effect/decal/cleanable/dirt,
/turf/open/floor/whitepurplecorner/east,
/area/lv624/lazarus/fitness)
"No" = (
/obj/structure/machinery/vending/snack,
/turf/open/floor/whitepurplecorner/east,
/area/lv624/lazarus/fitness)
"Nt" = (
/turf/open/gm/grass/grass1,
/area/lv624/ground/colony/south_medbay_road)
"NW" = (
/obj/structure/flora/grass/tallgrass/jungle/corner{
	dir = 10
	},
/turf/open/gm/grass/grass1,
/area/lv624/ground/jungle/central_jungle)
"Od" = (
/turf/open/gm/grass/grass1,
/area/lv624/ground/jungle/east_central_jungle)
"Pb" = (
/obj/structure/barricade/handrail,
/obj/effect/decal/cleanable/dirt,
/turf/open/floor,
/area/lv624/lazarus/fitness)
"Ph" = (
/turf/open/gm/dirtgrassborder/grassdirt_corner/south_east,
/area/lv624/ground/colony/north_nexus_road)
"PK" = (
/obj/effect/decal/cleanable/blood/splatter,
/turf/open/floor/whitepurple/northeast,
/area/lv624/lazarus/fitness)
"PQ" = (
/turf/open/floor/warnwhite/northwest,
/area/lv624/lazarus/fitness)
"PS" = (
/obj/effect/decal/remains/human,
/turf/open/floor/whitepurplecorner/east,
/area/lv624/lazarus/fitness)
"Qh" = (
/obj/structure/flora/grass/tallgrass/jungle/corner{
	dir = 5
	},
/turf/open/gm/grass/grass1,
/area/lv624/ground/jungle/central_jungle)
"Qw" = (
/turf/open/gm/dirt,
/area/lv624/ground/colony/north_nexus_road)
"QQ" = (
/obj/effect/decal/cleanable/dirt,
/turf/open/floor/whitepurplecorner/east,
/area/lv624/lazarus/fitness)
"Sx" = (
/obj/structure/machinery/light,
/turf/open/floor/warnwhite,
/area/lv624/lazarus/fitness)
"SA" = (
/obj/structure/closet/athletic_mixed,
/turf/open/floor/whitepurplecorner/east,
/area/lv624/lazarus/fitness)
"SD" = (
/obj/structure/flora/grass/tallgrass/jungle/corner{
	dir = 8
	},
/turf/open/gm/grass/grass1,
/area/lv624/ground/jungle/central_jungle)
"ST" = (
/obj/structure/machinery/conveyor{
	dir = 8;
	id = "lv_gym_1";
	name = "treadmill"
	},
/turf/open/floor/whitepurplecorner/east,
/area/lv624/lazarus/fitness)
"Tw" = (
/obj/structure/surface/rack,
/obj/item/clothing/shoes/black,
/obj/item/clothing/shoes/orange{
	name = "running shoes";
	pixel_x = -5;
	pixel_y = -9
	},
/turf/open/floor/whitepurplecorner/east,
/area/lv624/lazarus/fitness)
"Tz" = (
/obj/structure/machinery/light,
/obj/structure/surface/rack,
/obj/effect/landmark/item_pool_spawner/survivor_ammo/buckshot,
/turf/open/floor/whitepurplecorner/east,
/area/lv624/lazarus/fitness)
"TM" = (
/obj/effect/landmark/crap_item,
/turf/open/floor/whitepurplecorner/east,
/area/lv624/lazarus/fitness)
"Vt" = (
/obj/effect/landmark/survivor_spawner,
/obj/effect/decal/cleanable/dirt,
/turf/open/floor/whitepurplecorner/east,
/area/lv624/lazarus/fitness)
"VN" = (
/obj/item/clothing/suit/redtag,
/turf/open/floor/whitepurplecorner/east,
/area/lv624/lazarus/fitness)
"Wh" = (
/turf/open/gm/dirtgrassborder/grassdirt_corner2/south_west,
/area/lv624/ground/colony/south_medbay_road)
"Wx" = (
/obj/structure/window_frame/colony,
/obj/item/shard,
/turf/open/floor/plating,
/area/lv624/lazarus/fitness)
"Xe" = (
/obj/item/tool/soap,
/turf/open/floor/whitepurplecorner/east,
/area/lv624/lazarus/fitness)
"XY" = (
/obj/structure/closet/lasertag/red,
/turf/open/floor/whitepurplecorner/east,
/area/lv624/lazarus/fitness)
"YC" = (
/obj/effect/decal/cleanable/blood/oil/streak,
/turf/open/floor/whitepurplecorner/east,
/area/lv624/lazarus/fitness)

(1,1,1) = {"
LB
Nt
CO
Nt
Nt
sx
In
pq
sx
DM
NW
vZ
vZ
Qh
nl
"}
(2,1,1) = {"
LB
Nt
Nt
ux
Nt
fV
PK
GO
fV
fV
DM
NW
SD
Aq
DM
"}
(3,1,1) = {"
LB
fV
sx
sx
sx
fV
Ja
kg
du
fV
aG
sx
sx
fV
DM
"}
(4,1,1) = {"
wL
jA
In
In
iN
QQ
kg
TM
Nm
AA
PQ
AM
qV
sx
Bl
"}
(5,1,1) = {"
Wh
sx
In
fv
Pb
kg
PS
kg
kg
AA
hL
IA
jM
BE
DM
"}
(6,1,1) = {"
tY
fV
uF
Ge
uY
Xe
kg
MI
kg
kg
hL
dh
Sx
fV
DM
"}
(7,1,1) = {"
fV
fV
JV
Gq
QQ
kg
kg
kg
QQ
AA
hL
bo
jM
fV
fV
"}
(8,1,1) = {"
sx
kg
kg
kg
kg
QQ
kg
No
kg
AA
Ed
kj
HC
SA
sx
"}
(9,1,1) = {"
Ap
kg
kg
kg
kg
kg
gt
fV
Bj
kg
kg
kg
kg
YC
AC
"}
(10,1,1) = {"
sx
kg
kg
QQ
kg
VN
kg
Gm
kg
kg
QQ
kg
kg
oT
Wx
"}
(11,1,1) = {"
fV
fV
Tw
kg
ry
kg
kg
kg
QQ
QQ
QQ
kg
kg
fV
fV
"}
(12,1,1) = {"
Qw
fV
iG
cK
TM
kg
kg
kg
Gq
BR
EN
dm
Tz
fV
Od
"}
(13,1,1) = {"
lq
aG
ku
nc
nx
kg
kg
kg
QQ
kg
Vt
QQ
MR
sx
Od
"}
(14,1,1) = {"
Ph
sx
ST
oi
wW
kg
kg
kg
kg
XY
hr
pW
bL
sx
Od
"}
(15,1,1) = {"
Hz
fV
Wx
sx
sx
fV
Cw
kg
kg
fV
sx
sx
sx
fV
LG
"}
