//MAP CONVERTED BY dmm2tgm.py THIS HEADER COMMENT PREVENTS RECONVERSION, DO NOT REMOVE
"ah" = (
/obj/structure/machinery/light/double/blue/golden_arrow{
	dir = 8;
	light_power = 0.7
	},
/turf/open/floor/plating/plating_catwalk,
/area/golden_arrow/dorms)
"bE" = (
/turf/closed/wall/almayer,
/area/golden_arrow/cryo_cells)
"cD" = (
/obj/structure/closet/crate/bravo,
/obj/structure/machinery/light/double/blue/golden_arrow{
	dir = 1;
	light_power = 0.7
	},
/turf/open/floor/almayer/cargo,
/area/golden_arrow/shared_office)
"cR" = (
/obj/structure/closet/secure_closet/marine_personal/squad_leader{
	pixel_x = 8
	},
/obj/structure/machinery/light/double/blue/golden_arrow{
	light_power = 0.3
	},
/obj/structure/closet/secure_closet/marine_personal/platoon_commander{
	pixel_x = -7
	},
/obj/structure/machinery/light/double/blue/golden_arrow{
	dir = 8;
	light_power = 0.7
	},
/turf/open/floor/almayer/mono,
/area/golden_arrow/cryo_cells)
"dJ" = (
/turf/open/floor/almayer/blue/southwest,
/area/golden_arrow/platoon_commander_rooms)
"dM" = (
/turf/open/floor/plating/plating_catwalk,
/area/golden_arrow/briefing)
"dP" = (
/obj/structure/machinery/cryopod/big{
	dir = 4;
	layer = 3.1;
	pixel_x = -5
	},
/turf/open/floor/almayer/dark_sterile,
/area/golden_arrow/cryo_cells)
"ea" = (
/obj/structure/machinery/light/double/blue/golden_arrow{
	dir = 1;
	light_power = 0.7
	},
/obj/structure/inventory_machine,
/obj/structure/window/reinforced/ultra{
	dir = 4
	},
/obj/structure/window/reinforced/ultra{
	dir = 8
	},
/turf/open/floor/almayer,
/area/golden_arrow/shared_office)
"fg" = (
/obj/structure/machinery/cm_vending/gear/extraction,
/turf/open/floor/almayer/mono,
/area/golden_arrow/cryo_cells)
"fy" = (
/obj/structure/surface/table/almayer,
/obj/item/toy/deck/uno{
	pixel_x = 5
	},
/obj/item/toy/deck{
	pixel_x = -7;
	pixel_y = 5
	},
/turf/open/floor/almayer/mono,
/area/golden_arrow/dorms)
"gf" = (
/turf/open/floor/almayer/mono,
/area/golden_arrow/dorms)
"gH" = (
/obj/structure/machinery/prop/almayer/CICmap/table/horizontal,
/obj/item/storage/fancy/cigarettes/balaji_4{
	pixel_x = 7;
	pixel_y = 15
	},
/obj/item/storage/fancy/cigar/matchbook/brown{
	pixel_y = 9;
	pixel_x = -1
	},
/turf/open/floor/plating/plating_catwalk,
/area/golden_arrow/briefing)
"hy" = (
/obj/structure/machinery/light/double/blue/golden_arrow{
	dir = 1;
	light_power = 0.7
	},
/turf/open/floor/almayer/sterile_green_side,
/area/golden_arrow/cryo_cells)
"hA" = (
/obj/structure/machinery/light/double/blue/golden_arrow{
	dir = 4;
	light_power = 0.7
	},
/turf/open/floor/plating/plating_catwalk,
/area/golden_arrow/dorms)
"hF" = (
/obj/structure/machinery/light/double/blue/golden_arrow{
	dir = 1;
	light_power = 0.7
	},
/turf/open/floor/almayer,
/area/golden_arrow/platoon_commander_rooms)
"iL" = (
/obj/structure/bed/chair/office/dark,
/turf/open/floor/almayer,
/area/golden_arrow/platoon_commander_rooms)
"iS" = (
/turf/open/floor/almayer/plate,
/area/golden_arrow/cryo_cells)
"iV" = (
/turf/open/floor/almayer/sterile_green_side,
/area/golden_arrow/cryo_cells)
"jp" = (
/obj/structure/surface/table/reinforced/almayer_B,
/obj/structure/machinery/prop/almayer/CICmap{
	pixel_y = 5;
	pixel_x = -1;
	layer = 4
	},
/turf/open/floor/almayer/blue/west,
/area/golden_arrow/platoon_commander_rooms)
"jt" = (
/obj/structure/machinery/door/airlock/multi_tile/almayer/generic{
	name = "\improper Prep";
	dir = 1
	},
/turf/open/floor/almayer,
/area/golden_arrow/cryo_cells)
"kk" = (
/obj/structure/machinery/light/double/blue/golden_arrow{
	light_power = 0.3
	},
/turf/open/floor/almayer,
/area/golden_arrow/shared_office)
"kO" = (
/obj/structure/closet/secure_closet/marine_personal/corpsman{
	pixel_x = -7
	},
/turf/open/floor/almayer/plate,
/area/golden_arrow/cryo_cells)
"lk" = (
/obj/structure/machinery/light/double/blue/golden_arrow{
	dir = 1;
	light_power = 0.7
	},
/obj/structure/inventory_machine,
/obj/structure/window/reinforced/ultra{
	dir = 4
	},
/turf/open/floor/almayer,
/area/golden_arrow/shared_office)
"lQ" = (
/turf/open/floor/plating/plating_catwalk,
/area/golden_arrow/dorms)
"mi" = (
/obj/structure/machinery/light/double/blue/golden_arrow{
	light_power = 0.3
	},
/turf/open/floor/plating/plating_catwalk,
/area/golden_arrow/shared_office)
"mm" = (
/obj/structure/machinery/light/double/blue/golden_arrow{
	dir = 8;
	light_power = 0.7
	},
/obj/structure/flora/pottedplant/random,
/obj/item/clothing/mask/cigarette/weed{
	pixel_x = -10;
	pixel_y = -9
	},
/turf/open/floor/plating/plating_catwalk,
/area/golden_arrow/dorms)
"mn" = (
/obj/effect/landmark/late_join,
/obj/effect/landmark/start/marine/smartgunner/alpha,
/turf/open/floor/almayer/sterile_green,
/area/golden_arrow/cryo_cells)
"mt" = (
/turf/open/floor/almayer,
/area/golden_arrow/briefing)
"nv" = (
/obj/structure/machinery/light/double/blue/golden_arrow{
	dir = 1;
	light_power = 0.7
	},
/obj/structure/machinery/light/double/blue/golden_arrow{
	dir = 4;
	light_power = 0.7
	},
/obj/structure/closet/secure_closet/marine_personal/rifleman{
	pixel_x = 8
	},
/obj/structure/closet/secure_closet/marine_personal/rifleman{
	pixel_x = -7
	},
/turf/open/floor/almayer/mono,
/area/golden_arrow/cryo_cells)
"ny" = (
/turf/open/floor/almayer/cargo_arrow/north,
/area/golden_arrow/shared_office)
"nI" = (
/turf/open/floor/almayer/silverfull,
/area/golden_arrow/cryo_cells)
"od" = (
/obj/structure/machinery/light/double/blue/golden_arrow{
	light_power = 0.3
	},
/turf/open/floor/almayer/sterile_green_side/north,
/area/golden_arrow/cryo_cells)
"of" = (
/obj/structure/surface/table/reinforced/almayer_B,
/obj/item/reagent_container/food/drinks/coffeecup/uscm{
	pixel_y = 13;
	pixel_x = -3
	},
/obj/item/device/flashlight/lamp{
	pixel_x = 4;
	pixel_y = -3
	},
/obj/item/storage/fancy/cigarettes/wypacket_4{
	pixel_x = -7;
	pixel_y = 5
	},
/obj/item/storage/fancy/cigar/matchbook/wy_gold{
	pixel_x = 9;
	pixel_y = 13
	},
/turf/open/floor/almayer,
/area/golden_arrow/platoon_commander_rooms)
"op" = (
/turf/open/floor/plating/plating_catwalk,
/area/golden_arrow/platoon_commander_rooms)
"pa" = (
/obj/structure/surface/table/almayer,
/obj/item/storage/fancy/cigar/matchbook{
	pixel_x = -6;
	pixel_y = 8
	},
/turf/open/floor/almayer/plate,
/area/golden_arrow/dorms)
"pe" = (
/obj/structure/machinery/light/double/blue/golden_arrow{
	dir = 1;
	light_power = 0.7
	},
/obj/structure/mirror{
	pixel_x = 26
	},
/obj/structure/sink{
	dir = 4;
	pixel_x = 12
	},
/obj/item/reagent_container/syringe/drugs{
	pixel_x = 4;
	pixel_y = 15
	},
/turf/open/floor/almayer/silverfull,
/area/golden_arrow/cryo_cells)
"pm" = (
/turf/open/floor/almayer/sterile_green_side/north,
/area/golden_arrow/cryo_cells)
"po" = (
/obj/structure/sign/banners/united_americas_flag{
	pixel_y = 28;
	pixel_x = 15
	},
/turf/open/floor/almayer/plate,
/area/golden_arrow/briefing)
"pL" = (
/obj/structure/phone_base{
	pixel_y = 30;
	pixel_x = 9;
	phone_id = "Overwatch";
	name = "overwatch receiver";
	phone_category = "Overwatch"
	},
/turf/open/floor/almayer/blue/west,
/area/golden_arrow/platoon_commander_rooms)
"pO" = (
/obj/structure/machinery/light/double/blue/golden_arrow{
	light_power = 0.3
	},
/obj/structure/machinery/light/double/blue/golden_arrow{
	dir = 4;
	light_power = 0.7
	},
/obj/structure/closet/secure_closet/marine_personal/rifleman{
	pixel_x = -7
	},
/obj/structure/closet/secure_closet/marine_personal/rifleman{
	pixel_x = 8
	},
/turf/open/floor/almayer/mono,
/area/golden_arrow/cryo_cells)
"qo" = (
/turf/closed/wall/almayer/outer,
/area/golden_arrow/cryo_cells)
"qX" = (
/obj/structure/machinery/cm_vending/sorted/marine_food,
/turf/open/floor/almayer/plate,
/area/golden_arrow/dorms)
"rf" = (
/obj/effect/landmark/late_join,
/obj/effect/landmark/start/marine/alpha,
/turf/open/floor/almayer/sterile_green,
/area/golden_arrow/cryo_cells)
"rl" = (
/turf/open/floor/plating/plating_catwalk,
/area/golden_arrow/shared_office)
"rZ" = (
/obj/structure/machinery/light/double/blue/golden_arrow{
	dir = 1;
	light_power = 0.7
	},
/turf/open/floor/almayer/plate,
/area/golden_arrow/briefing)
"sf" = (
/obj/structure/machinery/door/airlock/almayer/engineering/glass{
	dir = 2;
	name = "\improper Requisitions"
	},
/turf/open/floor/almayer,
/area/golden_arrow/shared_office)
"tC" = (
/turf/open/floor/plating/plating_catwalk,
/area/golden_arrow/cryo_cells)
"tZ" = (
/obj/structure/sign/poster/pinup,
/turf/closed/wall/almayer,
/area/golden_arrow/briefing)
"uN" = (
/obj/structure/mirror{
	pixel_x = 26
	},
/obj/structure/sink{
	dir = 4;
	pixel_x = 12
	},
/turf/open/floor/almayer/silverfull,
/area/golden_arrow/cryo_cells)
"vg" = (
/obj/structure/bed/chair/comfy{
	dir = 1
	},
/turf/open/floor/almayer/plate,
/area/golden_arrow/dorms)
"vF" = (
/obj/effect/landmark/late_join,
/obj/effect/landmark/start/marine/leader/alpha,
/turf/open/floor/almayer/sterile_green_side/northeast,
/area/golden_arrow/cryo_cells)
"xv" = (
/obj/structure/bed/chair/comfy,
/turf/open/floor/almayer/mono,
/area/golden_arrow/dorms)
"xE" = (
/obj/structure/toilet{
	dir = 1
	},
/obj/structure/curtain/open/shower,
/obj/structure/window/reinforced/ultra{
	dir = 4
	},
/obj/structure/machinery/door/window/northleft,
/obj/structure/machinery/light/double/blue/golden_arrow,
/turf/open/floor/almayer/silverfull,
/area/golden_arrow/cryo_cells)
"xI" = (
/obj/structure/machinery/light/double/blue/golden_arrow{
	dir = 1;
	light_power = 0.7
	},
/obj/structure/closet/secure_closet/marine_personal/engineer{
	pixel_x = 8
	},
/obj/structure/closet/secure_closet/marine_personal/engineer{
	pixel_x = -7
	},
/obj/structure/machinery/light/double/blue/golden_arrow{
	dir = 8;
	light_power = 0.7
	},
/turf/open/floor/almayer/mono,
/area/golden_arrow/cryo_cells)
"xM" = (
/obj/structure/machinery/door/airlock/multi_tile/almayer/generic{
	name = "\improper Storage";
	dir = 1
	},
/turf/open/floor/almayer,
/area/golden_arrow/cryo_cells)
"yC" = (
/obj/structure/machinery/light/double/blue/golden_arrow{
	light_power = 0.3
	},
/obj/structure/flora/pottedplant/random,
/obj/item/explosive/grenade/high_explosive/training{
	pixel_x = 15;
	pixel_y = -10
	},
/turf/open/floor/almayer/mono,
/area/golden_arrow/briefing)
"yT" = (
/obj/structure/surface/table/reinforced/almayer_B,
/obj/structure/machinery/computer/overwatch/almayer,
/turf/open/floor/almayer,
/area/golden_arrow/platoon_commander_rooms)
"zo" = (
/obj/structure/inventory_machine,
/obj/structure/window/reinforced/ultra{
	dir = 4
	},
/turf/open/floor/almayer,
/area/golden_arrow/shared_office)
"Ae" = (
/turf/open/floor/almayer,
/area/golden_arrow/shared_office)
"Ap" = (
/obj/structure/machinery/shower{
	pixel_y = 15
	},
/obj/structure/curtain/open/shower,
/obj/structure/window/reinforced/ultra{
	dir = 4
	},
/obj/structure/machinery/door/window/southleft,
/obj/structure/machinery/light/double/blue/golden_arrow{
	dir = 1;
	light_power = 0.7
	},
/turf/open/floor/almayer/silverfull,
/area/golden_arrow/cryo_cells)
"BC" = (
/obj/structure/machinery/door/airlock/almayer/generic/glass{
	name = "\improper Briefing"
	},
/turf/open/floor/almayer,
/area/golden_arrow/briefing)
"Cg" = (
/obj/structure/machinery/light/double/blue/golden_arrow{
	light_power = 0.3
	},
/obj/structure/bed/chair/comfy{
	dir = 1
	},
/turf/open/floor/almayer/plate,
/area/golden_arrow/dorms)
"CE" = (
/turf/closed/wall/almayer/outer,
/area/golden_arrow/briefing)
"CL" = (
/turf/closed/wall/almayer/outer,
/area/golden_arrow/shared_office)
"CM" = (
/turf/closed/wall/almayer/outer,
/area/golden_arrow/dorms)
"Da" = (
/obj/structure/machinery/door/airlock/almayer/generic/glass{
	dir = 2;
	name = "\improper Stash Access"
	},
/turf/open/floor/almayer,
/area/golden_arrow/shared_office)
"Df" = (
/obj/structure/window/reinforced/ultra{
	dir = 4
	},
/obj/structure/machinery/door/window/southleft,
/turf/open/floor/almayer/cargo,
/area/golden_arrow/shared_office)
"DN" = (
/turf/open/floor/almayer/plate,
/area/golden_arrow/briefing)
"DY" = (
/obj/structure/window/framed/almayer,
/turf/open/floor/almayer,
/area/golden_arrow/briefing)
"El" = (
/obj/structure/closet/crate/alpha,
/obj/structure/sign/banners/usa_worn{
	pixel_x = -16;
	pixel_y = 27
	},
/turf/open/floor/almayer/cargo,
/area/golden_arrow/shared_office)
"Es" = (
/obj/item/tool/soap,
/obj/structure/closet{
	name = "cleaning supplies";
	pixel_x = -7
	},
/obj/item/tool/mop,
/obj/item/reagent_container/glass/bucket,
/obj/item/reagent_container/spray/cleaner,
/obj/item/tool/soap,
/turf/open/floor/almayer/silverfull,
/area/golden_arrow/cryo_cells)
"EC" = (
/obj/structure/machinery/light/double/blue/golden_arrow{
	light_power = 0.3
	},
/obj/structure/flora/pottedplant/random,
/turf/open/floor/almayer/mono,
/area/golden_arrow/briefing)
"EE" = (
/obj/structure/toilet{
	dir = 1
	},
/obj/structure/machinery/door/window/northleft,
/obj/structure/window/reinforced/ultra{
	dir = 4
	},
/obj/structure/curtain/open/shower,
/obj/item/reagent_container/pill/happy,
/turf/open/floor/almayer/silverfull,
/area/golden_arrow/cryo_cells)
"ET" = (
/obj/structure/closet/secure_closet/marine_personal/rifleman{
	pixel_x = -7
	},
/obj/structure/closet/secure_closet/marine_personal/rifleman{
	pixel_x = 8
	},
/turf/open/floor/almayer/plate,
/area/golden_arrow/cryo_cells)
"Fr" = (
/obj/structure/surface/table/almayer,
/obj/item/mre_food_packet/wy/cookie_brick,
/obj/item/mre_food_packet/wy/cookie_brick{
	pixel_x = 9;
	pixel_y = 4
	},
/obj/item/mre_food_packet/wy/cookie_brick{
	pixel_x = -8;
	pixel_y = 7
	},
/turf/open/floor/almayer/plate,
/area/golden_arrow/dorms)
"FJ" = (
/obj/structure/machinery/cryopod/big{
	dir = 4;
	layer = 3.1;
	pixel_x = -5
	},
/turf/open/floor/almayer/sterile_green,
/area/golden_arrow/cryo_cells)
"FQ" = (
/obj/structure/sign/poster/clf,
/turf/closed/wall/almayer,
/area/golden_arrow/cryo_cells)
"FT" = (
/obj/item/prop/tableflag{
	pixel_x = 6;
	pixel_y = 15
	},
/turf/open/floor/plating/plating_catwalk,
/area/golden_arrow/briefing)
"GG" = (
/turf/open/floor/almayer/mono,
/area/golden_arrow/cryo_cells)
"Hz" = (
/obj/structure/surface/table/almayer,
/obj/structure/machinery/door/window/southleft,
/turf/open/floor/almayer,
/area/golden_arrow/shared_office)
"HA" = (
/turf/open/floor/almayer/blue,
/area/golden_arrow/platoon_commander_rooms)
"HB" = (
/mob/living/simple_animal/cat{
	name = "Kiki";
	desc = "The Hideout's pet cat. It was found on Fiorina in the prison district by a rifleman and sold to Lieutenant Michael Brown; instead of turning the cat into a meal, he adopted her."
	},
/turf/open/floor/almayer/mono,
/area/golden_arrow/dorms)
"HI" = (
/obj/structure/closet/secure_closet/marine_personal/rifleman{
	pixel_x = 8
	},
/obj/structure/closet/secure_closet/marine_personal/rifleman{
	pixel_x = -7
	},
/turf/open/floor/almayer/plate,
/area/golden_arrow/cryo_cells)
"Iq" = (
/obj/structure/machinery/light/double/blue/golden_arrow{
	dir = 8;
	light_power = 0.7
	},
/turf/open/floor/almayer/plate,
/area/golden_arrow/briefing)
"Jb" = (
/turf/open/space/basic,
/area/space)
"Jh" = (
/turf/open/floor/almayer/plate,
/area/golden_arrow/dorms)
"JL" = (
/obj/structure/machinery/cryopod/big{
	dir = 4;
	layer = 3.1;
	pixel_x = -5
	},
/obj/structure/machinery/light/double/blue/golden_arrow{
	dir = 8;
	light_power = 0.7
	},
/turf/open/floor/almayer/dark_sterile,
/area/golden_arrow/cryo_cells)
"Kw" = (
/obj/structure/sign/poster/hunk,
/turf/closed/wall/almayer,
/area/golden_arrow/cryo_cells)
"Kz" = (
/obj/structure/machinery/light/double/blue/golden_arrow{
	dir = 1;
	light_power = 0.7
	},
/turf/open/floor/plating/plating_catwalk,
/area/golden_arrow/platoon_commander_rooms)
"Lp" = (
/obj/structure/machinery/light/double/blue/golden_arrow,
/obj/structure/mirror{
	pixel_x = 26
	},
/obj/structure/sink{
	dir = 4;
	pixel_x = 12
	},
/turf/open/floor/almayer/silverfull,
/area/golden_arrow/cryo_cells)
"LO" = (
/obj/structure/sign/poster/ad,
/turf/closed/wall/almayer,
/area/golden_arrow/shared_office)
"LU" = (
/obj/effect/landmark/late_join,
/obj/effect/landmark/start/bridge,
/turf/open/floor/almayer/sterile_green_side/east,
/area/golden_arrow/cryo_cells)
"LW" = (
/obj/structure/closet/secure_closet/marine_personal/platoon_leader{
	pixel_x = -7
	},
/obj/structure/closet/secure_closet/marine_personal/rifleman{
	pixel_x = 8
	},
/turf/open/floor/almayer/mono,
/area/golden_arrow/cryo_cells)
"Mi" = (
/obj/structure/surface/table/almayer,
/obj/item/storage/fancy/cigarettes/lucky_strikes_4{
	pixel_x = -5;
	pixel_y = 5
	},
/obj/item/storage/fancy/cigarettes/lucky_strikes_4,
/turf/open/floor/almayer/mono,
/area/golden_arrow/dorms)
"Mv" = (
/obj/structure/machinery/shower{
	pixel_y = 15
	},
/obj/structure/curtain/open/shower,
/obj/structure/window/reinforced/ultra{
	dir = 4
	},
/obj/structure/machinery/door/window/southleft,
/turf/open/floor/almayer/silverfull,
/area/golden_arrow/cryo_cells)
"MW" = (
/obj/structure/closet{
	pixel_x = -7;
	name = "spare uniforms"
	},
/obj/item/clothing/under/marine,
/obj/item/clothing/under/marine,
/obj/item/clothing/under/marine,
/obj/item/clothing/under/marine,
/obj/item/clothing/under/marine,
/obj/item/device/radio/headset/almayer/marine/solardevils,
/obj/item/device/radio/headset/almayer/marine/solardevils,
/obj/item/clothing/shoes/marine,
/obj/item/clothing/shoes/marine,
/obj/item/clothing/shoes/marine,
/obj/item/device/radio/headset/almayer/marine/solardevils,
/obj/item/device/radio/headset/almayer/marine/solardevils,
/obj/item/device/radio/headset/almayer/marine/solardevils,
/obj/item/clothing/shoes/marine,
/obj/item/clothing/shoes/marine,
/turf/open/floor/almayer/plate,
/area/golden_arrow/cryo_cells)
"NK" = (
/obj/structure/machinery/chem_dispenser/canteen,
/obj/structure/machinery/light/double/blue/golden_arrow{
	dir = 4;
	light_power = 0.7
	},
/obj/structure/machinery/light/double/blue/golden_arrow{
	dir = 1;
	light_power = 0.7
	},
/turf/open/floor/almayer,
/area/golden_arrow/dorms)
"Oz" = (
/turf/open/floor/almayer,
/area/golden_arrow/cryo_cells)
"OY" = (
/obj/effect/decal/warning_stripes{
	icon_state = "cargo"
	},
/obj/structure/bed/chair,
/turf/open/floor/almayer/mono,
/area/golden_arrow/briefing)
"Pu" = (
/obj/structure/window/framed/almayer,
/turf/open/floor/almayer,
/area/golden_arrow/shared_office)
"Qb" = (
/obj/structure/machinery/light/double/blue/golden_arrow{
	dir = 1;
	light_power = 0.7
	},
/obj/structure/closet/crate/charlie,
/turf/open/floor/almayer/cargo,
/area/golden_arrow/shared_office)
"QF" = (
/obj/structure/surface/table/almayer,
/turf/open/floor/almayer/plate,
/area/golden_arrow/dorms)
"Rv" = (
/turf/open/floor/almayer/mono,
/area/golden_arrow/briefing)
"RA" = (
/obj/effect/landmark/late_join,
/obj/effect/landmark/start/marine/medic/alpha,
/turf/open/floor/almayer/sterile_green_side/east,
/area/golden_arrow/cryo_cells)
"SC" = (
/obj/structure/surface/table/almayer,
/obj/item/storage/fancy/cigarettes/lucky_strikes_4{
	pixel_x = -6;
	pixel_y = 7
	},
/obj/item/storage/fancy/cigar/matchbook{
	pixel_x = 7;
	pixel_y = -2
	},
/turf/open/floor/almayer/mono,
/area/golden_arrow/dorms)
"Td" = (
/turf/closed/wall/almayer/outer,
/area/golden_arrow/platoon_commander_rooms)
"TK" = (
/obj/structure/window/framed/almayer,
/turf/open/floor/almayer,
/area/golden_arrow/cryo_cells)
"Um" = (
/obj/effect/landmark/late_join,
/obj/effect/landmark/start/marine/alpha,
/obj/structure/machinery/light/double/blue/golden_arrow{
	dir = 4;
	light_power = 0.7
	},
/turf/open/floor/almayer/sterile_green,
/area/golden_arrow/cryo_cells)
"Up" = (
/obj/structure/surface/table/almayer,
/obj/item/reagent_container/food/drinks/cans/beer{
	pixel_x = -9;
	pixel_y = 12
	},
/turf/open/floor/almayer/plate,
/area/golden_arrow/dorms)
"Us" = (
/obj/effect/landmark/late_join,
/obj/effect/landmark/start/marine/tl/alpha,
/turf/open/floor/almayer/sterile_green,
/area/golden_arrow/cryo_cells)
"Uu" = (
/obj/structure/machinery/door/airlock/multi_tile/almayer/comdoor{
	name = "\improper Overwatch"
	},
/turf/open/floor/almayer,
/area/golden_arrow/briefing)
"UR" = (
/obj/structure/surface/table/almayer,
/turf/open/floor/almayer/mono,
/area/golden_arrow/dorms)
"UT" = (
/turf/closed/wall/almayer,
/area/golden_arrow/shared_office)
"Vf" = (
/obj/effect/landmark/late_join,
/obj/effect/landmark/start/marine/leader/alpha,
/turf/open/floor/almayer/sterile_green_side/southeast,
/area/golden_arrow/cryo_cells)
"Vo" = (
/turf/closed/wall/almayer,
/area/golden_arrow/briefing)
"WE" = (
/obj/structure/bed/chair/comfy,
/turf/open/floor/almayer,
/area/golden_arrow/shared_office)
"Xj" = (
/obj/structure/machinery/light/double/blue/golden_arrow{
	dir = 4;
	light_power = 0.7
	},
/turf/open/floor/almayer/plate,
/area/golden_arrow/briefing)
"Yj" = (
/obj/structure/machinery/door/airlock/almayer/generic{
	name = "Bathroom";
	dir = 2
	},
/turf/open/floor/almayer/plate,
/area/golden_arrow/cryo_cells)
"ZG" = (
/obj/structure/window/reinforced/ultra{
	dir = 4
	},
/obj/structure/window/reinforced/ultra{
	dir = 8
	},
/obj/structure/machinery/door/window/southleft,
/turf/open/floor/almayer/cargo,
/area/golden_arrow/shared_office)
"ZO" = (
/obj/structure/machinery/light/double/blue/golden_arrow{
	dir = 4;
	light_power = 0.7
	},
/turf/open/floor/plating/plating_catwalk,
/area/golden_arrow/briefing)

(1,1,1) = {"
Jb
Jb
Jb
Jb
Jb
Jb
Jb
Jb
Jb
Jb
Jb
Jb
Jb
Jb
Jb
Jb
Jb
Jb
Jb
Jb
Jb
Jb
Jb
Jb
Jb
Jb
Jb
Jb
Jb
Jb
Jb
Jb
Jb
Jb
Jb
Jb
Jb
Jb
Jb
Jb
qo
qo
qo
qo
qo
qo
qo
qo
qo
qo
"}
(2,1,1) = {"
Jb
Jb
Jb
Jb
Jb
Jb
Jb
Jb
Jb
Jb
Jb
Jb
Jb
Jb
Jb
Jb
Jb
Jb
Jb
Jb
Jb
Jb
Jb
Jb
Jb
Jb
Jb
Jb
Jb
Jb
Jb
Jb
Jb
Jb
Jb
Jb
Jb
Jb
Jb
Jb
qo
dP
JL
dP
dP
dP
dP
JL
dP
qo
"}
(3,1,1) = {"
Jb
Jb
Jb
Jb
Jb
Jb
Jb
Jb
Jb
Jb
Jb
Jb
Jb
Jb
Jb
Jb
Jb
Jb
Jb
Jb
Jb
Jb
Jb
Jb
Jb
Jb
Jb
Jb
Jb
Jb
Jb
Jb
Jb
Jb
Jb
Jb
Jb
Jb
Jb
Jb
qo
Vf
RA
LU
vF
Vf
RA
LU
vF
qo
"}
(4,1,1) = {"
Jb
Jb
Jb
Jb
Jb
Jb
Jb
Jb
Jb
Jb
Jb
Jb
Jb
Jb
Jb
Jb
Jb
Jb
Jb
Jb
Jb
Jb
Jb
Jb
Jb
Jb
Jb
Jb
Jb
Jb
Jb
Jb
Jb
Jb
Jb
Jb
Jb
Jb
Jb
Jb
qo
iV
FJ
FJ
pm
iV
FJ
FJ
pm
qo
"}
(5,1,1) = {"
Jb
Jb
Jb
Jb
Jb
Jb
Jb
Jb
Jb
Jb
Jb
Jb
Jb
Jb
Jb
Jb
Jb
Jb
Jb
Jb
Jb
Jb
Jb
Jb
Jb
Jb
Jb
Jb
Jb
Jb
Jb
Jb
Jb
Jb
Jb
Jb
Jb
Jb
Jb
Jb
qo
hy
Us
mn
pm
iV
rf
Us
od
qo
"}
(6,1,1) = {"
Jb
Jb
Jb
Jb
Jb
Jb
Jb
Jb
Jb
Jb
Jb
Jb
Jb
Jb
Jb
Jb
Jb
Jb
Jb
Jb
Jb
Jb
Jb
Jb
Jb
Jb
Jb
Jb
Jb
Jb
Jb
Jb
Jb
Jb
Jb
Jb
Jb
Jb
Jb
Jb
qo
iV
FJ
FJ
pm
iV
FJ
FJ
pm
qo
"}
(7,1,1) = {"
Jb
Jb
Jb
Jb
Jb
Jb
Jb
Jb
Jb
Jb
Jb
Jb
Jb
Jb
Jb
Jb
Jb
Jb
Jb
Jb
Jb
Jb
Jb
Jb
Jb
Jb
Jb
Jb
Jb
Jb
Jb
Jb
Jb
Jb
Jb
Jb
Jb
Jb
Jb
Jb
qo
iV
mn
Um
pm
iV
rf
Um
pm
qo
"}
(8,1,1) = {"
Jb
Jb
Jb
Jb
Jb
Jb
Jb
Jb
Jb
Jb
Jb
Jb
Jb
Jb
Jb
Jb
Jb
Jb
Jb
Jb
Jb
Jb
Jb
Jb
Jb
Jb
Jb
Jb
Jb
Jb
Jb
Jb
Jb
Jb
Jb
Jb
qo
qo
qo
qo
qo
bE
TK
TK
Oz
xM
TK
TK
FQ
qo
"}
(9,1,1) = {"
Jb
Jb
Jb
Jb
Jb
Jb
Jb
Jb
Jb
Jb
Jb
Jb
Jb
Jb
Jb
Jb
Jb
Jb
Jb
Jb
Jb
Jb
Jb
Jb
Jb
Jb
Jb
Jb
Jb
Jb
Jb
Jb
Jb
Jb
Jb
Jb
qo
Ap
nI
xE
bE
xI
kO
fg
iS
GG
fg
MW
cR
qo
"}
(10,1,1) = {"
Jb
Jb
Jb
Jb
Jb
Jb
Jb
Jb
Jb
Jb
Jb
Jb
Jb
Jb
Jb
Jb
Jb
Jb
Jb
Jb
Jb
Jb
Jb
Jb
Jb
Jb
Jb
Jb
Jb
Jb
Jb
Jb
Jb
Jb
Jb
Jb
qo
Mv
nI
EE
bE
HI
GG
fg
GG
iS
fg
GG
ET
qo
"}
(11,1,1) = {"
Jb
Jb
Jb
Jb
Jb
Jb
Jb
Jb
Jb
Jb
Jb
Jb
Jb
Jb
Jb
Jb
Jb
Jb
Jb
Jb
Jb
Jb
Jb
Jb
Jb
Jb
Jb
Jb
Jb
Jb
Jb
Jb
Jb
Jb
Jb
Jb
qo
Es
nI
nI
Yj
GG
tC
fg
iS
GG
fg
tC
LW
qo
"}
(12,1,1) = {"
Jb
Jb
Jb
Jb
Jb
Jb
Jb
Jb
Jb
Jb
Jb
Jb
Jb
Jb
Jb
Jb
Jb
Jb
Jb
Jb
Jb
Jb
Jb
Jb
Jb
Jb
Jb
Jb
Jb
Jb
Jb
Jb
Jb
Jb
Jb
Jb
qo
pe
uN
Lp
bE
nv
tC
tC
tC
tC
tC
tC
pO
qo
"}
(13,1,1) = {"
Jb
Jb
Jb
Jb
Jb
Jb
Jb
Jb
Jb
Jb
Jb
Jb
Jb
Jb
Jb
Jb
Jb
Jb
Jb
Jb
Jb
Jb
Jb
Jb
Jb
Jb
Jb
Jb
Jb
Jb
Jb
Jb
Jb
Jb
Jb
Jb
CL
UT
UT
UT
bE
Kw
TK
TK
Oz
jt
TK
TK
bE
qo
"}
(14,1,1) = {"
Jb
Jb
Jb
Jb
Jb
Jb
Jb
Jb
Jb
Jb
Jb
Jb
Jb
Jb
Jb
Jb
Jb
Jb
Jb
Jb
Jb
Jb
Jb
Jb
Jb
Jb
Jb
Jb
Jb
Jb
Jb
Jb
Jb
Jb
Jb
Jb
CL
Qb
rl
mi
Pu
mm
lQ
lQ
lQ
lQ
lQ
lQ
ah
CM
"}
(15,1,1) = {"
Jb
Jb
Jb
Jb
Jb
Jb
Jb
Jb
Jb
Jb
Jb
Jb
Jb
Jb
Jb
Jb
Jb
Jb
Jb
Jb
Jb
Jb
Jb
Jb
Jb
Jb
Jb
Jb
Jb
Jb
Jb
Jb
Jb
Jb
Jb
Jb
CL
El
Ae
WE
Hz
Jh
gf
xv
pa
vg
xv
Mi
Cg
CM
"}
(16,1,1) = {"
Jb
Jb
Jb
Jb
Jb
Jb
Jb
Jb
Jb
Jb
Jb
Jb
Jb
Jb
Jb
Jb
Jb
Jb
Jb
Jb
Jb
Jb
Jb
Jb
Jb
Jb
Jb
Jb
Jb
Jb
Jb
Jb
Jb
Jb
Jb
Jb
CL
cD
Ae
ny
sf
Jh
gf
xv
QF
vg
xv
SC
vg
CM
"}
(17,1,1) = {"
Jb
Jb
Jb
Jb
Jb
Jb
Jb
Jb
Jb
Jb
Jb
Jb
Jb
Jb
Jb
Jb
Jb
Jb
Jb
Jb
Jb
Jb
Jb
Jb
Jb
Jb
Jb
Jb
Jb
Jb
Jb
Jb
Jb
Jb
Jb
Jb
CL
Pu
Pu
Pu
LO
Jh
HB
xv
Up
vg
xv
UR
vg
CM
"}
(18,1,1) = {"
Jb
Jb
Jb
Jb
Jb
Jb
Jb
Jb
Jb
Jb
Jb
Jb
Jb
Jb
Jb
Jb
Jb
Jb
Jb
Jb
Jb
Jb
Jb
Jb
Jb
Jb
Jb
Jb
Jb
Jb
Jb
Jb
Jb
Jb
Jb
Jb
CL
ea
ZG
Ae
Da
Jh
gf
xv
QF
vg
xv
fy
vg
CM
"}
(19,1,1) = {"
Jb
Jb
Jb
Jb
Jb
Jb
Jb
Jb
Jb
Jb
Jb
Jb
Jb
Jb
Jb
Jb
Jb
Jb
Jb
Jb
Jb
Jb
Jb
Jb
Jb
Jb
Jb
Jb
Jb
Jb
Jb
Jb
Jb
Jb
Jb
Jb
CL
zo
Df
Ae
UT
qX
gf
xv
Fr
vg
xv
UR
Cg
CM
"}
(20,1,1) = {"
Jb
Jb
Jb
Jb
Jb
Jb
Jb
Jb
Jb
Jb
Jb
Jb
Jb
Jb
Jb
Jb
Jb
Jb
Jb
Jb
Jb
Jb
Jb
Jb
Jb
Jb
Jb
Jb
Jb
Jb
Jb
Jb
Jb
Jb
Jb
Jb
CL
lk
Df
kk
UT
NK
lQ
lQ
lQ
lQ
lQ
lQ
hA
CM
"}
(21,1,1) = {"
Jb
Jb
Jb
Jb
Jb
Jb
Jb
Jb
Jb
Jb
Jb
Jb
Jb
Jb
Jb
Jb
Jb
Jb
Jb
Jb
Jb
Jb
Jb
Jb
Jb
Jb
Jb
Jb
Jb
Jb
Jb
Jb
Jb
Jb
Jb
Jb
CL
Pu
Pu
Pu
Vo
Vo
BC
Vo
DY
DY
DY
DY
tZ
CE
"}
(22,1,1) = {"
Jb
Jb
Jb
Jb
Jb
Jb
Jb
Jb
Jb
Jb
Jb
Jb
Jb
Jb
Jb
Jb
Jb
Jb
Jb
Jb
Jb
Jb
Jb
Jb
Jb
Jb
Jb
Jb
Jb
Jb
Jb
Jb
Jb
Jb
Jb
Jb
Td
Kz
op
op
DY
rZ
DN
Iq
DN
DN
dM
dM
EC
CE
"}
(23,1,1) = {"
Jb
Jb
Jb
Jb
Jb
Jb
Jb
Jb
Jb
Jb
Jb
Jb
Jb
Jb
Jb
Jb
Jb
Jb
Jb
Jb
Jb
Jb
Jb
Jb
Jb
Jb
Jb
Jb
Jb
Jb
Jb
Jb
Jb
Jb
Jb
Jb
Td
pL
jp
dJ
Uu
DN
OY
OY
OY
DN
dM
dM
Rv
CE
"}
(24,1,1) = {"
Jb
Jb
Jb
Jb
Jb
Jb
Jb
Jb
Jb
Jb
Jb
Jb
Jb
Jb
Jb
Jb
Jb
Jb
Jb
Jb
Jb
Jb
Jb
Jb
Jb
Jb
Jb
Jb
Jb
Jb
Jb
Jb
Jb
Jb
Jb
Jb
Td
iL
of
HA
mt
DN
OY
OY
OY
DN
dM
gH
Rv
CE
"}
(25,1,1) = {"
Jb
Jb
Jb
Jb
Jb
Jb
Jb
Jb
Jb
Jb
Jb
Jb
Jb
Jb
Jb
Jb
Jb
Jb
Jb
Jb
Jb
Jb
Jb
Jb
Jb
Jb
Jb
Jb
Jb
Jb
Jb
Jb
Jb
Jb
Jb
Jb
Td
hF
yT
HA
Vo
po
DN
DN
DN
DN
FT
dM
Rv
CE
"}
(26,1,1) = {"
Jb
Jb
Jb
Jb
Jb
Jb
Jb
Jb
Jb
Jb
Jb
Jb
Jb
Jb
Jb
Jb
Jb
Jb
Jb
Jb
Jb
Jb
Jb
Jb
Jb
Jb
Jb
Jb
Jb
Jb
Jb
Jb
Jb
Jb
Jb
Jb
Td
Td
Td
Td
CE
DN
OY
OY
OY
DN
dM
dM
Rv
CE
"}
(27,1,1) = {"
Jb
Jb
Jb
Jb
Jb
Jb
Jb
Jb
Jb
Jb
Jb
Jb
Jb
Jb
Jb
Jb
Jb
Jb
Jb
Jb
Jb
Jb
Jb
Jb
Jb
Jb
Jb
Jb
Jb
Jb
Jb
Jb
Jb
Jb
Jb
Jb
Jb
Jb
Jb
Jb
CE
DN
OY
OY
OY
DN
dM
dM
Rv
CE
"}
(28,1,1) = {"
Jb
Jb
Jb
Jb
Jb
Jb
Jb
Jb
Jb
Jb
Jb
Jb
Jb
Jb
Jb
Jb
Jb
Jb
Jb
Jb
Jb
Jb
Jb
Jb
Jb
Jb
Jb
Jb
Jb
Jb
Jb
Jb
Jb
Jb
Jb
Jb
Jb
Jb
Jb
Jb
CE
rZ
Xj
DN
DN
DN
dM
ZO
yC
CE
"}
(29,1,1) = {"
Jb
Jb
Jb
Jb
Jb
Jb
Jb
Jb
Jb
Jb
Jb
Jb
Jb
Jb
Jb
Jb
Jb
Jb
Jb
Jb
Jb
Jb
Jb
Jb
Jb
Jb
Jb
Jb
Jb
Jb
Jb
Jb
Jb
Jb
Jb
Jb
Jb
Jb
Jb
Jb
CE
CE
CE
CE
CE
CE
CE
CE
CE
CE
"}
(30,1,1) = {"
Jb
Jb
Jb
Jb
Jb
Jb
Jb
Jb
Jb
Jb
Jb
Jb
Jb
Jb
Jb
Jb
Jb
Jb
Jb
Jb
Jb
Jb
Jb
Jb
Jb
Jb
Jb
Jb
Jb
Jb
Jb
Jb
Jb
Jb
Jb
Jb
Jb
Jb
Jb
Jb
Jb
Jb
Jb
Jb
Jb
Jb
Jb
Jb
Jb
Jb
"}
(31,1,1) = {"
Jb
Jb
Jb
Jb
Jb
Jb
Jb
Jb
Jb
Jb
Jb
Jb
Jb
Jb
Jb
Jb
Jb
Jb
Jb
Jb
Jb
Jb
Jb
Jb
Jb
Jb
Jb
Jb
Jb
Jb
Jb
Jb
Jb
Jb
Jb
Jb
Jb
Jb
Jb
Jb
Jb
Jb
Jb
Jb
Jb
Jb
Jb
Jb
Jb
Jb
"}
(32,1,1) = {"
Jb
Jb
Jb
Jb
Jb
Jb
Jb
Jb
Jb
Jb
Jb
Jb
Jb
Jb
Jb
Jb
Jb
Jb
Jb
Jb
Jb
Jb
Jb
Jb
Jb
Jb
Jb
Jb
Jb
Jb
Jb
Jb
Jb
Jb
Jb
Jb
Jb
Jb
Jb
Jb
Jb
Jb
Jb
Jb
Jb
Jb
Jb
Jb
Jb
Jb
"}
(33,1,1) = {"
Jb
Jb
Jb
Jb
Jb
Jb
Jb
Jb
Jb
Jb
Jb
Jb
Jb
Jb
Jb
Jb
Jb
Jb
Jb
Jb
Jb
Jb
Jb
Jb
Jb
Jb
Jb
Jb
Jb
Jb
Jb
Jb
Jb
Jb
Jb
Jb
Jb
Jb
Jb
Jb
Jb
Jb
Jb
Jb
Jb
Jb
Jb
Jb
Jb
Jb
"}
(34,1,1) = {"
Jb
Jb
Jb
Jb
Jb
Jb
Jb
Jb
Jb
Jb
Jb
Jb
Jb
Jb
Jb
Jb
Jb
Jb
Jb
Jb
Jb
Jb
Jb
Jb
Jb
Jb
Jb
Jb
Jb
Jb
Jb
Jb
Jb
Jb
Jb
Jb
Jb
Jb
Jb
Jb
Jb
Jb
Jb
Jb
Jb
Jb
Jb
Jb
Jb
Jb
"}
(35,1,1) = {"
Jb
Jb
Jb
Jb
Jb
Jb
Jb
Jb
Jb
Jb
Jb
Jb
Jb
Jb
Jb
Jb
Jb
Jb
Jb
Jb
Jb
Jb
Jb
Jb
Jb
Jb
Jb
Jb
Jb
Jb
Jb
Jb
Jb
Jb
Jb
Jb
Jb
Jb
Jb
Jb
Jb
Jb
Jb
Jb
Jb
Jb
Jb
Jb
Jb
Jb
"}
(36,1,1) = {"
Jb
Jb
Jb
Jb
Jb
Jb
Jb
Jb
Jb
Jb
Jb
Jb
Jb
Jb
Jb
Jb
Jb
Jb
Jb
Jb
Jb
Jb
Jb
Jb
Jb
Jb
Jb
Jb
Jb
Jb
Jb
Jb
Jb
Jb
Jb
Jb
Jb
Jb
Jb
Jb
Jb
Jb
Jb
Jb
Jb
Jb
Jb
Jb
Jb
Jb
"}
(37,1,1) = {"
Jb
Jb
Jb
Jb
Jb
Jb
Jb
Jb
Jb
Jb
Jb
Jb
Jb
Jb
Jb
Jb
Jb
Jb
Jb
Jb
Jb
Jb
Jb
Jb
Jb
Jb
Jb
Jb
Jb
Jb
Jb
Jb
Jb
Jb
Jb
Jb
Jb
Jb
Jb
Jb
Jb
Jb
Jb
Jb
Jb
Jb
Jb
Jb
Jb
Jb
"}
(38,1,1) = {"
Jb
Jb
Jb
Jb
Jb
Jb
Jb
Jb
Jb
Jb
Jb
Jb
Jb
Jb
Jb
Jb
Jb
Jb
Jb
Jb
Jb
Jb
Jb
Jb
Jb
Jb
Jb
Jb
Jb
Jb
Jb
Jb
Jb
Jb
Jb
Jb
Jb
Jb
Jb
Jb
Jb
Jb
Jb
Jb
Jb
Jb
Jb
Jb
Jb
Jb
"}
(39,1,1) = {"
Jb
Jb
Jb
Jb
Jb
Jb
Jb
Jb
Jb
Jb
Jb
Jb
Jb
Jb
Jb
Jb
Jb
Jb
Jb
Jb
Jb
Jb
Jb
Jb
Jb
Jb
Jb
Jb
Jb
Jb
Jb
Jb
Jb
Jb
Jb
Jb
Jb
Jb
Jb
Jb
Jb
Jb
Jb
Jb
Jb
Jb
Jb
Jb
Jb
Jb
"}
(40,1,1) = {"
Jb
Jb
Jb
Jb
Jb
Jb
Jb
Jb
Jb
Jb
Jb
Jb
Jb
Jb
Jb
Jb
Jb
Jb
Jb
Jb
Jb
Jb
Jb
Jb
Jb
Jb
Jb
Jb
Jb
Jb
Jb
Jb
Jb
Jb
Jb
Jb
Jb
Jb
Jb
Jb
Jb
Jb
Jb
Jb
Jb
Jb
Jb
Jb
Jb
Jb
"}
(41,1,1) = {"
Jb
Jb
Jb
Jb
Jb
Jb
Jb
Jb
Jb
Jb
Jb
Jb
Jb
Jb
Jb
Jb
Jb
Jb
Jb
Jb
Jb
Jb
Jb
Jb
Jb
Jb
Jb
Jb
Jb
Jb
Jb
Jb
Jb
Jb
Jb
Jb
Jb
Jb
Jb
Jb
Jb
Jb
Jb
Jb
Jb
Jb
Jb
Jb
Jb
Jb
"}
(42,1,1) = {"
Jb
Jb
Jb
Jb
Jb
Jb
Jb
Jb
Jb
Jb
Jb
Jb
Jb
Jb
Jb
Jb
Jb
Jb
Jb
Jb
Jb
Jb
Jb
Jb
Jb
Jb
Jb
Jb
Jb
Jb
Jb
Jb
Jb
Jb
Jb
Jb
Jb
Jb
Jb
Jb
Jb
Jb
Jb
Jb
Jb
Jb
Jb
Jb
Jb
Jb
"}
(43,1,1) = {"
Jb
Jb
Jb
Jb
Jb
Jb
Jb
Jb
Jb
Jb
Jb
Jb
Jb
Jb
Jb
Jb
Jb
Jb
Jb
Jb
Jb
Jb
Jb
Jb
Jb
Jb
Jb
Jb
Jb
Jb
Jb
Jb
Jb
Jb
Jb
Jb
Jb
Jb
Jb
Jb
Jb
Jb
Jb
Jb
Jb
Jb
Jb
Jb
Jb
Jb
"}
(44,1,1) = {"
Jb
Jb
Jb
Jb
Jb
Jb
Jb
Jb
Jb
Jb
Jb
Jb
Jb
Jb
Jb
Jb
Jb
Jb
Jb
Jb
Jb
Jb
Jb
Jb
Jb
Jb
Jb
Jb
Jb
Jb
Jb
Jb
Jb
Jb
Jb
Jb
Jb
Jb
Jb
Jb
Jb
Jb
Jb
Jb
Jb
Jb
Jb
Jb
Jb
Jb
"}
(45,1,1) = {"
Jb
Jb
Jb
Jb
Jb
Jb
Jb
Jb
Jb
Jb
Jb
Jb
Jb
Jb
Jb
Jb
Jb
Jb
Jb
Jb
Jb
Jb
Jb
Jb
Jb
Jb
Jb
Jb
Jb
Jb
Jb
Jb
Jb
Jb
Jb
Jb
Jb
Jb
Jb
Jb
Jb
Jb
Jb
Jb
Jb
Jb
Jb
Jb
Jb
Jb
"}
(46,1,1) = {"
Jb
Jb
Jb
Jb
Jb
Jb
Jb
Jb
Jb
Jb
Jb
Jb
Jb
Jb
Jb
Jb
Jb
Jb
Jb
Jb
Jb
Jb
Jb
Jb
Jb
Jb
Jb
Jb
Jb
Jb
Jb
Jb
Jb
Jb
Jb
Jb
Jb
Jb
Jb
Jb
Jb
Jb
Jb
Jb
Jb
Jb
Jb
Jb
Jb
Jb
"}
(47,1,1) = {"
Jb
Jb
Jb
Jb
Jb
Jb
Jb
Jb
Jb
Jb
Jb
Jb
Jb
Jb
Jb
Jb
Jb
Jb
Jb
Jb
Jb
Jb
Jb
Jb
Jb
Jb
Jb
Jb
Jb
Jb
Jb
Jb
Jb
Jb
Jb
Jb
Jb
Jb
Jb
Jb
Jb
Jb
Jb
Jb
Jb
Jb
Jb
Jb
Jb
Jb
"}
(48,1,1) = {"
Jb
Jb
Jb
Jb
Jb
Jb
Jb
Jb
Jb
Jb
Jb
Jb
Jb
Jb
Jb
Jb
Jb
Jb
Jb
Jb
Jb
Jb
Jb
Jb
Jb
Jb
Jb
Jb
Jb
Jb
Jb
Jb
Jb
Jb
Jb
Jb
Jb
Jb
Jb
Jb
Jb
Jb
Jb
Jb
Jb
Jb
Jb
Jb
Jb
Jb
"}
(49,1,1) = {"
Jb
Jb
Jb
Jb
Jb
Jb
Jb
Jb
Jb
Jb
Jb
Jb
Jb
Jb
Jb
Jb
Jb
Jb
Jb
Jb
Jb
Jb
Jb
Jb
Jb
Jb
Jb
Jb
Jb
Jb
Jb
Jb
Jb
Jb
Jb
Jb
Jb
Jb
Jb
Jb
Jb
Jb
Jb
Jb
Jb
Jb
Jb
Jb
Jb
Jb
"}
(50,1,1) = {"
Jb
Jb
Jb
Jb
Jb
Jb
Jb
Jb
Jb
Jb
Jb
Jb
Jb
Jb
Jb
Jb
Jb
Jb
Jb
Jb
Jb
Jb
Jb
Jb
Jb
Jb
Jb
Jb
Jb
Jb
Jb
Jb
Jb
Jb
Jb
Jb
Jb
Jb
Jb
Jb
Jb
Jb
Jb
Jb
Jb
Jb
Jb
Jb
Jb
Jb
"}
