//MAP CONVERTED BY dmm2tgm.py THIS HEADER COMMENT PREVENTS RECONVERSION, DO NOT REMOVE
"a" = (
/turf/open/floor/plating,
/area/space)
"c" = (
/obj/effect/landmark/nightmare,
/turf/closed/wall/strata_outpost/reinforced,
/area/space)
"j" = (
/obj/structure/machinery/power/smes,
/obj/structure/machinery/power/smes{
	pixel_y = 16
	},
/turf/open/floor/plating,
/area/space)
"m" = (
/turf/closed/wall/strata_outpost/reinforced,
/area/space)
"p" = (
/obj/structure/reagent_dispensers/fueltank,
/turf/open/floor/plating,
/area/space)
"r" = (
/obj/structure/closet/toolcloset,
/turf/open/floor/plating,
/area/space)
"s" = (
/obj/structure/pipes/standard/tank/oxygen,
/turf/open/floor/plating,
/area/space)
"K" = (
/obj/structure/pipes/standard/tank/nitrogen,
/turf/open/floor/plating,
/area/space)
"S" = (
/obj/structure/closet/secure_closet/engineering_electrical,
/turf/open/floor/plating,
/area/space)
"T" = (
/obj/structure/surface/table/reinforced/black,
/turf/open/floor/plating,
/area/space)
"W" = (
/obj/structure/closet/secure_closet/engineering_welding,
/turf/open/floor/plating,
/area/space)

(1,1,1) = {"
m
m
a
m
m
m
m
m
m
c
"}
(2,1,1) = {"
m
r
a
a
S
m
a
T
T
m
"}
(3,1,1) = {"
m
r
a
a
a
a
a
a
a
m
"}
(4,1,1) = {"
m
a
a
a
a
m
s
a
a
a
"}
(5,1,1) = {"
m
a
a
a
p
m
K
a
a
m
"}
(6,1,1) = {"
m
a
a
a
W
m
m
m
m
m
"}
(7,1,1) = {"
m
a
a
a
a
m
a
a
a
m
"}
(8,1,1) = {"
m
a
a
a
a
a
a
j
a
m
"}
(9,1,1) = {"
m
a
T
T
T
m
a
a
a
m
"}
(10,1,1) = {"
m
m
m
m
m
m
m
m
m
m
"}
