//MAP CONVERTED BY dmm2tgm.py THIS HEADER COMMENT PREVENTS RECONVERSION, DO NOT REMOVE
"a" = (
/turf/closed/wall/strata_outpost/reinforced,
/area/space)
"f" = (
/turf/open/floor/strata{
	icon_state = "yellow4";
	dir = 4
	},
/area/space)
"h" = (
/obj/structure/machinery/door/poddoor/almayer/closed{
	id = "storageoneexit"
	},
/turf/open/space/basic,
/area/space)
"i" = (
/turf/open/floor/strata{
	icon_state = "yellow3";
	dir = 4
	},
/area/space)
"j" = (
/turf/open/space/basic,
/area/space)
"o" = (
/turf/open/floor/strata{
	icon_state = "yellow4"
	},
/area/space)
"s" = (
/turf/open/floor/strata{
	icon_state = "yellow4";
	dir = 8
	},
/area/space)
"A" = (
/turf/open/floor/plating,
/area/space)
"C" = (
/obj/structure/machinery/door/poddoor/almayer/closed{
	id = "storageoneentry"
	},
/obj/structure/machinery/door/poddoor/almayer/closed{
	id = "storageoneentry"
	},
/turf/open/space/basic,
/area/space)
"E" = (
/obj/structure/machinery/door/poddoor/almayer/closed{
	id = "storageoneentry"
	},
/turf/open/space/basic,
/area/space)
"F" = (
/turf/open/floor/strata{
	icon_state = "yellow3"
	},
/area/space)
"O" = (
/turf/open/floor/strata{
	dir = 6;
	icon_state = "multi_tiles"
	},
/area/space)
"P" = (
/turf/open/floor/strata{
	icon_state = "yellow4";
	dir = 1
	},
/area/space)
"R" = (
/turf/open/floor/strata{
	icon_state = "yellow3";
	dir = 8
	},
/area/space)
"U" = (
/turf/open/floor/strata{
	icon_state = "yellow3";
	dir = 1
	},
/area/space)

(1,1,1) = {"
A
A
A
A
A
a
a
A
a
a
a
a
A
a
a
a
a
a
a
a
a
a
A
A
A
a
O
"}
(2,1,1) = {"
a
A
a
A
A
A
A
A
A
A
A
A
A
a
A
A
A
A
A
A
A
A
A
a
A
a
O
"}
(3,1,1) = {"
A
A
a
a
a
a
a
A
a
a
a
a
a
a
A
A
A
a
A
A
a
a
a
a
A
a
O
"}
(4,1,1) = {"
a
A
A
A
A
A
a
a
a
j
j
j
j
a
a
a
A
a
a
A
A
A
A
a
A
a
O
"}
(5,1,1) = {"
A
A
a
A
a
a
a
j
j
j
j
j
j
j
j
a
a
a
A
A
A
a
A
a
A
a
O
"}
(6,1,1) = {"
A
a
a
a
a
j
j
j
j
j
j
j
j
j
j
j
j
a
a
a
a
a
A
a
a
a
O
"}
(7,1,1) = {"
A
A
A
a
j
j
j
j
j
j
j
j
j
j
j
j
j
a
A
A
A
A
A
A
A
a
O
"}
(8,1,1) = {"
a
a
a
a
j
j
j
j
j
j
j
j
j
j
j
j
j
a
a
a
a
a
a
a
a
a
O
"}
(9,1,1) = {"
A
A
A
a
j
j
j
j
j
j
j
j
j
j
j
j
j
E
o
R
R
R
R
R
f
h
O
"}
(10,1,1) = {"
A
a
A
a
j
j
j
j
j
j
j
j
j
j
j
j
j
E
U
j
j
j
j
j
F
h
O
"}
(11,1,1) = {"
A
a
A
a
j
j
j
j
j
j
j
j
j
j
j
j
j
C
P
i
i
i
i
i
s
h
O
"}
(12,1,1) = {"
a
a
A
a
j
j
j
j
j
j
j
j
j
j
j
j
j
a
a
a
a
a
a
a
a
a
O
"}
(13,1,1) = {"
a
A
A
a
j
j
j
j
j
j
j
j
j
j
j
j
j
a
A
a
A
A
A
A
A
a
O
"}
(14,1,1) = {"
a
A
a
a
a
j
j
j
j
j
j
j
j
j
j
j
j
a
A
a
A
a
A
A
a
a
O
"}
(15,1,1) = {"
a
a
a
A
a
a
a
j
j
j
j
j
j
j
j
a
a
a
A
A
A
a
a
A
A
a
O
"}
(16,1,1) = {"
A
A
A
A
a
A
a
a
a
j
j
j
j
a
a
a
A
a
a
A
A
A
a
a
A
a
O
"}
(17,1,1) = {"
A
a
a
A
a
A
A
A
a
a
a
a
a
a
A
A
A
A
A
A
A
a
a
A
A
a
O
"}
(18,1,1) = {"
A
A
a
a
A
A
a
A
a
A
A
a
A
A
A
A
a
a
A
a
A
A
a
a
A
a
O
"}
(19,1,1) = {"
A
A
A
a
A
a
a
a
a
A
a
a
a
a
A
a
a
A
A
a
A
A
A
a
A
a
O
"}
(20,1,1) = {"
A
a
A
a
A
A
A
A
A
A
a
A
a
A
A
A
a
A
a
a
a
a
A
A
A
a
O
"}
