"a" = (/turf/closed/wall/drg_rock,/turf/open/auto_turf/sand_white/layer1,/area/drg)
"e" = (/turf/closed/wall/drg_rock/organic/veiny,/turf/open/auto_turf/sand_white/layer0,/area/drg)
"f" = (/obj/effect/decal/organic_veins,/turf/open/auto_turf/sand_white/layer0,/area/drg)
"g" = (/obj/structure/prop/hybrisa/cavedecor/stalagmite0{pixel_y = 24},/obj/structure/prop/hybrisa/cavedecor/stalagmite5{pixel_x = -11; pixel_y = 4},/turf/open/auto_turf/sand_white/layer1,/area/drg)
"i" = (/obj/item/drg_glyphid_egg,/turf/open/floor/organic,/area/drg)
"j" = (/turf/open/auto_turf/sand_white/layer0,/area/drg)
"m" = (/turf/open/floor/organic/veiny,/area/drg)
"r" = (/turf/open/floor/organic,/area/drg)
"x" = (/turf/closed/wall/drg_rock,/turf/open/auto_turf/sand_white/layer0,/area/drg)
"y" = (/obj/effect/decal/organic_veins,/turf/open/auto_turf/sand_white/layer1,/area/drg)
"F" = (/turf/open/auto_turf/sand_white/layer1,/area/drg)
"J" = (/obj/structure/prop/hybrisa/cavedecor/stalagmite1{pixel_x = 3; pixel_y = 17},/obj/structure/prop/hybrisa/cavedecor/stalagmite5,/obj/structure/prop/hybrisa/cavedecor/stalagmite4{pixel_x = 3},/turf/open/auto_turf/sand_white/layer0,/area/drg)
"L" = (/turf/closed/wall/drg_rock/organic/veiny,/turf/open/auto_turf/sand_white/layer1,/area/drg)
"R" = (/obj/structure/tunnel,/turf/open/auto_turf/sand_white/layer1,/area/drg)
"U" = (/obj/effect/decal/organic_veins,/turf/open/floor/organic,/area/drg)

(1,1,1) = {"
aaaFFFFFaaaaaaaaFFFF
aaaFFFFFaaaaaaaaFFFF
aaFjjjFaaaaaaaaaFFFa
aFjjjFFaaaaaaaaaFFaa
aFjjFjxxaaaaaaaFFFaa
ajjjjjxaaaaaaaaFFFaa
ajjFFxaaaaaaaaajFFaa
ajjFFjaaaaaaaaajFaaa
aJFFFjFaaaaaaaxFFxaa
aajFFFFaaaaaaxFFjxaa
aaajFFFaaaxxaxjjFFaa
aaaFFFaaaaxxxxjjFFaa
aaaFFFaaaaxxxxjFFFaa
aaaFFaaaaaaxxjjjjFaa
aaaFFaaaaLLeaxjjjFaa
aaFFFaLLLLrLLxjjjFaa
aaFFaaLLrUrrLxjjjaaa
aaFFaLLrrrmLLxjjjaaa
aaFFaLUUirULaaFFFaaa
aaFFaLUmrrLLayFFFaaa
aFFFyLLrrrLLayyyyaaa
aFFFFyLLmrLLayFFFaaa
aFFyyyyLLLLyyyFFaaaa
aaFyFFFyyyyFFFFaaaaa
aayyFFFyyyFFFFFaaaaa
aaaaaFFyFFFFFaaaaaaa
aaaxaxyyFFFFaaaaaaaa
aaxxaxfFFjFFaaaxxaxa
axxxaxfFFFFgaaaxxxxa
axxxaaajFFFaaaaxxxaa
axxxxaajFFFaaaaaaxaa
axxxxaaaFFFaaaaaaxaa
axxxxaaaFFFaaaaaaaaa
aaxxxxxxaFFaaFFaaaaa
aaxxxxxxaFFFaFRFaaaa
aaaaxxxxFFFFaaFFaaaa
aaaaxxxxFFFFFaFaaaaa
aaaaaaxxFFFFFaaaaaaa
aaaaaaaFFFFFaaaaaaaa
aaaaaaaFFFFaaaaaaaaa
"}
