"a" = (/turf/closed/wall/drg_rock,/turf/open/auto_turf/sand_white/layer1,/area/drg)
"h" = (/obj/structure/tunnel,/turf/open/auto_turf/sand_white/layer1,/area/drg)
"m" = (/obj/structure/prop/hybrisa/cavedecor/stalagmite2{pixel_x = -12; pixel_y = 5},/obj/structure/prop/hybrisa/cavedecor/stalagmite1,/turf/open/auto_turf/sand_white/layer0,/area/drg)
"z" = (/obj/structure/prop/hybrisa/cavedecor/stalagmite0{pixel_x = 10; pixel_y = 6},/obj/structure/prop/hybrisa/cavedecor/stalagmite4,/turf/open/auto_turf/sand_white/layer0,/area/drg)
"B" = (/turf/closed/wall/drg_rock,/turf/open/auto_turf/sand_white/layer0,/area/drg)
"G" = (/obj/structure/prop/hybrisa/cavedecor/stalagmite0,/turf/open/auto_turf/sand_white/layer1,/area/drg)
"I" = (/turf/open/auto_turf/sand_white/layer0,/area/drg)
"K" = (/turf/open/auto_turf/sand_white/layer1,/area/drg)

(1,1,1) = {"
aaaKKKKKaaaaaaa
aaaKKKKKaaaaaaa
aaaKKKKKaaaaaaa
aaaaKKKKKIBaaaa
aaaaaKKKIIBBBaa
aaaaaaKIIImBBaa
aBaaaaKIIIIBaaa
aBaaaaKIIIIBaaa
aBBBBaKKIIIKaaa
aBBBBBaaIIIKaaa
aBBBaBaaIIIIBaa
aaaBBBaaKIIIBBB
aaaaBBaaKKIIBBB
aaaaIIKKKKIIBBB
aaaaKKKKKKKBBBB
aaaaKKGKaaaBBBB
aaaaKKKaaaaKIBB
aaaKKKKaaaKKKBB
aaaKKKKKaKKKaBB
aaaKKKKKaKhKBBB
aaaaKKKKaaaaBBB
aBBaKKKIIaaBBBa
aBBaaKKIIaaBBaa
BBBBBKKKKKaaaaa
BBBBBBIIIKaaaaa
BBBBBBIIIKaaaaa
BBBBBBIIIKKaaaa
aBBBBzIIKKKBaaa
aaaBIIIIKKaaaaa
aaaBIIIKGaaaaaa
"}
