"ay" = (/obj/structure/flora/bush/ausbushes/grassybush,/turf/open/auto_turf/strata_grass/layer1,/area/drg)
"aZ" = (/obj/structure/tunnel,/turf/open/auto_turf/sand_white/layer0,/area/drg)
"be" = (/turf/closed/wall/drg_rock,/turf/open/auto_turf/sand_white/layer1,/area/drg)
"bx" = (/obj/structure/flora/jungle/vines/light_1,/turf/open/auto_turf/strata_grass/layer0,/area/drg)
"cN" = (/obj/structure/flora/grass/tallgrass/jungle/corner{dir = 6},/turf/open/auto_turf/strata_grass/layer1,/area/drg)
"cV" = (/turf/open/auto_turf/sand_white/layer0,/area/drg)
"dy" = (/turf/open/auto_turf/sand_white/layer1,/area/drg)
"fw" = (/obj/structure/tunnel,/turf/open/auto_turf/sand_white/layer1,/area/drg)
"gg" = (/obj/structure/flora/jungle/vines/light_2,/obj/structure/flora/jungle/vines/light_1,/turf/open/auto_turf/sand_white/layer1,/area/drg)
"gM" = (/obj/structure/flora/grass/tallgrass/jungle/corner{dir = 10},/turf/open/auto_turf/strata_grass/layer1,/area/drg)
"gX" = (/obj/structure/flora/jungle/vines/heavy,/turf/open/auto_turf/sand_white/layer0,/area/drg)
"hb" = (/obj/structure/flora/bush/ausbushes/reedbush{pixel_x = -12; pixel_y = 19},/turf/open/gm/river,/area/drg)
"hW" = (/obj/structure/flora/bush/ausbushes/reedbush{pixel_x = -6; pixel_y = 14},/obj/structure/flora/bush/ausbushes/reedbush,/turf/open/gm/river,/area/drg)
"jd" = (/obj/structure/flora/grass/tallgrass/jungle/corner{dir = 8},/turf/open/auto_turf/strata_grass/layer1,/area/drg)
"nC" = (/obj/structure/flora/jungle/plantbot1,/turf/open/auto_turf/strata_grass/layer0,/area/drg)
"po" = (/obj/structure/flora/jungle/vines/light_1,/obj/structure/flora/jungle/vines/light_2,/turf/open/auto_turf/strata_grass/layer1,/area/drg)
"rZ" = (/obj/structure/flora/jungle/planttop1,/turf/open/auto_turf/strata_grass/layer0,/area/drg)
"uw" = (/obj/structure/flora/bush/ausbushes/var3/stalkybush{pixel_x = -3; pixel_y = 10},/obj/structure/flora/bush/ausbushes/reedbush{pixel_x = 7},/turf/open/gm/river,/area/drg)
"wv" = (/obj/structure/drg/land_crystals/sugar,/turf/open/auto_turf/sand_white/layer1,/area/drg)
"wK" = (/turf/open/auto_turf/strata_grass/layer0,/area/drg)
"wS" = (/obj/structure/flora/bush/ausbushes/var3/sparsegrass,/turf/open/auto_turf/strata_grass/layer0,/area/drg)
"xJ" = (/turf/open/auto_turf/strata_grass/layer1,/area/drg)
"xU" = (/turf/closed/wall/drg_rock,/turf/open/auto_turf/strata_grass/layer1,/area/drg)
"yi" = (/obj/structure/flora/grass/tallgrass/jungle/corner{dir = 5},/turf/open/auto_turf/strata_grass/layer1,/area/drg)
"Ag" = (/obj/structure/flora/bush/ausbushes/var3/leafybush,/turf/open/auto_turf/strata_grass/layer1,/area/drg)
"Cl" = (/obj/structure/drg/land_crystals/sugar{pixel_x = 8; pixel_y = 13},/turf/open/auto_turf/sand_white/layer1,/area/drg)
"DF" = (/obj/structure/flora/jungle/vines/light_3,/turf/open/auto_turf/sand_white/layer1,/area/drg)
"DZ" = (/obj/structure/flora/jungle/vines/heavy,/turf/open/auto_turf/strata_grass/layer0,/area/drg)
"Ee" = (/obj/structure/flora/jungle/vines/heavy,/obj/structure/flora/jungle/vines/light_1,/turf/open/auto_turf/strata_grass/layer1,/area/drg)
"EJ" = (/obj/structure/prop/hybrisa/cavedecor/stalagmite5{pixel_x = -8; pixel_y = 12},/obj/structure/prop/hybrisa/cavedecor/stalagmite0,/turf/open/auto_turf/sand_white/layer1,/area/drg)
"Fj" = (/obj/structure/flora/jungle/vines/light_3,/turf/open/auto_turf/strata_grass/layer1,/area/drg)
"Ga" = (/obj/structure/flora/grass/tallgrass/jungle/corner{dir = 4},/turf/open/auto_turf/sand_white/layer1,/area/drg)
"Gb" = (/obj/structure/flora/bush/ausbushes/var3/brflowers,/turf/open/auto_turf/strata_grass/layer0,/area/drg)
"Hn" = (/obj/structure/flora/jungle/vines/light_3,/obj/structure/flora/jungle/vines/light_2,/turf/open/auto_turf/strata_grass/layer0,/area/drg)
"Jt" = (/obj/structure/flora/jungle/vines/heavy,/turf/open/auto_turf/sand_white/layer1,/area/drg)
"Lb" = (/obj/structure/flora/grass/tallgrass/jungle/corner{dir = 9},/turf/open/auto_turf/strata_grass/layer1,/area/drg)
"LV" = (/obj/structure/flora/jungle/vines/heavy,/obj/structure/flora/jungle/vines/light_1,/turf/open/auto_turf/strata_grass/layer0,/area/drg)
"Mg" = (/obj/structure/flora/bush/ausbushes/ppflowers,/turf/open/auto_turf/strata_grass/layer0,/area/drg)
"Oi" = (/obj/structure/flora/bush/ausbushes/var3/brflowers,/turf/open/auto_turf/strata_grass/layer1,/area/drg)
"Ox" = (/obj/structure/flora/bush/ausbushes/reedbush{pixel_x = 6; pixel_y = 21},/obj/structure/flora/bush/ausbushes/reedbush{pixel_x = -2; pixel_y = 14},/obj/structure/flora/bush/ausbushes/reedbush,/turf/open/gm/river,/area/drg)
"Oy" = (/obj/structure/flora/grass/tallgrass/jungle/corner{dir = 6},/turf/open/auto_turf/sand_white/layer1,/area/drg)
"ON" = (/obj/structure/flora/bush/ausbushes/var3/sunnybush,/turf/open/auto_turf/strata_grass/layer1,/area/drg)
"Ps" = (/obj/structure/prop/hybrisa/cavedecor/stalagmite4,/turf/open/auto_turf/sand_white/layer1,/area/drg)
"PM" = (/obj/structure/flora/jungle/vines/light_2,/obj/structure/flora/jungle/vines/heavy,/turf/open/auto_turf/strata_grass/layer0,/area/drg)
"PV" = (/turf/open/gm/river,/area/drg)
"QG" = (/obj/structure/flora/jungle/vines/heavy,/turf/open/auto_turf/strata_grass/layer1,/area/drg)
"RS" = (/turf/closed/wall/drg_rock,/turf/open/auto_turf/sand_white/layer0,/area/drg)
"Sg" = (/obj/structure/flora/grass/tallgrass/jungle,/turf/open/auto_turf/strata_grass/layer1,/area/drg)
"SR" = (/obj/structure/prop/hybrisa/cavedecor/stalagmite3{pixel_x = 6; pixel_y = 14},/obj/structure/prop/hybrisa/cavedecor/stalagmite5,/obj/structure/prop/hybrisa/cavedecor/stalagmite1{pixel_x = 6; pixel_y = -18},/turf/open/auto_turf/sand_white/layer1,/area/drg)
"TJ" = (/obj/structure/flora/jungle/vines/light_1,/obj/structure/flora/jungle/vines/heavy,/turf/open/auto_turf/strata_grass/layer1,/area/drg)
"UF" = (/obj/structure/flora/bush/ausbushes/var3/ywflowers,/turf/open/auto_turf/strata_grass/layer1,/area/drg)
"UG" = (/obj/structure/flora/jungle/vines/light_2,/turf/open/auto_turf/strata_grass/layer1,/area/drg)
"UX" = (/turf/closed/wall/strata_ice/jungle,/area/drg)
"Vt" = (/obj/structure/flora/bush/ausbushes/reedbush,/turf/open/gm/river,/area/drg)
"VQ" = (/obj/structure/flora/bush/ausbushes/var3/sparsegrass,/turf/open/auto_turf/strata_grass/layer1,/area/drg)
"WO" = (/obj/structure/flora/jungle/vines/light_1,/turf/open/auto_turf/strata_grass/layer1,/area/drg)
"WQ" = (/obj/structure/flora/jungle/alienplant1,/turf/open/auto_turf/sand_white/layer1,/area/drg)
"XA" = (/turf/closed/wall/drg_rock,/turf/open/auto_turf/strata_grass/layer0,/area/drg)

(1,1,1) = {"
bebebebebebebebebebebebebebebebebebebebebebebebebebebebebebebebebebebebebebebebebebebebebe
bebebebebebebebebebebebebebebebebebebebebebebebebebebebebebebebebebebebebebebebebebebebebe
bebebebebebeRSRSbebebebebebebebebebebebebebebebebebebebebebebebebebebebebebebebebebebebebe
bebebebebebeRSRSRSbebebebebebebebebebebebebebebebebebebebebebebebebebebebebebebebebebebebe
bebebebebeRSRSRSRSRSbebebebebebebebebebebebebedydydydybebebebebebebebebebebebebebebebebebe
bebebebeRSRSRSRSRSRSRSRSbebebebebebebebebebebedydydydybebebebebebebebebebebebebebebebebebe
bebebeRSRSRSRSRSRSRSRSRSbebebebexUxUxUxUxJdydydydydydybebebebebebebebebebebebebebebebebebe
bebebeRSRSRSRSRSRSRSRSRSbebebexUxUxUxUxUVQxJdydydybedydydydydydybebebebebebebebebebebebebe
bebebeRSRSRSRSRSRSRSRSRSbebebexUxUxUxUbeFjxJdydyEJdydydydydydydybebebebebebebebebebebebebe
bebebeRSRSRSRSRSRSRSbebebebeRSxUQGQGQGFjwKdydydydydydydydydydydydydybebebebebebebebebebebe
bebebeRSRSRSRSRSRSRSbebebebeRSxUQGbxQGxJdydydydydydydydydydydydydydybebebebebebebebebebebe
bebebeRSRSRScVcVcVcVRSbebebeUXQGQGwKwKUGdydydydydydydydydydydydydycVRSbebebebebebebebebebe
bebebebeRSRScVcVcVcVcVRSRSbeUXgXEeONwKdydydydydydydydydydydydycVcVcVcVdydybebebebebebebebe
bebebebeRSRScVcVcVcVcVRSRSbeUXUXgXWOwKdydydydydydydydydydydycVcVcVcVcVdydydydybebebebebebe
bebebebebedycVaZcVcVRSRSUXUXUXUXJtdydydydyxJxJdydydydydydydycVcVcVdydydydydydybebebebebebe
bebebebebedydycVcVdyRSRSUXUXUXDFdydydydydyxJxJdydydyxJxJdydycVcVcVdydydydydydydybebebebebe
bebebebebedydydydybebebeUXUXdydydydydydydydydydydyxJxJVQxJdycVcVdydydydydydydydybebebebebe
bebebeRSRSbedydyRSRSdydydydydydydydydyxJxJdydyxJxJxJFjxJAgcVcVcVdydydydydydydydybebebebebe
bebebeRSRSRSRScVRSRSdydydydydydydydydyxJxJxJxJxJxJTJUXUXxJaycVcVdydydydydydydybebebebebebe
bebebebeRSRSRSRSRSRScVdydydydydyxJxJxJxJwKxJxJxJxJWOUXUXxJxJcVdydydydydydydydybebebebebebe
bebebebeRSRSRSRScVdydydydydydydyxJxJxJMgwKWQdydywKpoQGUXUXxJdydydydydydydydydybebebebebebe
bebebebebebebebecVdydywvdydydycVxJxJOiwKdydyhbdydydyxJWOxJdydydydydydydydydybebebebebebebe
bebebebebebebebedydydydydydydycVcVxJxJdydyPVPVuwPVdycNgMxJdydydydydydydydyxJxUbebebebebebe
bebebebebebebebedydydydydydydydycVxJxJdydyPVVtPVPVOySgjdxJdydydydydydydydyxJxUbebebebebebe
bebebebebebebebedydydydydyUXdydycVVQxJxJdyhWPVPVdyGaSgLbdydydydydydydydyxJwKxUxUbebebebebe
bebebebebebebebedydydyUXUXUXdydycVxJxJxJdydyPVOxdyyiLbxJxJdydydydydydydyAgwKwKXAXAbebebebe
bebebebebebebebedydydydyUXUXdydydycVcVVQxJdydydydywKwKxJdydydydydydydydyxJwSwKXAXAbebebebe
bebebebebebebebedydydydyUXUXUXdydydycVxJxJxJxJrZwKGbxJxJdydydyPsdydydydyxJxJDZxUXAbebebebe
bebebebebebebebebebedydydydyUXdydydycVxJAgxJxJnCwKxJxJdydydydydydydydyUXwSpoPMXAxUbebebebe
bebebebebebebebebebedydydycVdydydycVcVdyxJxJxJxJwKxJxJdydydydydydydyUXUXUXQGwKXAxUbebebebe
bebebebebebeRSRSbebedydydycVcVdydydydydydydyxJxJxJxJdydyxJdydydydydydyUXUXUXUFHnxUbebebebe
bebebebebebeRSRSbebebeSRdydycVcVcVcVcVcVdydydydydydydydydydydydydydydydydyUXWOwKxUbebebebe
bebebebeRSRSRSRSRSbebedydydycVcVcVcVcVdydydydydydydydydydydydydyCldydydydydyxJxUbebebebebe
bebebebeRSRSRSRSRSbebedydydydycVcVcVcVdydydydydydydydydydydydydydydydydydydybebebebebebebe
bebebebeRSRSRSRSbebebedydydycVcVcVcVcVdydydydydydydydydydydydydydycVcVdydydybebebebebebebe
bebebeRSRSRSRSRSbebebedydydycVcVxJwKdydydydyxJxJdydydydydydydydydycVcVdydybebebebebebebebe
bebebeRSRSRSRSRSbebebebebedydycVxJxJwKdyggUXayxJdydydybebebebebebeRSRSRSbebebebebebebebebe
bebebeRSRSRSRSbebebebebebedydycVxJGbwKwKUXUXdydydybebebebebeRSRSRSRSbeRSbeRSRSRSbebebebeRS
bebebeRSRSRSRSbebebebebebedydydyxJxJAgwKUXFjdydydybebebeRSRSRSRSbebeRSRSRSRSRSbeRSRSbebebe
bebebebebeRSRSbebebebebebebebedydydyxJwKLVxJdybebebebebeRSRSRSRSRSRSRSRSRSRSRSRSRSRSRSbebe
bebebebebeRSRSRSbebebebebebebedydydybexUbebebebebebebebeRSRSRSRSRSRSRSRSbebebeRSRSRSRSbebe
bebebebebebeRSRSbebebebebebebedybebebexUbebebebebebebebeRSRSRSRSRSRSRSRSRSbebeRSRSbebebebe
bebebebebebebeRSbebebebebebebebebebebebebebebebebebebebeRSRSRSRSRSRSRSRSRSbebebeRSRSbebebe
bebebebebebebebebebebebebebebebebebebebebebebebebebebebeRSRSRSRSRSRSRSRSRSRSbebeRSRSbebebe
bebebebebebebebebebebebebebebebebebebebebebebebebebebebebedyRSRScVcVRSRSRSRSbebebebebebebe
bebebebebebebebebebebebebebebebebebebebebebebebebebebebebedycVcVcVcVRSRSRSbebebebebebebebe
bebebebebebebebebebebebebebebebebebebebebebebebebebebebedydydydydycVbeRSRSbebebebebebebebe
bebebebebebebebebebebebebebebebebebebebebebebebebebebebebebedydyfwdybebebebeRSRSbebebebebe
bebebebebebebebebebebebebebebebebebebebebebebebebebebebebebedydybebebebebebeRSRSbebebebebe
bebebebebebebebebebebebebebebebebebebebebebebebebebebebebebebebebebebebebebebebebebebebebe
"}
