"a" = (/obj/structure/surface/table/rock,/turf/open/auto_turf/sand_white/layer1,/area/drg)
"j" = (/turf/open/auto_turf/sand_white/layer1,/area/drg)
"r" = (/obj/structure/prop/hybrisa/cavedecor/stalagmite3,/turf/open/auto_turf/sand_white/layer1,/area/drg)
"w" = (/obj/structure/prop/hybrisa/cavedecor/stalagmite0{pixel_x = -12; pixel_y = 6},/obj/structure/prop/hybrisa/cavedecor/stalagmite2,/turf/open/auto_turf/sand_white/layer0,/area/drg)
"x" = (/obj/structure/prop/hybrisa/cavedecor/stalagmite2{pixel_x = 6; pixel_y = 12},/obj/structure/prop/hybrisa/cavedecor/stalagmite4,/turf/open/auto_turf/sand_white/layer1,/area/drg)
"z" = (/obj/structure/surface/table/rock,/turf/open/auto_turf/sand_white/layer0,/area/drg)
"H" = (/obj/structure/prop/hybrisa/cavedecor/stalagmite4{pixel_x = -15; pixel_y = 16},/obj/structure/prop/hybrisa/cavedecor/stalagmite4{pixel_x = -2; pixel_y = 14},/obj/structure/prop/hybrisa/cavedecor/stalagmite5{pixel_x = 9},/obj/structure/prop/hybrisa/cavedecor/stalagmite4,/turf/open/auto_turf/sand_white/layer1,/area/drg)
"K" = (/turf/open/auto_turf/sand_white/layer0,/area/drg)
"N" = (/obj/structure/tunnel,/turf/open/auto_turf/sand_white/layer1,/area/drg)

(1,1,1) = {"
aaaaaajjjjjjjjjaaaaaaaaaaaaaaa
aaaaaaajjjjjjjjaaaaaaaaaaaaaaa
aaaaaaajjjjjjjjaaaaaaaaaazzzza
aaaaaaajjjjjjjjjaaaaaaaazzzzzz
aaaaaaaajjjjjjjjaaaaaaaaaazzzz
aaaaaajaaajjjjjjjaaazzaaaaazza
aaaaaajjjaaaajjjjaaazzzzzzazaa
aaaaajjajjaaajjjjKwzzzzzzzaaaa
aaaaajjjjjaaajjjjKKzzzzzzaaaaa
aaaaajjNjjjaaaajjKKzzzzzzaaaaa
aaaaaaajjjaaaaajKKKKKzzzzaaaaa
aaaaaaaajjaaaaajKKKKKzzzzzzaaa
aaaaaaaaaaaaaaaaKKKKKzzzzzzzaa
aaaaaaaaaaaaaaaaKKKKKzzzzzzzaa
aaaaaaaaaaaaaaaajjKKzzzzzzzzaa
aaaaaaaaaaaaaaaajjKKzzzzzzzaaa
zaaaaaaaaaaaaaajjjjjzzzzzzzaaa
zzaaaaaaaaaaaaajjjjjazzzzzzaaa
zzaaaaaaaaaaajjjjjjaaaaazzaaaa
zzzaaaaaaaaaajjjjaaaaaaaaaaaaa
zzzaaaaaaaaajjjjjaaaaaaaaaaaaa
azzaaaaaaaaajjjjjaaaaaaaaaaaaa
aaaaaaaaajjjjjjjaaaaaaaaaaaaaa
aaaazzzzzjjjjjjjaajjaaaaaaaaaa
aaazzzKKKjjjjjjjaNjjaaaaaaaaaj
aazzzzKKKjjjjjjaajjjjaaaaaajjj
aazzKKKKjjjjjjaajjjjNaaaaaajjj
aazzKKKKHjjjjjaaajjjjaaaajjjjj
aazzKKjjaajjjjjzaaajaaaaajjjjj
aazzzKKraajKKjjjjaaaaaaaajjjjj
aaaazKKjjjjKKKjjjjjaaaaaajjjjj
aaaazzKKKjjjKKjjjjjjjaajjjjjjj
aaaaaajKKKjjKKKjjjjjjjjjjjjjjj
aaaaaajjKKjjjzzajjjjjjjjjjjjaa
aaaaaajjKKjjjaaaaaajjjjjjjxaaa
aaaaaaKKKKjjjaaaaaaaaajjjaaaaa
aaaaazKKjjjjaaaaaaaaaajaaaaaaa
aaaaazKjjjjjaaaaaaaaaaaaaaaaaa
aaaajKjjjjjaaaaaaaaaaaaaaaaaaa
aaaajjjjjjjaaaaaaaaaaaaaaaaaaa
"}
