"a" = (/turf/closed/wall/drg_rock,/turf/open/auto_turf/sand_white/layer0,/area/drg)
"e" = (/turf/open/auto_turf/sand_white/layer1,/area/drg)
"p" = (/turf/closed/wall/drg_rock,/turf/open/auto_turf/sand_white/layer1,/area/drg)
"u" = (/obj/structure/prop/hybrisa/cavedecor/stalagmite4{pixel_x = 6; pixel_y = -8},/turf/open/auto_turf/sand_white/layer0,/area/drg)
"G" = (/obj/structure/prop/hybrisa/cavedecor/stalagmite5{pixel_x = -10; pixel_y = 13},/obj/structure/prop/hybrisa/cavedecor/stalagmite2{pixel_y = 9},/turf/open/auto_turf/sand_white/layer1,/area/drg)
"L" = (/obj/structure/drg/land_crystals/sugar{pixel_x = -11; pixel_y = 11},/turf/open/auto_turf/sand_white/layer1,/area/drg)
"R" = (/obj/structure/prop/hybrisa/cavedecor/stalagmite0{pixel_x = 8; pixel_y = 13},/obj/structure/prop/hybrisa/cavedecor/stalagmite1,/turf/open/auto_turf/sand_white/layer1,/area/drg)
"V" = (/obj/structure/prop/hybrisa/cavedecor/stalagmite1{pixel_x = -14; pixel_y = -7},/turf/open/auto_turf/sand_white/layer1,/area/drg)
"W" = (/obj/structure/tunnel,/turf/open/auto_turf/sand_white/layer1,/area/drg)
"X" = (/turf/open/auto_turf/sand_white/layer0,/area/drg)
"Z" = (/obj/structure/prop/hybrisa/cavedecor/stalagmite4,/turf/open/auto_turf/sand_white/layer1,/area/drg)

(1,1,1) = {"
ppppppppppppppppppppeepppppppp
ppppppppppppppppppppeepppppppp
ppppppppppppppppppaXXeepaaappp
epppppppppppppppppXXXeepaaaaap
eeppppppppppppppppeeeeeaaaaaap
eeeeppppppeeeeppeeeeeeaaaaaaaa
eeeeeeeeeeeeeeeeeXXepaaaaaaaaa
eepeeeeeeLeeppReeXappaaaaaaaaa
pppeeXXXXeeeppeepppppaaaaaaaaa
epppeXXXXeeeeeeeppppppaaaaaaaa
eeeeXXXXXXeeeeeeppppppaaaaaaaa
eeeVeppaaapeeeeepppppppppaaaap
eeppppppaapeeeeeppppppppppaaap
ppaaaapppXaapeeeeppppppppppppp
paaaaaappXXaaaeeeeeeeppppppppp
paaaaaapeeeXXaeeeeeeeepppppppp
aaaaaaapeWeeaaXeeeeeeXpppppppp
aaaaaaaapeepaaaeXeeeeepppppppp
paaaaaaapppppppeXeeeeepppppppp
paaaaaaaapppppppeeeeeepppppppp
ppaaaaaaappaaappeeeeeGpppppppp
ppppaaaaaaaaaaaXXXXeZepppppppp
ppppaaaaaaaaaaaXXXXepppppppppp
ppppaaaaaaaaaaaXXXXepppppppppp
pppppaaaaaaaaXXXXXXeppeeppppaa
ppppppaaaaaaaXXXXXXXapeWepppaa
ppppppaaaaauXXXXXXXapeeeeaaaaa
aapappaaaaXXXXXXXXppeeeeXaaaaa
aaapppaaapXXXXXXeppppeeeaaaaaa
aaappppppeeeeeeeeppppppppppaaa
"}
