"a" = (/obj/structure/surface/table/rock,/turf/open/auto_turf/sand_white/layer1,/area/drg)
"y" = (/obj/structure/prop/hybrisa/cavedecor/stalagmite2,/turf/open/auto_turf/sand_white/layer1,/area/drg)
"z" = (/obj/structure/prop/hybrisa/cavedecor/stalagmite5{pixel_x = -12; pixel_y = 12},/obj/structure/prop/hybrisa/cavedecor/stalagmite4,/turf/open/auto_turf/sand_white/layer1,/area/drg)
"A" = (/turf/open/auto_turf/sand_white/layer1,/area/drg)
"E" = (/obj/structure/drg/land_crystals/sugar,/turf/open/auto_turf/sand_white/layer0,/area/drg)
"I" = (/turf/open/auto_turf/sand_white/layer0,/area/drg)
"J" = (/obj/structure/surface/table/rock,/turf/open/auto_turf/sand_white/layer0,/area/drg)
"U" = (/obj/structure/tunnel,/turf/open/auto_turf/sand_white/layer1,/area/drg)
"W" = (/obj/structure/prop/hybrisa/cavedecor/stalagmite0{pixel_x = 10; pixel_y = 6},/obj/structure/prop/hybrisa/cavedecor/stalagmite5,/turf/open/auto_turf/sand_white/layer1,/area/drg)

(1,1,1) = {"
aaaaaaaaaaaaaaaaaaaaaaaaaaaaaa
aJJaaaaaaaaaaaaaAAAAaaaaaaaJJa
JJJJJaaaaaaaaaaaAAAAaaaaJJaJJa
JJJJJJJaaaaaaAAAAAUAAAAAJJJaaa
JJJJJJJaaaaaaAAAAAAAAAAAaJJaaa
JJJJJJJJJJJaaAAAAAAAAAAAAIAaaa
JJJJJJJJJJJaAAAAaaAAAAAAAAAaaa
JJJJaaaaaJJaAAAAaaAAAAAAAAAaaa
aJJJJJaJaJJaAAAAAAzAAAAAAAAAaa
JJJJJJaaaJaaAAAAAAAAAAAAAAAAaa
JJaaJJJJaJaaAAAAAAAAAAAIIAAAaa
aJJaaJJJJaaaaaAAAAAAAAAIIAAAaa
aJJaJJJJJaaaaaAAAAAAAAIIIAAAaa
aJJaJJJJJaaaaaaAAAAAAAIIIAAaaa
aaaJJJJJaaaaaaaaaAAAIIIIIAAaaa
aaaaaaaaaaaaaaaaaaAAIIIIIAAaaa
aaaaaaaAAAAaaaaaaaAAIIIIIUaaaa
aaaaaaaAAAAaaaaaaaAAIIIEIAaaaa
aaaaaaAAAAAaJaaaaaaAIIIIIIaaaa
aaaaaaAIIIIAAaaaaaaAIIIIIIaaaa
aaaIAWAIIIIaAaaaaaaaaAIIIIJaaa
aaaIIAAAIIIAAaaaaaaaaAIIIIJaaa
aaaIIIAAIIIAAAaaaaaaaAAIIJJaaa
aaaAIIIIIAAAAAaaaaaaaaaIIJJaaa
aaAAIIIIIAAAAAAaaaaJJaaIJJJaaa
aaAAIIIIIAAAAyAaAaaaJJaaaJJaaa
aaAAIIAAAAAAAaaaAAaaJJaaaaaaaa
aaaaAAAAAAAAaaAAAAaaJJaaaaaaaa
aaaaAAAAAaaaaAAUaaaaaaaaaaaaaa
aaaaaaaaaaaaaaaaaaaaaaJaaaaaaa
"}
