"a" = (/turf/template_noop,/area/template_noop)
"b" = (/obj/effect/alien/weeds/node,/turf/open/ice{color = "#797979"},/area/template_noop)
"c" = (/obj/effect/alien/egg,/obj/effect/alien/resin/sticky/thin,/turf/open/ice{color = "#797979"},/area/template_noop)
"e" = (/obj/effect/xenomorph/boiler_bombard,/mob/living/carbon/xenomorph/drone,/turf/open/ice{color = "#797979"},/area/template_noop)
"f" = (/obj/effect/alien/resin/sticky/thin,/turf/open/ice{color = "#797979"},/area/template_noop)
"i" = (/obj/effect/xenomorph/boiler_bombard,/turf/open/ice{color = "#797979"},/area/template_noop)
"m" = (/turf/closed/wall/mineral/bone_resin,/area/template_noop)
"t" = (/obj/effect/alien/resin/acid_pillar/strong,/turf/open/ice{color = "#797979"},/area/template_noop)
"u" = (/obj/effect/alien/resin/sticky/thin,/mob/living/carbon/xenomorph/drone,/turf/open/ice{color = "#797979"},/area/template_noop)
"y" = (/turf/open/ice{color = "#797979"},/area/template_noop)
"A" = (/obj/effect/alien/resin/sticky/thin,/obj/effect/xenomorph/boiler_bombard,/turf/open/ice{color = "#797979"},/area/template_noop)
"F" = (/obj/effect/xenomorph/boiler_bombard,/turf/template_noop,/area/template_noop)
"H" = (/obj/effect/alien/weeds/node,/obj/effect/alien/resin/sticky/thin,/obj/effect/xenomorph/boiler_bombard,/turf/open/ice{color = "#797979"},/area/template_noop)
"O" = (/mob/living/carbon/xenomorph/drone,/turf/open/ice{color = "#797979"},/area/template_noop)
"Q" = (/obj/effect/alien/resin/king_cocoon{pixel_y = -47},/turf/open/ice{color = "#797979"},/area/template_noop)
"T" = (/obj/effect/alien/egg,/turf/open/ice{color = "#797979"},/area/template_noop)
"U" = (/obj/effect/alien/resin/acid_pillar/strong,/obj/effect/xenomorph/boiler_bombard,/turf/open/ice{color = "#797979"},/area/template_noop)
"W" = (/obj/effect/alien/resin/shield_pillar,/turf/open/ice{color = "#797979"},/area/template_noop)
"X" = (/obj/effect/alien/weeds/node,/obj/effect/xenomorph/boiler_bombard,/turf/open/ice{color = "#797979"},/area/template_noop)

(1,1,1) = {"
aaaaaaaammmmaaaaaFmmaa
aaammmmaammmmmaaaFmmma
aammmmaaaamTTmmmFmmmaF
ammaaaaaammTyyymmmmiFa
ammaaaammmybtybyOiAXFa
ammmammmmTyfyTmyyfOiFF
aammmmTyyycffymmmfbmma
aammmmmyQyTcfbWmmOfmmm
aaaaammybyTmcyffuyAmmm
aaaaaammTcyyTffyfHeUmm
aaaaaaammmmmfbOftyieim
aaaaaammmmmmmTymiemiXF
ammaammmammmmmmmmmmmFa
ammmmmmaaaammmmmmmmmma
aammmmaaaaaaammmmmaFmm
"}
