//MAP CONVERTED BY dmm2tgm.py THIS HEADER COMMENT PREVENTS RECONVERSION, DO NOT REMOVE
"aE" = (
/obj/structure/machinery/light/small{
	dir = 8;
	pixel_x = -11;
	pixel_y = 10
	},
/turf/open/floor/plating/plating_catwalk,
/area/template_noop)
"aN" = (
/turf/closed/shuttle/ert{
	icon_state = "stan20"
	},
/area/template_noop)
"bh" = (
/turf/closed/wall/strata_ice/jungle{
	desc = "It is made of Fiberbush(tm). It contains asbestos.";
	name = "synthetic vegetation"
	},
/area/template_noop)
"bw" = (
/obj/structure/machinery/filtration/console{
	pixel_y = 22
	},
/turf/open/floor/almayer,
/area/template_noop)
"cn" = (
/obj/structure/inflatable,
/turf/open/floor/prison/floor_plate,
/area/template_noop)
"cT" = (
/obj/structure/machinery/light/small{
	dir = 8;
	pixel_x = -11;
	pixel_y = 10
	},
/obj/structure/surface/table/reinforced/prison,
/obj/effect/spawner/random/toolbox,
/obj/item/clothing/head/soft/ferret{
	pixel_y = 7
	},
/turf/open/floor/almayer/plate,
/area/template_noop)
"fN" = (
/obj/structure/largecrate/random/barrel{
	pixel_x = -1;
	pixel_y = 17
	},
/obj/structure/largecrate/random/barrel{
	pixel_x = 6;
	pixel_y = 3
	},
/obj/structure/largecrate/random/barrel{
	pixel_x = -18;
	pixel_y = -1
	},
/turf/open/floor/plating/plating_catwalk,
/area/template_noop)
"gc" = (
/obj/item/tool/wet_sign,
/turf/open/floor/almayer/plate,
/area/template_noop)
"gi" = (
/obj/structure/girder/displaced,
/turf/open/floor/plating/prison,
/area/template_noop)
"he" = (
/obj/structure/bed/chair/comfy{
	dir = 4
	},
/turf/open/organic/grass/astroturf,
/area/template_noop)
"hF" = (
/obj/structure/largecrate/random/barrel/red,
/turf/open/floor/almayer/plate,
/area/template_noop)
"hG" = (
/obj/structure/machinery/power/apc/power/south,
/turf/open/floor/almayer,
/area/template_noop)
"il" = (
/obj/structure/prop/structure_lattice{
	dir = 4
	},
/obj/structure/prop/structure_lattice{
	dir = 4;
	layer = 3.1;
	pixel_y = 10
	},
/turf/open/floor/prison/floor_plate,
/area/template_noop)
"iU" = (
/turf/open/floor/plating/plating_catwalk/prison,
/area/template_noop)
"jZ" = (
/turf/closed/shuttle/ert{
	icon_state = "rightengine_1";
	opacity = 0
	},
/area/template_noop)
"lI" = (
/obj/structure/largecrate/random/barrel{
	pixel_y = 12;
	layer = 3.1;
	pixel_x = -6
	},
/obj/structure/largecrate/random/barrel{
	layer = 3.1;
	pixel_x = 5
	},
/turf/open/floor/plating/plating_catwalk,
/area/template_noop)
"mz" = (
/obj/structure/surface/table/reinforced/prison,
/obj/item/clothing/accessory/storage/webbing,
/obj/item/clothing/under/marine/veteran/mercenary/support{
	layer = 2.9;
	pixel_y = 6
	},
/obj/item/clothing/head/helmet/marine/veteran/mercenary/support/engineer{
	pixel_y = 8;
	armor_bio = 25;
	armor_bomb = 10;
	armor_bullet = 20;
	armor_energy = 0;
	armor_internaldamage = 20;
	armor_melee = 20;
	armor_rad = 10;
	desc = "A sturdy helmet worn by an unknown mercenary group. Features a toggleable welding screen for eye protection. This one has seen better days, don't count on the protection you've heard from the rumors!"
	},
/obj/item/clothing/suit/storage/marine/veteran/mercenary/support{
	pixel_y = -4;
	armor_bio = 25;
	armor_bullet = 20;
	armor_energy = 0;
	armor_internaldamage = 25;
	armor_melee = 25;
	armor_rad = 15;
	desc = "A set of blue armor with yellow highlights built for protection while building or carrying out medical treatment in highly dangerous environments. It is a specialized uniform of an unknown mercenary group working in the sector. This one has seen better days, don't count on the protection you've heard from the rumors!"
	},
/obj/structure/machinery/defenses/sentry/premade/dumb{
	dir = 4
	},
/turf/open/floor/almayer,
/area/template_noop)
"nF" = (
/turf/closed/shuttle/ert,
/area/template_noop)
"oh" = (
/turf/open/floor/plating/prison,
/area/template_noop)
"om" = (
/obj/structure/machinery/light/small{
	dir = 8;
	pixel_x = -11;
	pixel_y = 10
	},
/obj/structure/largecrate/black_market/secured_wildlife,
/turf/open/floor/almayer,
/area/template_noop)
"oH" = (
/turf/open/floor/plating/plating_catwalk,
/area/template_noop)
"pw" = (
/obj/structure/surface/table/reinforced/prison,
/obj/structure/machinery/computer/med_data/laptop{
	dir = 1
	},
/turf/open/floor/plating/plating_catwalk,
/area/template_noop)
"pV" = (
/obj/structure/machinery/light/small{
	dir = 4;
	pixel_x = 11;
	pixel_y = 10
	},
/turf/open/floor/plating/plating_catwalk,
/area/template_noop)
"qI" = (
/turf/closed/shuttle/ert{
	icon_state = "stan22"
	},
/area/template_noop)
"rv" = (
/obj/structure/bed/chair/dropship/pilot{
	dir = 1
	},
/obj/structure/machinery/light/small{
	dir = 8;
	pixel_x = -11;
	pixel_y = 10
	},
/turf/open/floor/almayer,
/area/template_noop)
"rW" = (
/obj/structure/machinery/light/small{
	dir = 8;
	pixel_x = -11;
	pixel_y = 10
	},
/obj/structure/largecrate/supply/weapons/pistols,
/turf/open/floor/almayer/plate,
/area/template_noop)
"si" = (
/obj/structure/bed/chair/dropship/pilot,
/turf/open/floor/almayer/plate,
/area/template_noop)
"tp" = (
/turf/open/floor/almayer,
/area/template_noop)
"tC" = (
/obj/structure/barricade/metal/wired{
	dir = 4
	},
/turf/open/floor/almayer/plate,
/area/template_noop)
"tD" = (
/obj/structure/lattice,
/turf/open/space,
/area/template_noop)
"tZ" = (
/obj/item/tool/extinguisher/mini{
	pixel_x = 14;
	pixel_y = -14
	},
/turf/open/floor/almayer,
/area/template_noop)
"vh" = (
/obj/structure/surface/rack,
/obj/structure/machinery/light/small{
	dir = 8;
	pixel_x = -11;
	pixel_y = 10
	},
/obj/item/storage/firstaid/adv{
	pixel_x = 3;
	pixel_y = 5
	},
/obj/item/storage/firstaid/adv,
/obj/item/device/healthanalyzer{
	pixel_y = -9
	},
/turf/open/floor/almayer/plate,
/area/template_noop)
"wO" = (
/turf/closed/shuttle/ert{
	icon_state = "stan_leftengine"
	},
/area/template_noop)
"xR" = (
/turf/closed/shuttle/ert{
	icon_state = "stan5"
	},
/area/template_noop)
"xS" = (
/turf/closed/shuttle/ert{
	icon_state = "stan_white_t_up"
	},
/area/template_noop)
"xW" = (
/obj/structure/surface/table/reinforced/prison,
/obj/item/storage/toolbox/syndicate{
	pixel_x = -1;
	pixel_y = 7
	},
/obj/item/storage/toolbox/syndicate{
	pixel_x = -1;
	pixel_y = 1
	},
/turf/open/floor/almayer,
/area/template_noop)
"yv" = (
/obj/structure/sign/poster{
	pixel_y = 30
	},
/turf/open/floor/almayer,
/area/template_noop)
"yD" = (
/obj/structure/barricade/sandbags/wired{
	dir = 8
	},
/turf/open/floor/almayer/plate,
/area/template_noop)
"Ac" = (
/turf/open/floor/prison/floor_plate,
/area/template_noop)
"BC" = (
/turf/closed/shuttle/ert{
	icon_state = "stan9"
	},
/area/template_noop)
"Cc" = (
/obj/structure/surface/rack,
/obj/item/ammo_magazine/sentry/premade/dumb{
	pixel_x = -11;
	pixel_y = 3
	},
/obj/item/ammo_magazine/sentry/premade/dumb{
	pixel_x = 6;
	pixel_y = 3
	},
/turf/open/floor/almayer,
/area/template_noop)
"CG" = (
/obj/structure/sign/poster/clf{
	pixel_y = 30;
	pixel_x = -2
	},
/turf/open/floor/almayer,
/area/template_noop)
"CL" = (
/obj/structure/flora/bush/ausbushes/ausbush{
	desc = "Fiberbush(tm) infestations have been the leading cause in asbestos related deaths in spacecraft for 3 years in a row now.";
	icon_state = "fullgrass_2";
	name = "Fiberbush(tm) tubers"
	},
/turf/open/organic/grass/astroturf,
/area/template_noop)
"CM" = (
/turf/closed/shuttle/ert{
	icon_state = "leftengine_1";
	opacity = 0
	},
/area/template_noop)
"DS" = (
/turf/closed/shuttle/ert{
	icon_state = "stan27"
	},
/area/template_noop)
"EW" = (
/turf/closed/shuttle/ert{
	icon_state = "leftengine_3";
	opacity = 0
	},
/area/template_noop)
"Fx" = (
/obj/structure/barricade/metal/wired{
	dir = 4
	},
/obj/item/tool/pen/blue{
	pixel_x = -15;
	pixel_y = 2
	},
/turf/open/floor/almayer/plate,
/area/template_noop)
"Ge" = (
/obj/structure/machinery/door/airlock/prison_hatch/autoname,
/turf/open/floor/prison/floor_plate,
/area/template_noop)
"Hb" = (
/obj/structure/machinery/light/small{
	dir = 8;
	pixel_x = -11;
	pixel_y = 10
	},
/turf/open/floor/almayer,
/area/template_noop)
"HH" = (
/turf/closed/shuttle/ert{
	icon_state = "stan_l_w"
	},
/area/template_noop)
"Ia" = (
/turf/closed/shuttle/ert{
	icon_state = "stan8"
	},
/area/template_noop)
"Iu" = (
/obj/structure/sign/safety/bulkhead_door,
/turf/closed/wall/r_wall/prison_unmeltable,
/area/template_noop)
"Iv" = (
/obj/structure/largecrate/random/barrel/blue,
/turf/open/floor/almayer/plate,
/area/template_noop)
"IU" = (
/obj/structure/largecrate/random/barrel/yellow,
/turf/open/floor/almayer/plate,
/area/template_noop)
"Jg" = (
/turf/closed/shuttle/ert{
	icon_state = "stan1"
	},
/area/template_noop)
"Jv" = (
/obj/structure/barricade/metal/wired{
	dir = 4
	},
/obj/structure/barricade/plasteel/wired{
	dir = 1
	},
/turf/open/floor/almayer,
/area/template_noop)
"JA" = (
/obj/item/stack/sheet/metal,
/turf/open/floor/plating/plating_catwalk/prison,
/area/template_noop)
"Ki" = (
/obj/effect/landmark/survivor_spawner,
/turf/open/floor/plating/plating_catwalk,
/area/template_noop)
"Ky" = (
/obj/structure/bed,
/obj/item/bedsheet/blue,
/obj/effect/landmark/wo_supplies/guns/common/m41a,
/turf/open/floor/almayer,
/area/template_noop)
"KC" = (
/obj/structure/machinery/door/airlock/prison_hatch/autoname{
	dir = 1
	},
/turf/open/floor/plating/plating_catwalk,
/area/template_noop)
"KG" = (
/turf/closed/shuttle/ert{
	icon_state = "stan2"
	},
/area/template_noop)
"KO" = (
/obj/structure/machinery/door/airlock/prison_hatch/autoname,
/turf/open/floor/almayer/plating/northeast,
/area/template_noop)
"Ld" = (
/turf/open/space,
/area/template_noop)
"Lz" = (
/obj/structure/prop/invuln/fire{
	pixel_y = -15
	},
/turf/closed/shuttle/ert{
	icon_state = "stan22"
	},
/area/template_noop)
"LG" = (
/turf/closed/shuttle/ert{
	icon_state = "stan23"
	},
/area/template_noop)
"MB" = (
/obj/structure/machinery/light/small{
	dir = 4;
	pixel_x = 11;
	pixel_y = 10
	},
/obj/structure/sign/poster/safety{
	pixel_y = 29;
	pixel_x = 5
	},
/turf/open/floor/almayer/plate,
/area/template_noop)
"Ni" = (
/turf/open/organic/grass/astroturf,
/area/template_noop)
"Nm" = (
/obj/structure/prop/invuln/fire{
	pixel_y = -15
	},
/turf/closed/shuttle/ert{
	icon_state = "stan23"
	},
/area/template_noop)
"NR" = (
/obj/structure/machinery/light/small,
/obj/structure/machinery/defenses/sentry/premade/dumb{
	dir = 4
	},
/turf/open/floor/almayer/plate,
/area/template_noop)
"NV" = (
/turf/closed/wall/mineral/bone_resin,
/area/template_noop)
"Ox" = (
/obj/structure/largecrate/random/barrel{
	pixel_x = -6;
	pixel_y = 21
	},
/obj/structure/largecrate/random/barrel{
	pixel_x = 12;
	pixel_y = 17
	},
/obj/structure/largecrate/random/barrel{
	pixel_x = -7;
	pixel_y = -1
	},
/turf/open/floor/almayer/plate,
/area/template_noop)
"ON" = (
/turf/closed/shuttle/ert{
	icon_state = "stan_inner_w_1"
	},
/area/template_noop)
"OP" = (
/obj/structure/barricade/metal/wired{
	dir = 4
	},
/obj/item/paper_bin{
	pixel_x = -22;
	pixel_y = -2
	},
/obj/structure/barricade/metal/wired,
/turf/open/floor/plating/plating_catwalk,
/area/template_noop)
"Qz" = (
/obj/structure/machinery/light/small{
	dir = 8;
	pixel_x = -11;
	pixel_y = 10
	},
/obj/structure/largecrate/random/mini/ammo{
	pixel_y = 8;
	pixel_x = -9
	},
/obj/structure/largecrate/random/mini/ammo{
	pixel_y = -3;
	pixel_x = -9
	},
/obj/structure/largecrate/random/mini/ammo{
	pixel_y = 8;
	pixel_x = 8
	},
/obj/structure/largecrate/random/mini/ammo{
	pixel_y = -3;
	pixel_x = 7
	},
/obj/structure/largecrate/random/mini/ammo{
	pixel_y = 7;
	pixel_x = -1
	},
/turf/open/floor/almayer/plate,
/area/template_noop)
"Sh" = (
/obj/structure/machinery/light/small{
	dir = 4;
	pixel_x = 11;
	pixel_y = 10
	},
/obj/structure/surface/rack,
/obj/item/tank/oxygen,
/turf/open/floor/plating/plating_catwalk,
/area/template_noop)
"ST" = (
/obj/structure/surface/table/reinforced/prison{
	icon_state = "prisonflip2";
	dir = 4
	},
/turf/open/floor/almayer,
/area/template_noop)
"Ug" = (
/obj/structure/machinery/door/airlock/prison_hatch/autoname{
	dir = 1
	},
/turf/open/floor/almayer/plate,
/area/template_noop)
"Uh" = (
/turf/closed/shuttle/ert{
	icon_state = "stan3"
	},
/area/template_noop)
"UJ" = (
/turf/closed/shuttle/ert{
	icon_state = "stan_inner_w_2"
	},
/area/template_noop)
"UQ" = (
/turf/closed/shuttle/ert{
	icon_state = "stan_inner_t_right"
	},
/area/template_noop)
"Vh" = (
/turf/closed/wall/r_wall/prison_unmeltable,
/area/template_noop)
"Vn" = (
/turf/open/floor/almayer/plate,
/area/template_noop)
"VD" = (
/obj/structure/bed,
/obj/item/bedsheet/rd,
/obj/item/toy/katana,
/obj/structure/sign/poster/pinup{
	pixel_y = 30
	},
/turf/open/floor/almayer,
/area/template_noop)
"VW" = (
/obj/structure/surface/table/reinforced/prison,
/obj/structure/machinery/computer{
	icon_state = "security_det";
	name = "Shuttle control deck";
	pixel_y = 6
	},
/obj/structure/machinery/light/small{
	dir = 8;
	pixel_x = -11;
	pixel_y = 10
	},
/obj/item/coin/uranium{
	desc = "You found one of the three uranium coins. It is entirely worthless."
	},
/obj/item/storage/fancy/cigar/tarbacks{
	pixel_x = -11
	},
/obj/structure/prop/invuln/fire{
	pixel_y = 1
	},
/turf/open/floor/almayer,
/area/template_noop)
"Wd" = (
/turf/closed/shuttle/ert{
	icon_state = "rightengine_3";
	opacity = 0
	},
/area/template_noop)
"Wf" = (
/obj/structure/closet/secure_closet/engineering_personal,
/turf/open/floor/almayer/plate,
/area/template_noop)
"Wt" = (
/turf/closed/shuttle/ert{
	icon_state = "stan_rightengine"
	},
/area/template_noop)
"WN" = (
/turf/closed/shuttle/ert{
	icon_state = "stan25"
	},
/area/template_noop)
"Xf" = (
/turf/closed/shuttle/ert{
	icon_state = "stan_inner_s_w"
	},
/area/template_noop)
"Xm" = (
/obj/structure/largecrate/random/barrel/white,
/turf/open/floor/plating/prison,
/area/template_noop)
"Yj" = (
/turf/closed/shuttle/ert{
	icon_state = "stan_r_w"
	},
/area/template_noop)
"YV" = (
/obj/structure/machinery/cm_vending/sorted/medical/wall_med/limited{
	pixel_y = 25
	},
/obj/item/device/flashlight/lamp{
	pixel_x = -11
	},
/turf/open/floor/plating/plating_catwalk,
/area/template_noop)

(1,1,1) = {"
NV
Ld
Ld
Ld
NV
NV
tD
Ld
aN
nF
nF
Yj
nF
nF
Jg
Ld
Ld
Ld
Ld
Ld
Ld
"}
(2,1,1) = {"
NV
NV
Ld
Ld
NV
NV
tD
Ld
DS
aE
Cc
ON
Ox
Qz
KG
Ld
Ld
Ld
Ld
Ld
Ld
"}
(3,1,1) = {"
NV
NV
Ld
NV
NV
NV
NV
Ld
DS
Ki
tp
Ug
fN
lI
UQ
nF
Jg
Ld
Ld
Ld
Ld
"}
(4,1,1) = {"
NV
NV
NV
NV
aN
nF
nF
Yj
qI
oH
gc
xS
UJ
UJ
Xf
om
Ia
Jg
Ld
Ld
Ld
"}
(5,1,1) = {"
NV
NV
NV
aN
qI
vh
hF
ON
rW
Vn
tp
ON
Iv
cT
ON
yD
IU
Ia
wO
EW
CM
"}
(6,1,1) = {"
NV
NV
aN
qI
si
pw
oH
ON
yv
oH
Vn
KC
oH
oH
KC
oH
Vn
BC
Wt
Wd
jZ
"}
(7,1,1) = {"
aN
nF
Lz
bw
oH
tp
tp
ON
Vn
xW
hG
ON
VD
Ky
ON
tp
Vn
KG
NV
NV
Ld
"}
(8,1,1) = {"
DS
VW
rv
tZ
oH
oH
Vn
ON
YV
mz
Vn
xS
UJ
UJ
qI
CG
NR
KG
NV
NV
NV
"}
(9,1,1) = {"
WN
xR
Nm
bw
Vn
tp
tp
KC
tC
ST
OP
Ug
tp
tp
Hb
Jv
tC
KG
NV
NV
NV
"}
(10,1,1) = {"
NV
NV
WN
LG
MB
oH
oH
ON
Fx
pV
tC
ON
Sh
oH
oH
oH
oH
Ia
wO
EW
CM
"}
(11,1,1) = {"
NV
NV
NV
WN
LG
Wf
BC
HH
KO
xR
KO
HH
LG
Vn
tC
tC
Vn
BC
Wt
Wd
jZ
"}
(12,1,1) = {"
bh
NV
NV
NV
WN
xR
Uh
cn
iU
Ac
iU
cn
WN
xR
KO
KO
xR
Uh
NV
NV
NV
"}
(13,1,1) = {"
bh
NV
NV
NV
NV
NV
il
cn
JA
Ac
iU
cn
il
oh
oh
oh
oh
il
NV
NV
NV
"}
(14,1,1) = {"
CL
NV
Ni
he
Ni
Ac
Ac
Iu
Ge
Vh
Ge
Iu
Xm
oh
oh
gi
oh
oh
oh
bh
bh
"}
