//MAP CONVERTED BY dmm2tgm.py THIS HEADER COMMENT PREVENTS RECONVERSION, DO NOT REMOVE
"aA" = (
/obj/effect/landmark/monkey_spawn,
/turf/open/floor/prison,
/area/template_noop)
"aU" = (
/obj/structure/bed/chair/comfy,
/obj/effect/decal/cleanable/blood,
/obj/effect/landmark/corpsespawner/engineer,
/turf/open/floor/prison/darkpurple2,
/area/template_noop)
"bh" = (
/obj/structure/bed/chair{
	dir = 8
	},
/obj/effect/decal/cleanable/blood/oil/streak,
/obj/effect/landmark/corpsespawner/prisoner,
/turf/open/floor/prison/darkpurplefull2,
/area/template_noop)
"da" = (
/turf/closed/wall/r_wall/prison_unmeltable,
/area/template_noop)
"dv" = (
/obj/structure/surface/table/reinforced/prison,
/obj/structure/machinery/computer/cameras{
	dir = 1
	},
/turf/open/floor/prison,
/area/template_noop)
"dM" = (
/obj/structure/machinery/door/airlock/prison_hatch/autoname,
/turf/open/floor/prison/floor_plate,
/area/template_noop)
"ew" = (
/obj/structure/prop/dam/crane,
/turf/open/floor/prison/floor_marked/west,
/area/template_noop)
"gd" = (
/obj/structure/machinery/light/double/blue{
	dir = 1;
	pixel_y = 21
	},
/obj/item/device/flashlight/lamp/tripod,
/turf/open/floor/prison/darkpurplefull2,
/area/template_noop)
"gB" = (
/obj/structure/surface/table/reinforced/prison,
/obj/structure/machinery/computer/communications{
	dir = 4;
	icon_state = "commb";
	layer = 4
	},
/obj/item/reagent_container/food/drinks/cans/boda{
	pixel_y = 9;
	pixel_x = 9
	},
/turf/open/floor/prison,
/area/template_noop)
"hy" = (
/obj/structure/surface/table/reinforced/prison,
/obj/structure/machinery/faxmachine,
/turf/open/floor/prison/floor_plate,
/area/template_noop)
"hI" = (
/obj/structure/surface/table/reinforced/prison,
/obj/structure/machinery/computer/communications{
	dir = 4;
	icon_state = "commb";
	layer = 4
	},
/obj/item/reagent_container/food/drinks/cans/dr_gibb{
	pixel_y = 10
	},
/turf/open/floor/prison/darkpurple2/north,
/area/template_noop)
"ic" = (
/obj/structure/surface/table/reinforced/prison,
/obj/item/newspaper,
/turf/open/floor/prison/floor_plate,
/area/template_noop)
"jx" = (
/obj/structure/machinery/light/double/blue{
	dir = 4;
	pixel_x = 10;
	pixel_y = 13
	},
/obj/structure/machinery/computer3/server/rack,
/turf/open/floor/prison/darkpurplefull2,
/area/template_noop)
"jF" = (
/obj/structure/surface/table/reinforced/prison,
/obj/structure/machinery/computer/communications{
	dir = 4;
	icon_state = "commb"
	},
/turf/open/floor/prison/darkpurple2/southeast,
/area/template_noop)
"kx" = (
/obj/effect/decal/cleanable/blood/oil/streak,
/turf/open/floor/prison/darkpurple2/north,
/area/template_noop)
"kU" = (
/obj/structure/machinery/deployable/barrier,
/turf/open/floor/plating/prison,
/area/template_noop)
"na" = (
/obj/structure/surface/table/reinforced/prison,
/turf/open/floor/prison,
/area/template_noop)
"nr" = (
/turf/open/floor/prison/darkpurple2,
/area/template_noop)
"nD" = (
/obj/item/trash/chunk,
/turf/open/floor/prison/floor_marked/west,
/area/template_noop)
"nV" = (
/turf/open/floor/prison/darkpurple2/southwest,
/area/template_noop)
"oy" = (
/obj/structure/surface/table/reinforced/prison,
/turf/open/floor/prison/darkpurple2/northwest,
/area/template_noop)
"pf" = (
/turf/open/floor/prison/floor_marked/west,
/area/template_noop)
"pl" = (
/obj/structure/machinery/light/double/blue{
	dir = 8;
	pixel_x = -10;
	pixel_y = 13
	},
/turf/open/floor/prison/darkpurplefull2,
/area/template_noop)
"pF" = (
/obj/structure/surface/table/reinforced/prison,
/obj/structure/machinery/computer/communications{
	dir = 4;
	icon_state = "commb"
	},
/obj/item/holder/mouse{
	pixel_x = 4;
	pixel_y = 18;
	desc = "Wait, why won't it work with my computer?"
	},
/turf/open/floor/prison/darkpurplefull2,
/area/template_noop)
"qt" = (
/turf/open/floor/prison/cell_stripe/east,
/area/template_noop)
"qE" = (
/obj/structure/machinery/deployable/barrier,
/turf/open/floor/prison/darkpurple2/southwest,
/area/template_noop)
"rk" = (
/obj/structure/bed/chair{
	dir = 8
	},
/turf/open/floor/prison/darkpurple2/northeast,
/area/template_noop)
"sV" = (
/obj/structure/computer3frame,
/turf/open/floor/prison/darkpurplefull2,
/area/template_noop)
"uj" = (
/obj/effect/decal/cleanable/blood/oil,
/obj/structure/machinery/deployable/barrier,
/turf/open/floor/prison/cell_stripe/east,
/area/template_noop)
"vn" = (
/obj/structure/bed/chair{
	dir = 8
	},
/obj/effect/decal/cleanable/blood,
/obj/effect/landmark/corpsespawner/prisoner,
/turf/open/floor/prison/darkpurple2/west,
/area/template_noop)
"xP" = (
/obj/structure/bed/chair{
	dir = 4
	},
/obj/effect/landmark/corpsespawner/ua_riot,
/turf/open/floor/prison/darkpurple2/east,
/area/template_noop)
"yx" = (
/obj/item/trash/wy_chips_pepper,
/turf/open/floor/prison/darkpurplefull2,
/area/template_noop)
"yO" = (
/obj/item/stock_parts/manipulator/pico,
/turf/open/floor/prison/darkpurple2,
/area/template_noop)
"yS" = (
/turf/closed/wall/prison,
/area/template_noop)
"Cu" = (
/obj/structure/bed/chair{
	dir = 4
	},
/obj/effect/decal/cleanable/blood,
/turf/open/floor/prison/floor_marked/west,
/area/template_noop)
"Dd" = (
/turf/open/floor/prison/darkpurple2/north,
/area/template_noop)
"El" = (
/obj/structure/bed/chair{
	dir = 4
	},
/turf/open/floor/prison,
/area/template_noop)
"Fp" = (
/turf/open/floor/prison,
/area/template_noop)
"HL" = (
/turf/open/floor/prison/darkpurple2/northeast,
/area/template_noop)
"Ij" = (
/obj/item/trash/pistachios,
/turf/open/floor/prison/darkpurplefull2,
/area/template_noop)
"Jf" = (
/obj/structure/bed/chair/comfy,
/turf/open/floor/prison/darkpurple2,
/area/template_noop)
"Ka" = (
/obj/structure/prop/structure_lattice{
	dir = 4;
	health = 300
	},
/obj/structure/prop/structure_lattice{
	dir = 4;
	layer = 3.1;
	pixel_y = 10
	},
/turf/open/floor/prison/floor_plate,
/area/template_noop)
"Kt" = (
/obj/structure/surface/table/reinforced/prison,
/obj/structure/machinery/computer/communications{
	dir = 8;
	icon_state = "commb"
	},
/obj/item/device/encryptionkey/WY{
	pixel_x = 4;
	pixel_y = -8
	},
/turf/open/floor/prison/floor_marked/west,
/area/template_noop)
"Li" = (
/obj/structure/bed/chair{
	dir = 4
	},
/obj/effect/landmark/corpsespawner/ua_riot/burst,
/turf/open/floor/prison/darkpurplefull2,
/area/template_noop)
"Lx" = (
/obj/structure/surface/table/reinforced/prison,
/obj/item/trash/chips,
/turf/open/floor/prison/darkpurple2/northeast,
/area/template_noop)
"LH" = (
/obj/structure/surface/table/reinforced/prison,
/obj/structure/machinery/computer/communications{
	dir = 8;
	icon_state = "commb";
	layer = 4
	},
/obj/item/reagent_container/food/drinks/cans/souto/blue{
	pixel_x = 8;
	pixel_y = 16
	},
/turf/open/floor/prison/darkpurplefull2,
/area/template_noop)
"LI" = (
/obj/structure/surface/table/reinforced/prison,
/obj/structure/machinery/computer/communications{
	dir = 8;
	icon_state = "commb"
	},
/turf/open/floor/prison/darkpurplefull2,
/area/template_noop)
"MN" = (
/obj/structure/machinery/light/double/blue{
	dir = 1;
	pixel_y = 21
	},
/turf/open/floor/prison/darkpurplefull2,
/area/template_noop)
"Nd" = (
/obj/structure/machinery/computer3/server/rack,
/turf/open/floor/prison/darkpurplefull2,
/area/template_noop)
"NA" = (
/obj/structure/machinery/deployable/barrier,
/turf/open/floor/prison/floor_plate,
/area/template_noop)
"OC" = (
/obj/structure/machinery/light/double/blue{
	dir = 4;
	pixel_x = 10;
	pixel_y = -3
	},
/turf/open/floor/prison/darkpurplefull2,
/area/template_noop)
"OG" = (
/turf/closed/wall/mineral/bone_resin,
/area/template_noop)
"OH" = (
/obj/structure/bed/chair{
	dir = 8
	},
/turf/open/floor/prison,
/area/template_noop)
"OT" = (
/obj/structure/bed/chair{
	dir = 4
	},
/obj/effect/decal/cleanable/blood/oil/streak,
/turf/open/floor/prison/darkpurplefull2,
/area/template_noop)
"Pw" = (
/turf/open/floor/prison/darkpurplefull2,
/area/template_noop)
"Qw" = (
/obj/structure/surface/table/reinforced/prison,
/obj/structure/machinery/computer/cameras{
	dir = 1
	},
/obj/item/holder/mouse{
	pixel_x = 12;
	pixel_y = 12;
	desc = "Wait, why won't it work with my computer?"
	},
/turf/open/floor/prison,
/area/template_noop)
"RC" = (
/obj/structure/machinery/deployable/barrier,
/turf/open/floor/prison/darkpurple2/southeast,
/area/template_noop)
"RW" = (
/turf/open/floor/bluegrid,
/area/template_noop)
"RX" = (
/turf/open/floor/prison/darkpurple2/southeast,
/area/template_noop)
"Sk" = (
/turf/open/floor/prison/floor_plate,
/area/template_noop)
"Tb" = (
/obj/structure/bed/chair{
	dir = 8
	},
/turf/open/floor/prison/darkpurplefull2,
/area/template_noop)
"TR" = (
/obj/effect/decal/cleanable/blood/oil/streak,
/turf/open/floor/prison/darkpurplefull2,
/area/template_noop)
"UK" = (
/turf/open/floor/prison/darkpurple2/northwest,
/area/template_noop)
"Vu" = (
/obj/structure/surface/table/reinforced/prison,
/obj/structure/machinery/computer/communications{
	dir = 4;
	icon_state = "commb"
	},
/turf/open/floor/prison/darkpurplefull2,
/area/template_noop)
"VZ" = (
/obj/structure/surface/table/reinforced/prison,
/obj/structure/machinery/computer/communications{
	dir = 8;
	icon_state = "commb"
	},
/obj/item/reagent_container/food/drinks/cans/classcola{
	pixel_x = -10;
	pixel_y = 17
	},
/turf/open/floor/prison,
/area/template_noop)
"Wa" = (
/obj/structure/surface/table/reinforced/prison,
/obj/structure/machinery/computer/communications{
	dir = 8;
	icon_state = "commb";
	layer = 2.99
	},
/turf/open/floor/prison/darkpurple2/southwest,
/area/template_noop)
"Xb" = (
/obj/structure/machinery/deployable/barrier,
/turf/open/floor/prison/darkpurple2,
/area/template_noop)
"Za" = (
/obj/structure/surface/table/reinforced/prison,
/obj/item/reagent_container/food/drinks/golden_cup{
	pixel_y = 11
	},
/turf/open/floor/prison,
/area/template_noop)

(1,1,1) = {"
da
yS
yS
yS
Ka
kU
NA
kU
Ka
yS
yS
yS
yS
"}
(2,1,1) = {"
yS
Nd
Pw
Ij
Pw
Pw
Pw
Pw
Sk
Sk
pl
hy
ic
"}
(3,1,1) = {"
yS
MN
Fp
Pw
xP
OT
El
Li
Cu
pf
Pw
pf
ew
"}
(4,1,1) = {"
yS
sV
Pw
oy
VZ
Wa
LH
LI
Kt
nD
Pw
pf
pf
"}
(5,1,1) = {"
yS
Pw
nr
Za
RW
RW
RW
RW
RW
qt
Pw
qt
uj
"}
(6,1,1) = {"
yS
TR
Jf
Qw
RW
RW
RW
RW
RW
nV
Fp
UK
qE
"}
(7,1,1) = {"
kU
Pw
aU
dv
RW
RW
RW
RW
RW
nr
Fp
Dd
Xb
"}
(8,1,1) = {"
Ka
Pw
yO
na
RW
RW
RW
RW
RW
nr
aA
Dd
Xb
"}
(9,1,1) = {"
Ka
Pw
Pw
Lx
gB
jF
pF
Vu
hI
nr
Fp
kx
Xb
"}
(10,1,1) = {"
yS
gd
Fp
Pw
vn
Tb
OH
bh
rk
RX
OG
HL
RC
"}
(11,1,1) = {"
yS
jx
TR
Pw
Pw
OC
Pw
yx
OG
OG
OG
OG
OG
"}
(12,1,1) = {"
da
da
dM
dM
dM
yS
da
OG
OG
OG
OG
OG
OG
"}
