//MAP CONVERTED BY dmm2tgm.py THIS HEADER COMMENT PREVENTS RECONVERSION, DO NOT REMOVE
"af" = (
/turf/open/floor/prison/whitegreen/northeast,
/area/template_noop)
"at" = (
/obj/structure/largecrate/supply/supplies/tables_racks,
/turf/open/floor/prison/whitegreen,
/area/template_noop)
"aL" = (
/obj/effect/decal/cleanable/vomit,
/turf/open/floor/prison/sterile_white/southwest,
/area/template_noop)
"bv" = (
/obj/structure/stairs/perspective{
	dir = 4;
	icon_state = "p_stair_sn_full_cap"
	},
/obj/structure/platform{
	dir = 4
	},
/turf/open/floor/plating/prison,
/area/template_noop)
"bH" = (
/obj/structure/bed/chair{
	dir = 4;
	pixel_y = 4
	},
/turf/open/floor/prison/whitegreenfull/southwest,
/area/template_noop)
"bI" = (
/obj/structure/platform{
	dir = 1
	},
/obj/effect/decal/cleanable/blood/drip,
/obj/structure/largecrate/random/barrel,
/turf/open/floor/prison/whitegreen/north,
/area/template_noop)
"bZ" = (
/obj/structure/platform_decoration{
	dir = 8
	},
/obj/structure/platform_decoration{
	dir = 4;
	layer = 2.8
	},
/turf/open/floor/prison/whitegreen/north,
/area/template_noop)
"cl" = (
/obj/structure/platform_decoration{
	dir = 1
	},
/obj/structure/inflatable,
/turf/open/floor/prison/whitegreen,
/area/template_noop)
"cO" = (
/obj/structure/machinery/door/airlock/almayer/marine{
	icon = 'icons/obj/structures/doors/prepdoor_charlie.dmi';
	icon_state = "door_open"
	},
/turf/open/floor/plating/prison,
/area/template_noop)
"ds" = (
/obj/structure/inflatable,
/turf/open/floor/prison/whitegreencorner,
/area/template_noop)
"dG" = (
/obj/structure/platform{
	dir = 1;
	layer = 2.8
	},
/obj/structure/largecrate/random/barrel{
	pixel_x = -8;
	layer = 2.9
	},
/obj/structure/largecrate/random/barrel{
	pixel_x = 13;
	layer = 2.9
	},
/obj/structure/largecrate/random/barrel{
	pixel_x = 3;
	layer = 2.9;
	pixel_y = -8
	},
/turf/open/floor/prison/whitegreen/north,
/area/template_noop)
"eP" = (
/obj/effect/decal/cleanable/blood,
/turf/open/floor/prison/sterile_white/southwest,
/area/template_noop)
"fz" = (
/obj/effect/decal/cleanable/blood/drip,
/turf/open/floor/prison/sterile_white/southwest,
/area/template_noop)
"fN" = (
/obj/effect/decal/medical_decals{
	icon_state = "triagedecalbottom"
	},
/obj/structure/inflatable/popped,
/turf/open/floor/prison/whitegreen/west,
/area/template_noop)
"go" = (
/obj/structure/sign/prop3{
	desc = "Enlist in the Penal Battalions today! The USCM 3rd Fleet features a subset of UA sanctioned penal battalions, drawing from inmate popualtions across the colonies. Mostly New Argentina though."
	},
/turf/closed/wall/r_wall/prison_unmeltable,
/area/template_noop)
"gA" = (
/turf/open/floor/prison/whitegreen/west,
/area/template_noop)
"hp" = (
/obj/structure/largecrate/random/case/double{
	pixel_y = 8
	},
/obj/structure/largecrate/random/case/double{
	pixel_y = -4
	},
/obj/structure/largecrate/random/case/double{
	pixel_y = -18
	},
/turf/open/floor/prison/sterile_white/southwest,
/area/template_noop)
"iD" = (
/obj/structure/surface/table/reinforced/prison,
/obj/item/book/manual/surgery{
	pixel_y = 4
	},
/obj/item/storage/surgical_tray,
/turf/open/floor/prison/whitegreenfull/southwest,
/area/template_noop)
"iG" = (
/obj/structure/inflatable/door,
/turf/open/floor/prison/whitegreencorner/east,
/area/template_noop)
"iK" = (
/obj/structure/janitorialcart,
/turf/open/floor/prison,
/area/template_noop)
"iR" = (
/obj/structure/machinery/door/airlock/almayer/maint/colony/autoname{
	dir = 1;
	req_one_access = null
	},
/turf/open/floor/plating/prison,
/area/template_noop)
"jc" = (
/obj/structure/bed/roller,
/obj/structure/machinery/iv_drip{
	pixel_y = 19
	},
/obj/item/bedsheet/medical,
/turf/open/floor/prison/sterile_white/southwest,
/area/template_noop)
"ju" = (
/obj/structure/machinery/light/double/blue,
/turf/open/floor/prison/whitegreen,
/area/template_noop)
"jw" = (
/obj/structure/surface/table/reinforced/prison,
/obj/structure/machinery/light/double/blue{
	dir = 4;
	pixel_x = 10;
	pixel_y = -3
	},
/obj/item/storage/beer_pack{
	pixel_y = 6;
	layer = 3.1
	},
/turf/open/floor/prison/whitegreen/southeast,
/area/template_noop)
"kE" = (
/turf/closed/wall/prison,
/area/template_noop)
"la" = (
/obj/structure/machinery/light/double/blue{
	dir = 4;
	pixel_x = 10;
	pixel_y = 13
	},
/turf/open/floor/prison/whitegreen/east,
/area/template_noop)
"lf" = (
/obj/structure/inflatable/popped/door,
/turf/open/floor/prison/whitegreencorner,
/area/template_noop)
"lA" = (
/obj/structure/surface/table/reinforced/prison,
/obj/item/storage/fancy/vials/random,
/turf/open/floor/prison/whitegreenfull/southwest,
/area/template_noop)
"lH" = (
/obj/effect/landmark/monkey_spawn,
/turf/open/floor/prison/sterile_white/southwest,
/area/template_noop)
"mU" = (
/obj/structure/bed/roller,
/obj/structure/machinery/iv_drip{
	pixel_y = 19
	},
/obj/item/bedsheet/medical,
/obj/effect/decal/cleanable/vomit,
/turf/open/floor/prison/sterile_white/southwest,
/area/template_noop)
"mV" = (
/obj/structure/inflatable/popped,
/turf/open/floor/prison/whitegreencorner/west,
/area/template_noop)
"na" = (
/obj/effect/decal/medical_decals{
	icon_state = "triagedecalleft"
	},
/obj/structure/inflatable,
/turf/open/floor/prison/sterile_white/southwest,
/area/template_noop)
"nj" = (
/obj/structure/bed/chair/janicart,
/turf/open/floor/prison,
/area/template_noop)
"nv" = (
/obj/structure/inflatable,
/turf/open/floor/prison/whitegreen,
/area/template_noop)
"oh" = (
/obj/structure/inflatable,
/turf/open/floor/prison/whitegreenfull/southwest,
/area/template_noop)
"om" = (
/obj/structure/surface/table/reinforced/prison,
/obj/structure/machinery/computer/cameras{
	dir = 8
	},
/obj/structure/window/reinforced{
	dir = 4
	},
/obj/item/handset{
	pixel_x = -3;
	pixel_y = 13
	},
/turf/open/floor/plating/prison,
/area/template_noop)
"pA" = (
/obj/structure/platform{
	dir = 8
	},
/obj/effect/decal/medical_decals{
	icon_state = "triagedecalbottomleft"
	},
/obj/structure/inflatable,
/turf/open/floor/prison/whitegreenfull/southwest,
/area/template_noop)
"qp" = (
/obj/effect/decal/cleanable/blood/oil,
/turf/open/floor/prison/whitegreenfull/southwest,
/area/template_noop)
"qB" = (
/obj/structure/bed/chair{
	layer = 2.7;
	dir = 4
	},
/turf/open/floor/prison/whitegreen,
/area/template_noop)
"rf" = (
/obj/structure/bed/chair{
	dir = 4;
	layer = 2.7
	},
/turf/open/floor/prison/sterile_white/southwest,
/area/template_noop)
"rm" = (
/obj/structure/inflatable/door,
/turf/open/floor/prison/whitegreen/east,
/area/template_noop)
"sf" = (
/obj/structure/largecrate/random/case/double{
	pixel_y = 8;
	pixel_x = -5
	},
/obj/structure/largecrate/random/case/double{
	pixel_y = -4;
	pixel_x = -5
	},
/obj/structure/largecrate/random/case/double{
	pixel_y = -17;
	pixel_x = -5
	},
/turf/open/floor/prison/sterile_white/southwest,
/area/template_noop)
"sK" = (
/obj/structure/largecrate/random,
/obj/effect/decal/medical_decals{
	icon_state = "triagedecalbottomright"
	},
/obj/item/reagent_container/food/drinks/coffee{
	pixel_y = 13
	},
/turf/open/floor/prison/whitegreenfull/southwest,
/area/template_noop)
"tD" = (
/obj/structure/largecrate/supply/supplies/water,
/turf/open/floor/prison/whitegreen/west,
/area/template_noop)
"uj" = (
/obj/structure/inflatable,
/turf/open/floor/prison/whitegreen/east,
/area/template_noop)
"vo" = (
/obj/structure/platform_decoration{
	dir = 4
	},
/obj/effect/decal/medical_decals{
	icon_state = "triagedecalleft"
	},
/obj/structure/inflatable,
/turf/open/floor/prison/whitegreen/north,
/area/template_noop)
"vq" = (
/obj/structure/largecrate/random/barrel/yellow{
	pixel_x = 6;
	pixel_y = -11;
	layer = 2.8
	},
/obj/structure/largecrate/random/barrel/yellow{
	pixel_x = -13;
	pixel_y = -4;
	layer = 2.9
	},
/obj/structure/largecrate/random/barrel/yellow{
	pixel_x = 6;
	pixel_y = 6;
	layer = 2.7
	},
/turf/open/floor/prison/sterile_white/southwest,
/area/template_noop)
"vS" = (
/obj/structure/flora/pottedplant{
	icon_state = "pottedplant_22"
	},
/turf/open/floor/prison/whitegreen/west,
/area/template_noop)
"vV" = (
/obj/effect/decal/prints{
	pixel_y = -10
	},
/turf/open/floor/prison/sterile_white/southwest,
/area/template_noop)
"wO" = (
/obj/item/storage/pill_bottle/tramadol/skillless,
/turf/open/floor/prison/sterile_white/southwest,
/area/template_noop)
"yr" = (
/turf/open/floor/prison/whitegreen/east,
/area/template_noop)
"yM" = (
/obj/item/ammo_casing{
	icon_state = "cartridge_1"
	},
/turf/open/floor/prison/whitegreenfull/southwest,
/area/template_noop)
"zK" = (
/obj/structure/surface/table/reinforced/prison,
/obj/structure/machinery/door/window/eastright,
/obj/item/reagent_container/food/drinks/coffeecup{
	pixel_x = 7;
	pixel_y = 14
	},
/turf/open/floor/plating/prison,
/area/template_noop)
"zL" = (
/obj/structure/inflatable/popped/door,
/turf/open/floor/prison/whitegreenfull/southwest,
/area/template_noop)
"AP" = (
/obj/effect/decal/medical_decals{
	icon_state = "triagedecalbottom"
	},
/obj/structure/inflatable,
/turf/open/floor/prison/sterile_white/southwest,
/area/template_noop)
"Bc" = (
/obj/structure/largecrate/supply/medicine/medkits,
/turf/open/floor/prison/sterile_white/southwest,
/area/template_noop)
"BI" = (
/turf/open/floor/prison/whitegreencorner/west,
/area/template_noop)
"CA" = (
/obj/structure/extinguisher_cabinet,
/turf/closed/wall/r_wall/prison_unmeltable,
/area/template_noop)
"DI" = (
/turf/open/floor/prison/sterile_white/southwest,
/area/template_noop)
"Ec" = (
/obj/effect/decal/medical_decals{
	icon_state = "triagedecalbottom"
	},
/obj/structure/inflatable/popped,
/turf/open/floor/prison/sterile_white/southwest,
/area/template_noop)
"Es" = (
/obj/item/reagent_container/glass/bucket/mopbucket,
/obj/item/tool/mop,
/turf/open/floor/prison,
/area/template_noop)
"EZ" = (
/obj/structure/machinery/shower{
	pixel_y = 13
	},
/turf/open/floor/plating/plating_catwalk/prison,
/area/template_noop)
"Fn" = (
/obj/structure/bed/roller,
/obj/structure/machinery/iv_drip{
	pixel_y = 19
	},
/obj/item/bedsheet/medical,
/obj/effect/decal/cleanable/blood,
/obj/effect/decal/cleanable/greenglow,
/turf/open/floor/prison/sterile_white/southwest,
/area/template_noop)
"Gk" = (
/obj/structure/platform{
	dir = 1
	},
/obj/structure/largecrate/random/barrel,
/obj/structure/largecrate/random/barrel{
	pixel_x = 16;
	layer = 3.1;
	pixel_y = -4
	},
/turf/open/floor/prison/whitegreen/north,
/area/template_noop)
"GI" = (
/obj/structure/stairs/perspective,
/obj/structure/platform{
	dir = 8
	},
/obj/structure/platform{
	dir = 4
	},
/obj/structure/inflatable/door,
/turf/open/floor/plating/prison,
/area/template_noop)
"GT" = (
/obj/structure/machinery/cryo_cell,
/turf/open/floor/plating/plating_catwalk/prison,
/area/template_noop)
"HL" = (
/obj/structure/machinery/cm_vending/sorted/medical/no_access,
/obj/structure/machinery/light/double/blue,
/turf/open/floor/prison/sterile_white/southwest,
/area/template_noop)
"Ip" = (
/obj/structure/machinery/light/double/blue{
	dir = 4;
	pixel_x = 10;
	pixel_y = -3
	},
/obj/structure/largecrate/supply/medicine/blood,
/turf/open/floor/prison/whitegreen/east,
/area/template_noop)
"IJ" = (
/obj/structure/bed/chair{
	dir = 8;
	layer = 2.7
	},
/turf/open/floor/prison/sterile_white/southwest,
/area/template_noop)
"IR" = (
/turf/open/floor/prison/whitegreen/southwest,
/area/template_noop)
"IZ" = (
/obj/structure/inflatable/popped,
/turf/open/floor/prison/whitegreen/east,
/area/template_noop)
"Kk" = (
/obj/structure/machinery/door/airlock/almayer/marine{
	icon = 'icons/obj/structures/doors/prepdoor_charlie.dmi'
	},
/turf/open/floor/plating/prison,
/area/template_noop)
"Lw" = (
/obj/effect/decal/cleanable/blood/drip,
/obj/structure/machinery/defenses/bell_tower/md,
/turf/open/floor/prison/sterile_white/southwest,
/area/template_noop)
"Ly" = (
/obj/effect/decal/cleanable/vomit,
/turf/open/floor/prison/whitegreen/north,
/area/template_noop)
"LW" = (
/obj/structure/inflatable,
/turf/open/floor/prison/sterile_white/southwest,
/area/template_noop)
"Nb" = (
/obj/structure/largecrate/supply/supplies/mre,
/turf/open/floor/prison/whitegreenfull/southwest,
/area/template_noop)
"Ng" = (
/turf/open/floor/prison/whitegreen/north,
/area/template_noop)
"NX" = (
/obj/structure/inflatable,
/turf/open/floor/prison/whitegreen/west,
/area/template_noop)
"Od" = (
/turf/closed/wall/r_wall/prison_unmeltable,
/area/template_noop)
"Op" = (
/obj/structure/platform{
	dir = 1
	},
/obj/effect/decal/medical_decals{
	icon_state = "triagedecalbottomleft"
	},
/obj/structure/inflatable,
/turf/open/floor/prison/whitegreen/northwest,
/area/template_noop)
"OQ" = (
/obj/structure/inflatable/popped/door,
/turf/open/floor/prison/sterile_white/southwest,
/area/template_noop)
"PE" = (
/obj/structure/machinery/door/airlock/prison_hatch/autoname{
	dir = 1
	},
/turf/open/floor/plating/prison,
/area/template_noop)
"Qq" = (
/obj/effect/decal/cleanable/blood/gibs/xeno/limb,
/turf/open/floor/prison/whitegreencorner/east,
/area/template_noop)
"QA" = (
/obj/structure/bed/chair{
	dir = 8;
	layer = 2.7
	},
/obj/effect/decal/cleanable/mucus{
	pixel_x = -16
	},
/turf/open/floor/prison/sterile_white/southwest,
/area/template_noop)
"Rj" = (
/obj/structure/machinery/light/double/blue{
	dir = 8;
	pixel_x = -10;
	pixel_y = 13
	},
/obj/structure/largecrate/supply/supplies/flares,
/turf/open/floor/prison/whitegreen/southwest,
/area/template_noop)
"Ro" = (
/obj/structure/machinery/shower{
	pixel_y = 13
	},
/obj/structure/platform{
	dir = 8
	},
/turf/open/floor/plating/plating_catwalk/prison,
/area/template_noop)
"RP" = (
/obj/structure/machinery/medical_pod/sleeper,
/turf/open/floor/prison/whitegreen/southeast,
/area/template_noop)
"Sm" = (
/obj/structure/machinery/optable,
/obj/item/bedsheet/rainbow,
/obj/effect/decal/cleanable/blood,
/turf/open/floor/prison/whitegreen,
/area/template_noop)
"SJ" = (
/turf/open/floor/prison/whitegreen/northwest,
/area/template_noop)
"Tf" = (
/turf/open/floor/prison/whitegreenfull/southwest,
/area/template_noop)
"Tj" = (
/obj/structure/platform_decoration{
	dir = 8
	},
/obj/effect/decal/medical_decals{
	icon_state = "triagedecaldir"
	},
/turf/open/floor/prison/whitegreenfull/southwest,
/area/template_noop)
"TI" = (
/obj/effect/decal/medical_decals{
	icon_state = "triagedecalbottom"
	},
/obj/structure/inflatable/door,
/turf/open/floor/prison/sterile_white/southwest,
/area/template_noop)
"Ur" = (
/obj/structure/machinery/light/double/blue{
	dir = 4;
	pixel_x = 10;
	pixel_y = -3
	},
/turf/open/floor/prison/whitegreenfull/southwest,
/area/template_noop)
"UA" = (
/obj/effect/decal/medical_decals{
	icon_state = "triagedecalleft"
	},
/obj/structure/inflatable/door,
/turf/open/floor/prison/sterile_white/southwest,
/area/template_noop)
"UZ" = (
/obj/effect/decal/medical_decals{
	icon_state = "triagedecalleft"
	},
/obj/structure/inflatable/popped/door,
/turf/open/floor/prison/sterile_white/southwest,
/area/template_noop)
"Va" = (
/obj/structure/extinguisher_cabinet,
/turf/closed/wall/prison,
/area/template_noop)
"Wb" = (
/turf/open/floor/prison/whitegreen,
/area/template_noop)
"Wc" = (
/obj/structure/largecrate/supply/weapons/pistols,
/turf/open/floor/prison/whitegreenfull/southwest,
/area/template_noop)
"Wt" = (
/obj/structure/inflatable/door,
/turf/open/floor/prison/sterile_white/southwest,
/area/template_noop)
"WF" = (
/obj/structure/largecrate/supply/medicine/iv,
/turf/open/floor/prison/sterile_white/southwest,
/area/template_noop)
"Xj" = (
/obj/structure/inflatable/door,
/turf/open/floor/prison/whitegreenfull/southwest,
/area/template_noop)
"XN" = (
/obj/structure/inflatable/popped,
/turf/open/floor/prison/sterile_white/southwest,
/area/template_noop)
"Yj" = (
/obj/structure/machinery/medical_pod/bodyscanner,
/turf/open/floor/prison/whitegreen/southwest,
/area/template_noop)
"Yz" = (
/obj/structure/window/framed/prison/cell,
/turf/open/floor/plating/prison,
/area/template_noop)
"Zg" = (
/obj/structure/machinery/cm_vending/sorted/medical/wall_med/limited,
/turf/closed/wall/prison,
/area/template_noop)

(1,1,1) = {"
yM
Ur
oh
bv
Tj
Tf
SJ
Qq
BI
IR
sK
kE
om
zK
Va
kE
kE
kE
"}
(2,1,1) = {"
kE
kE
kE
go
Op
NX
iG
OQ
LW
mV
fN
vS
NX
NX
tD
Rj
Wc
kE
"}
(3,1,1) = {"
bH
Tf
kE
kE
dG
DI
DI
DI
DI
DI
Ec
DI
DI
DI
DI
at
Nb
kE
"}
(4,1,1) = {"
lA
Tf
iR
GI
bZ
DI
Lw
aL
eP
DI
TI
DI
DI
DI
eP
Wb
kE
kE
"}
(5,1,1) = {"
Tf
Ur
kE
kE
Gk
fz
DI
DI
DI
DI
TI
eP
DI
DI
DI
ju
kE
kE
"}
(6,1,1) = {"
kE
kE
kE
kE
bI
fz
DI
DI
DI
vq
AP
rf
rf
rf
DI
cl
iD
Od
"}
(7,1,1) = {"
iK
kE
Ro
pA
vo
UZ
UA
na
na
Zg
Zg
jc
DI
jc
DI
mV
gA
Yj
"}
(8,1,1) = {"
nj
kE
EZ
Tf
Ng
DI
DI
vV
HL
kE
kE
Fn
DI
jc
DI
Wt
aL
Wb
"}
(9,1,1) = {"
Es
kE
GT
Tf
Ng
DI
eP
lH
WF
Zg
Zg
jc
DI
mU
DI
lf
DI
Sm
"}
(10,1,1) = {"
kE
kE
GT
Tf
Ly
hp
DI
DI
DI
Bc
LW
QA
IJ
IJ
fz
nv
wO
Wb
"}
(11,1,1) = {"
kE
Tf
Tf
Tf
Ng
sf
fz
DI
DI
DI
Wt
DI
DI
eP
fz
ds
yr
RP
"}
(12,1,1) = {"
PE
Xj
Tf
qp
Ng
eP
DI
DI
DI
DI
XN
DI
DI
DI
DI
qB
CA
Od
"}
(13,1,1) = {"
kE
Tf
zL
oh
af
la
uj
uj
uj
uj
uj
Ip
IZ
rm
uj
jw
Od
Od
"}
(14,1,1) = {"
Od
Kk
cO
Kk
Od
Od
Yz
Yz
Yz
Yz
Yz
Od
cO
Kk
Kk
Od
Od
Od
"}
