//MAP CONVERTED BY dmm2tgm.py THIS HEADER COMMENT PREVENTS RECONVERSION, DO NOT REMOVE
"aj" = (
/obj/structure/window/framed/prison,
/turf/open/floor/plating/prison,
/area/template_noop)
"az" = (
/obj/structure/bed/chair/comfy{
	dir = 1
	},
/turf/open/floor/wood,
/area/template_noop)
"bm" = (
/turf/open/gm/river/pool,
/area/template_noop)
"bD" = (
/obj/effect/decal/cleanable/blood,
/turf/open/floor/wood,
/area/template_noop)
"bT" = (
/obj/item/trash/crushed_cup{
	pixel_y = -2;
	pixel_x = -12
	},
/turf/open/floor/prison/darkbrown2/east,
/area/template_noop)
"cb" = (
/obj/item/trash/barcardine{
	pixel_y = -9;
	pixel_x = -15
	},
/turf/open/floor/wood,
/area/template_noop)
"ci" = (
/obj/item/toy/gun,
/turf/open/floor/wood,
/area/template_noop)
"cq" = (
/obj/structure/surface/table/reinforced/prison,
/obj/item/clothing/head/cueball{
	pixel_x = 32;
	pixel_y = -2
	},
/obj/item/reagent_container/food/drinks/bottle/beer/craft/tuxedo{
	pixel_x = -9;
	pixel_y = 9
	},
/turf/open/floor/wood,
/area/template_noop)
"cu" = (
/obj/item/trash/crushed_cup{
	pixel_x = -13;
	pixel_y = 48
	},
/turf/open/gm/river/pool,
/area/template_noop)
"cT" = (
/obj/structure/platform_decoration,
/turf/open/floor/prison/floor_plate,
/area/template_noop)
"dD" = (
/obj/effect/decal/cleanable/blood,
/turf/open/floor/prison/darkbrown2/west,
/area/template_noop)
"eh" = (
/obj/structure/closet/basketball{
	pixel_x = -8;
	pixel_y = -2
	},
/obj/item/weapon/gun/pistol/heavy,
/obj/item/weapon/gun/revolver/spearhead,
/turf/open/floor/wood,
/area/template_noop)
"ey" = (
/obj/item/trash/crushed_cup{
	pixel_y = -7;
	pixel_x = -1
	},
/turf/open/floor/prison/darkbrown2,
/area/template_noop)
"eJ" = (
/obj/structure/machinery/power/apc/power/south,
/turf/open/floor/wood,
/area/template_noop)
"eN" = (
/obj/item/toy/beach_ball,
/turf/open/gm/river/pool,
/area/template_noop)
"fk" = (
/obj/effect/decal/cleanable/blood,
/turf/open/floor/prison/darkbrowncorners2/north,
/area/template_noop)
"fw" = (
/obj/item/trash/kepler{
	pixel_x = 13
	},
/turf/open/floor/prison/darkbrown2/west,
/area/template_noop)
"fB" = (
/obj/effect/decal/cleanable/blood/oil/streak,
/turf/open/floor/prison/darkbrown2/north,
/area/template_noop)
"fI" = (
/turf/open/floor/prison/darkbrowncorners2/west,
/area/template_noop)
"fX" = (
/turf/closed/wall/mineral/bone_resin,
/area/template_noop)
"fZ" = (
/obj/structure/grille,
/obj/item/reagent_container/food/snacks/carpmeat{
	pixel_x = -5;
	pixel_y = 13
	},
/obj/item/reagent_container/food/snacks/carpmeat{
	pixel_x = 4;
	pixel_y = 6
	},
/obj/structure/prop/invuln/fire{
	layer = 2.9
	},
/turf/open/floor/prison/darkbrowncorners2/west,
/area/template_noop)
"gA" = (
/obj/item/trash/crushed_cup{
	pixel_y = 6;
	pixel_x = 6
	},
/turf/open/floor/prison/darkbrown2/east,
/area/template_noop)
"gH" = (
/turf/open/floor/prison/darkbrowncorners2/north,
/area/template_noop)
"gQ" = (
/obj/structure/platform,
/obj/structure/machinery/light/double/blue,
/turf/open/floor/prison/darkbrown2,
/area/template_noop)
"gV" = (
/turf/open/space,
/area/template_noop)
"hl" = (
/obj/structure/platform{
	dir = 1
	},
/obj/structure/machinery/light/double/blue{
	dir = 1;
	pixel_y = 21
	},
/turf/open/floor/prison/floor_plate,
/area/template_noop)
"hP" = (
/obj/structure/platform{
	dir = 4
	},
/turf/open/floor/prison,
/area/template_noop)
"hV" = (
/obj/effect/decal/cleanable/blood/oil,
/turf/open/floor/prison/darkbrown2/east,
/area/template_noop)
"hW" = (
/obj/item/toy/crossbow_ammo{
	pixel_x = 19;
	pixel_y = 9
	},
/turf/open/floor/prison/darkbrown2,
/area/template_noop)
"hX" = (
/obj/structure/platform_decoration{
	dir = 8
	},
/turf/open/floor/prison/darkbrown2/east,
/area/template_noop)
"hY" = (
/obj/structure/machinery/light/double/blue{
	dir = 8;
	pixel_x = -10;
	pixel_y = -3
	},
/turf/open/floor/wood,
/area/template_noop)
"ij" = (
/obj/item/toy/crossbow_ammo{
	pixel_y = 18;
	pixel_x = 24;
	layer = 2.5
	},
/turf/open/floor/wood,
/area/template_noop)
"in" = (
/obj/item/trash/crushed_cup{
	pixel_y = -6;
	pixel_x = -8
	},
/turf/open/floor/prison/darkbrown2/east,
/area/template_noop)
"iY" = (
/obj/structure/surface/table/reinforced/prison,
/obj/item/reagent_container/food/drinks/cup{
	pixel_x = 6;
	pixel_y = 5
	},
/obj/item/reagent_container/food/drinks/cup{
	pixel_x = 15;
	pixel_y = 5
	},
/turf/open/floor/wood,
/area/template_noop)
"ji" = (
/obj/structure/platform_decoration{
	dir = 1
	},
/turf/open/floor/prison/darkbrown2/southeast,
/area/template_noop)
"jr" = (
/obj/effect/landmark/survivor_spawner,
/turf/open/floor/prison/darkbrown2,
/area/template_noop)
"jt" = (
/obj/structure/surface/table/reinforced/prison,
/turf/open/floor/wood,
/area/template_noop)
"jT" = (
/obj/item/tool/mop{
	pixel_x = 11;
	layer = 2.9;
	pixel_y = 3
	},
/obj/item/reagent_container/glass/bucket/mopbucket{
	pixel_x = 9;
	pixel_y = -5
	},
/turf/open/floor/prison/darkbrown2/east,
/area/template_noop)
"kl" = (
/obj/structure/platform_decoration{
	dir = 4
	},
/turf/open/floor/prison/darkbrown2/northeast,
/area/template_noop)
"ks" = (
/obj/structure/surface/table/reinforced/prison,
/obj/item/toy/plush/therapy/blue{
	pixel_y = 4
	},
/obj/item/reagent_container/food/drinks/bottle/whiskey{
	pixel_x = 10;
	pixel_y = 4
	},
/obj/item/clothing/head/bowlerhat{
	pixel_y = 16;
	layer = 3.1
	},
/turf/open/floor/wood,
/area/template_noop)
"kC" = (
/obj/structure/platform_decoration,
/turf/open/floor/prison/darkbrowncorners2,
/area/template_noop)
"kJ" = (
/obj/effect/decal/cleanable/blood/oil/streak,
/turf/open/floor/prison/darkbrown2/west,
/area/template_noop)
"lc" = (
/obj/structure/surface/table/reinforced/prison,
/obj/item/toy/deck,
/obj/item/toy/dice{
	pixel_x = 11;
	pixel_y = 7
	},
/turf/open/floor/wood,
/area/template_noop)
"lh" = (
/obj/item/trash/cigbutt{
	pixel_x = 31;
	pixel_y = -16
	},
/turf/open/floor/wood,
/area/template_noop)
"ls" = (
/obj/item/toy/crossbow_ammo{
	pixel_y = -14;
	pixel_x = -15
	},
/turf/open/floor/prison/darkbrown2/north,
/area/template_noop)
"ly" = (
/obj/structure/platform_decoration{
	dir = 8
	},
/turf/open/floor/prison,
/area/template_noop)
"lS" = (
/obj/structure/surface/table/reinforced/prison,
/obj/item/reagent_container/food/snacks/cheeseburger{
	pixel_x = -6;
	pixel_y = 12
	},
/obj/item/reagent_container/food/snacks/cheeseburger{
	pixel_x = 9;
	pixel_y = 12
	},
/obj/item/reagent_container/food/snacks/cheeseburger{
	pixel_x = 9;
	pixel_y = 1
	},
/obj/item/reagent_container/food/snacks/cheeseburger{
	pixel_x = -6;
	pixel_y = 2
	},
/turf/open/floor/wood,
/area/template_noop)
"mk" = (
/obj/structure/machinery/light/double/blue{
	dir = 1;
	pixel_y = 21
	},
/obj/item/trash/crushed_cup{
	pixel_y = -7;
	pixel_x = 7
	},
/turf/open/floor/wood,
/area/template_noop)
"mu" = (
/turf/open/floor/plating/prison,
/area/template_noop)
"nf" = (
/turf/open/floor/wood,
/area/template_noop)
"ni" = (
/turf/closed/wall/prison,
/area/template_noop)
"nv" = (
/obj/structure/platform{
	dir = 8
	},
/turf/open/floor/prison/floor_plate,
/area/template_noop)
"ny" = (
/obj/item/trash/cigbutt{
	pixel_x = 31;
	pixel_y = -16
	},
/turf/open/floor/prison/darkbrown2/west,
/area/template_noop)
"nA" = (
/obj/structure/surface/table/reinforced/prison,
/obj/item/reagent_container/food/drinks/bottle/beer/craft/mono{
	pixel_x = 6;
	pixel_y = 5;
	layer = 3.1
	},
/obj/item/toy/plush/farwa{
	pixel_x = -5;
	pixel_y = 4
	},
/obj/item/trash/cigbutt{
	pixel_x = -6;
	pixel_y = 11
	},
/turf/open/floor/wood,
/area/template_noop)
"nC" = (
/obj/structure/stairs/perspective{
	icon_state = "p_stair_ew_full_cap"
	},
/obj/structure/platform{
	dir = 1
	},
/turf/open/floor/plating/prison,
/area/template_noop)
"nS" = (
/obj/structure/prop/souto_land/pole,
/turf/open/floor/wood,
/area/template_noop)
"nT" = (
/obj/structure/platform,
/turf/open/floor/prison/darkbrown2,
/area/template_noop)
"or" = (
/obj/structure/prop/souto_land/pole{
	dir = 1
	},
/turf/open/floor/wood,
/area/template_noop)
"oL" = (
/obj/structure/lattice,
/turf/open/space,
/area/template_noop)
"pt" = (
/obj/structure/bed/chair/comfy{
	layer = 2.9
	},
/turf/open/floor/wood,
/area/template_noop)
"pG" = (
/obj/structure/stairs/perspective{
	dir = 8;
	icon_state = "p_stair_ew_full_cap"
	},
/obj/structure/platform/stair_cut,
/turf/open/floor/plating/prison,
/area/template_noop)
"qa" = (
/obj/structure/prop/souto_land/streamer{
	dir = 9
	},
/turf/open/floor/prison/darkbrown2/north,
/area/template_noop)
"qi" = (
/obj/structure/platform_decoration{
	dir = 1
	},
/turf/open/floor/prison/darkbrowncorners2/west,
/area/template_noop)
"qm" = (
/obj/structure/stairs/perspective{
	dir = 4;
	icon_state = "p_stair_full"
	},
/obj/structure/platform,
/turf/open/floor/plating/prison,
/area/template_noop)
"qB" = (
/obj/item/trash/crushed_cup{
	pixel_x = -20
	},
/turf/open/gm/river/pool,
/area/template_noop)
"qG" = (
/obj/item/trash/crushed_cup{
	pixel_y = 16
	},
/obj/item/trash/hotdog{
	pixel_x = 7;
	pixel_y = -8
	},
/obj/item/trash/hotdog{
	pixel_x = -4;
	pixel_y = -11
	},
/obj/item/trash/hotdog{
	pixel_x = 2;
	pixel_y = -2
	},
/turf/open/floor/wood,
/area/template_noop)
"rp" = (
/obj/item/reagent_container/glass/bucket/janibucket,
/turf/open/floor/prison,
/area/template_noop)
"rW" = (
/obj/structure/bed/chair/comfy{
	dir = 8
	},
/turf/open/floor/wood,
/area/template_noop)
"so" = (
/obj/item/device/flashlight/lamp/tripod,
/turf/open/floor/wood,
/area/template_noop)
"sr" = (
/turf/open/floor/prison/darkbrown2/northwest,
/area/template_noop)
"su" = (
/obj/structure/prop/souto_land/pole,
/obj/structure/prop/souto_land/pole{
	dir = 4;
	pixel_y = 24
	},
/obj/item/toy/plush/barricade{
	pixel_x = 1;
	pixel_y = -9
	},
/obj/effect/decal/cleanable/blood/oil/streak,
/turf/open/floor/prison/darkbrown2/west,
/area/template_noop)
"sG" = (
/obj/structure/platform,
/turf/open/gm/river/pool,
/area/template_noop)
"sI" = (
/obj/item/toy/crossbow{
	pixel_x = 11;
	pixel_y = -8
	},
/turf/open/floor/prison/darkbrown2,
/area/template_noop)
"sW" = (
/turf/open/floor/prison/floor_plate,
/area/template_noop)
"tb" = (
/obj/item/trash/wy_chips_pepper{
	pixel_x = 18;
	layer = 2.5
	},
/turf/open/floor/wood,
/area/template_noop)
"tw" = (
/obj/item/toy/crossbow_ammo{
	pixel_x = -7;
	pixel_y = -11
	},
/turf/open/floor/wood,
/area/template_noop)
"ty" = (
/obj/structure/platform{
	dir = 8
	},
/turf/open/floor/prison,
/area/template_noop)
"tz" = (
/obj/structure/bed/chair/comfy{
	dir = 4
	},
/turf/open/floor/wood,
/area/template_noop)
"tF" = (
/obj/structure/stairs/perspective{
	dir = 1;
	icon_state = "p_stair_sn_full_cap"
	},
/obj/structure/platform{
	dir = 8
	},
/obj/structure/prop/souto_land/pole,
/obj/structure/prop/souto_land/pole{
	dir = 4;
	pixel_y = 24
	},
/obj/item/toy/plush/barricade{
	pixel_x = 1;
	pixel_y = -9
	},
/turf/open/floor/prison/darkbrown2/west,
/area/template_noop)
"tT" = (
/obj/effect/decal/cleanable/blood/oil/streak,
/turf/open/floor/wood,
/area/template_noop)
"tX" = (
/turf/open/floor/prison/darkbrown2/north,
/area/template_noop)
"ut" = (
/turf/open/floor/prison/darkbrown2/east,
/area/template_noop)
"uv" = (
/obj/effect/landmark/corpsespawner/ua_riot/burst,
/turf/open/floor/prison/darkbrown2/north,
/area/template_noop)
"uO" = (
/obj/structure/stairs/perspective{
	dir = 8;
	icon_state = "p_stair_sn_full_cap"
	},
/obj/structure/platform{
	dir = 4
	},
/obj/structure/prop/souto_land/pole{
	dir = 1
	},
/obj/structure/prop/souto_land/pole{
	dir = 8;
	pixel_y = 24
	},
/obj/item/toy/plush/barricade{
	pixel_x = -1;
	pixel_y = -9
	},
/turf/open/floor/prison/darkbrown2/east,
/area/template_noop)
"vU" = (
/obj/structure/surface/table/reinforced/prison,
/obj/item/reagent_container/food/snacks/hotdog{
	pixel_x = 6;
	pixel_y = 16
	},
/obj/item/reagent_container/food/snacks/hotdog{
	pixel_x = -7;
	pixel_y = 16
	},
/obj/item/reagent_container/food/snacks/hotdog{
	pixel_x = 6;
	pixel_y = 12
	},
/obj/item/reagent_container/food/snacks/hotdog{
	pixel_x = -7;
	pixel_y = 12
	},
/obj/item/reagent_container/food/snacks/hotdog{
	pixel_x = -7;
	pixel_y = 7
	},
/obj/item/reagent_container/food/snacks/hotdog{
	pixel_x = 6;
	pixel_y = 7
	},
/obj/item/reagent_container/food/snacks/hotdog{
	pixel_x = -7;
	pixel_y = 2
	},
/obj/item/reagent_container/food/snacks/hotdog{
	pixel_x = 6;
	pixel_y = 2
	},
/turf/open/floor/wood,
/area/template_noop)
"vX" = (
/obj/structure/surface/table/reinforced/prison,
/obj/structure/machinery/light/double/blue{
	dir = 4;
	pixel_x = 10;
	pixel_y = 13
	},
/obj/structure/prop/souto_land/pole{
	dir = 1
	},
/obj/structure/prop/souto_land/streamer{
	dir = 9
	},
/obj/item/tool/hand_labeler{
	pixel_x = -5;
	pixel_y = 7
	},
/turf/open/floor/wood,
/area/template_noop)
"wv" = (
/obj/item/toy/beach_ball/holoball{
	pixel_x = -10;
	pixel_y = -7
	},
/turf/open/floor/prison/darkbrown2/west,
/area/template_noop)
"xz" = (
/obj/structure/prop/souto_land/streamer{
	dir = 9
	},
/turf/open/floor/wood,
/area/template_noop)
"xS" = (
/obj/structure/platform{
	dir = 1
	},
/obj/structure/machinery/light/double/blue{
	dir = 1;
	pixel_y = 21
	},
/turf/open/floor/wood,
/area/template_noop)
"yv" = (
/obj/item/trash/crushed_cup{
	pixel_y = 5;
	pixel_x = 11
	},
/turf/open/gm/river/pool,
/area/template_noop)
"yz" = (
/obj/structure/grille,
/obj/item/reagent_container/food/snacks/bearmeat{
	pixel_x = 6;
	pixel_y = 13
	},
/obj/item/reagent_container/food/snacks/meat/human{
	pixel_x = -7;
	pixel_y = 3
	},
/obj/structure/prop/invuln/fire{
	layer = 2.9
	},
/turf/open/floor/prison/darkbrowncorners2,
/area/template_noop)
"yL" = (
/obj/structure/stairs/perspective{
	dir = 4;
	icon_state = "p_stair_sn_full_cap"
	},
/obj/structure/platform{
	dir = 4
	},
/turf/open/floor/plating/prison,
/area/template_noop)
"zR" = (
/obj/item/trash/cigbutt{
	pixel_x = 10;
	pixel_y = -11
	},
/turf/open/floor/wood,
/area/template_noop)
"zS" = (
/obj/structure/platform_decoration{
	dir = 4
	},
/turf/open/floor/prison/darkbrown2/west,
/area/template_noop)
"Aj" = (
/obj/item/device/flashlight/lamp/tripod,
/turf/open/floor/prison,
/area/template_noop)
"Ao" = (
/obj/structure/surface/table/reinforced/prison,
/obj/structure/machinery/light/double/blue{
	dir = 4;
	pixel_x = 10;
	pixel_y = -3
	},
/turf/open/floor/wood,
/area/template_noop)
"Bf" = (
/obj/structure/window/framed/prison/reinforced/hull,
/turf/open/floor/plating/prison,
/area/template_noop)
"Bv" = (
/obj/structure/prop/souto_land/streamer{
	dir = 9
	},
/obj/item/toy/gun_ammo{
	pixel_y = 66
	},
/turf/open/floor/wood,
/area/template_noop)
"BK" = (
/obj/structure/prop/souto_land/pole,
/obj/structure/prop/souto_land/streamer{
	dir = 6
	},
/turf/open/floor/wood,
/area/template_noop)
"BZ" = (
/obj/structure/platform{
	dir = 1
	},
/turf/open/floor/prison/floor_plate,
/area/template_noop)
"Ci" = (
/obj/structure/surface/table/reinforced/prison,
/obj/item/storage/beer_pack{
	pixel_y = 5;
	layer = 4
	},
/turf/open/floor/wood,
/area/template_noop)
"Cj" = (
/obj/structure/prop/souto_land/pole{
	dir = 1
	},
/turf/open/floor/prison/darkbrown2,
/area/template_noop)
"Cw" = (
/obj/structure/platform_decoration,
/turf/open/floor/prison/darkbrown2,
/area/template_noop)
"Cx" = (
/obj/item/weapon/baseballbat/metal,
/turf/open/floor/wood,
/area/template_noop)
"CD" = (
/obj/item/trash/crushed_cup{
	pixel_x = -2;
	pixel_y = 36
	},
/turf/open/gm/river/pool,
/area/template_noop)
"CR" = (
/obj/structure/platform,
/turf/open/floor/prison/floor_plate,
/area/template_noop)
"CZ" = (
/obj/item/reagent_container/food/drinks/cans/beer,
/turf/open/floor/prison/darkbrown2,
/area/template_noop)
"DG" = (
/obj/structure/platform_decoration{
	dir = 1
	},
/turf/open/floor/prison/darkbrown2,
/area/template_noop)
"DL" = (
/obj/item/trash/sosjerky{
	pixel_x = -14;
	pixel_y = -20
	},
/obj/effect/decal/cleanable/blood/oil/streak,
/turf/open/floor/prison/darkbrown2/north,
/area/template_noop)
"DW" = (
/obj/structure/closet/crate/trashcart,
/obj/item/storage/pill_bottle/kelotane/skillless,
/turf/open/floor/prison,
/area/template_noop)
"Eb" = (
/obj/item/toy/crossbow_ammo{
	pixel_x = -17;
	pixel_y = 41
	},
/turf/open/floor/prison/darkbrown2/north,
/area/template_noop)
"Ez" = (
/obj/structure/prop/souto_land/pole{
	dir = 1
	},
/obj/structure/prop/souto_land/pole{
	dir = 8;
	pixel_y = 24
	},
/obj/item/toy/plush/barricade{
	pixel_x = -3;
	pixel_y = -9
	},
/turf/open/floor/prison/darkbrown2/east,
/area/template_noop)
"EA" = (
/obj/effect/decal/cleanable/blood/oil,
/turf/open/floor/prison/darkbrown2/north,
/area/template_noop)
"Fj" = (
/obj/structure/platform_decoration{
	dir = 8
	},
/turf/open/floor/wood,
/area/template_noop)
"Fy" = (
/turf/closed/wall/r_wall/prison_unmeltable,
/area/template_noop)
"Gi" = (
/obj/structure/stairs/perspective{
	dir = 4;
	icon_state = "p_stair_full"
	},
/turf/open/floor/plating/prison,
/area/template_noop)
"Gq" = (
/obj/item/trash/plate{
	pixel_x = -9
	},
/turf/open/floor/prison/darkbrowncorners2,
/area/template_noop)
"HP" = (
/obj/structure/prop/souto_land/streamer{
	dir = 6
	},
/obj/item/trash/crushed_cup{
	pixel_y = 3;
	pixel_x = -4
	},
/turf/open/floor/wood,
/area/template_noop)
"IJ" = (
/obj/item/trash/crushed_cup{
	pixel_y = -65;
	pixel_x = 29
	},
/turf/open/gm/river/pool,
/area/template_noop)
"IO" = (
/obj/effect/decal/cleanable/blood,
/turf/open/floor/prison/darkbrown2/southwest,
/area/template_noop)
"IU" = (
/obj/effect/decal/cleanable/blood/oil,
/turf/open/floor/wood,
/area/template_noop)
"Jf" = (
/obj/structure/surface/table/reinforced/prison,
/obj/item/reagent_container/food/drinks/cup{
	pixel_x = -17;
	pixel_y = -21
	},
/obj/item/reagent_container/food/drinks/bottle/beer/craft/tazhushka{
	pixel_x = 10;
	pixel_y = 20
	},
/turf/open/floor/wood,
/area/template_noop)
"Jw" = (
/obj/structure/machinery/light/double/blue{
	dir = 1;
	pixel_y = 21
	},
/turf/open/floor/wood,
/area/template_noop)
"Jz" = (
/turf/open/floor/prison/darkbrown2/southeast,
/area/template_noop)
"JQ" = (
/obj/item/clipboard,
/turf/open/floor/prison,
/area/template_noop)
"Kp" = (
/obj/structure/platform,
/obj/structure/platform{
	dir = 8
	},
/obj/structure/platform_decoration{
	dir = 10
	},
/turf/open/floor/prison/floor_plate,
/area/template_noop)
"KL" = (
/obj/structure/surface/table/reinforced/prison,
/obj/item/reagent_container/food/drinks/cup{
	pixel_x = -8;
	pixel_y = 5
	},
/obj/item/reagent_container/food/drinks/cup{
	pixel_x = -12;
	pixel_y = -1
	},
/obj/item/reagent_container/food/drinks/cup{
	pixel_x = -21;
	pixel_y = -1
	},
/obj/item/reagent_container/food/drinks/cup{
	pixel_x = -16;
	pixel_y = -6
	},
/turf/open/floor/wood,
/area/template_noop)
"KO" = (
/obj/structure/surface/table/reinforced/prison,
/obj/item/reagent_container/food/drinks/cup{
	pixel_x = -8;
	layer = 3.2
	},
/obj/item/reagent_container/food/drinks/cup{
	pixel_x = -13;
	pixel_y = 6;
	layer = 3.1
	},
/turf/open/floor/wood,
/area/template_noop)
"Lr" = (
/obj/item/trash/semki{
	pixel_x = 15
	},
/turf/open/floor/prison/darkbrown2/north,
/area/template_noop)
"Ls" = (
/obj/structure/surface/table/reinforced/prison,
/obj/structure/prop/souto_land/pole{
	dir = 1
	},
/obj/structure/prop/souto_land/streamer{
	dir = 9
	},
/turf/open/floor/wood,
/area/template_noop)
"LI" = (
/obj/structure/surface/table/reinforced/prison,
/obj/item/reagent_container/food/drinks/cans/beer{
	pixel_y = 11;
	pixel_x = 9
	},
/obj/item/reagent_container/food/drinks/cans/beer{
	pixel_y = 11;
	pixel_x = 1
	},
/obj/item/reagent_container/food/drinks/cans/beer{
	pixel_y = 11;
	pixel_x = -7
	},
/obj/item/reagent_container/food/drinks/cans/beer{
	pixel_y = 4;
	pixel_x = 9
	},
/obj/item/reagent_container/food/drinks/cans/beer{
	pixel_y = 4;
	pixel_x = 1
	},
/obj/item/reagent_container/food/drinks/cans/beer{
	pixel_y = 4;
	pixel_x = -7
	},
/turf/open/floor/wood,
/area/template_noop)
"Mf" = (
/obj/structure/stairs/perspective{
	dir = 4;
	icon_state = "p_stair_full"
	},
/obj/structure/platform,
/turf/open/floor/prison/darkbrown2,
/area/template_noop)
"Nh" = (
/obj/item/toy/bikehorn/rubberducky{
	pixel_x = -2;
	pixel_y = -15
	},
/turf/open/gm/river/pool,
/area/template_noop)
"NE" = (
/obj/structure/platform_decoration{
	dir = 4
	},
/turf/open/floor/prison/floor_plate,
/area/template_noop)
"NR" = (
/obj/item/toy/crossbow_ammo{
	pixel_x = -16
	},
/turf/open/floor/prison/darkbrowncorners2/west,
/area/template_noop)
"NT" = (
/obj/structure/platform{
	dir = 1
	},
/turf/open/gm/river/pool,
/area/template_noop)
"NY" = (
/turf/open/floor/prison/cell_stripe/east,
/area/template_noop)
"PC" = (
/turf/open/floor/prison/darkbrowncorners2/east,
/area/template_noop)
"PD" = (
/obj/structure/platform,
/obj/item/trash/crushed_cup{
	pixel_y = 13;
	pixel_x = 45
	},
/turf/open/gm/river/pool,
/area/template_noop)
"PL" = (
/obj/item/storage/belt/marine/quackers,
/turf/open/gm/river/pool,
/area/template_noop)
"PS" = (
/obj/effect/decal/cleanable/blood/oil,
/turf/open/floor/prison/darkbrown2,
/area/template_noop)
"Qn" = (
/turf/open/floor/prison,
/area/template_noop)
"Qt" = (
/obj/item/storage/belt/shotgun/full/quackers{
	layer = 3.1
	},
/obj/item/trash/crushed_cup{
	pixel_y = 6;
	pixel_x = -30
	},
/obj/item/reagent_container/food/drinks/cans/beer{
	pixel_y = 4;
	pixel_x = 1
	},
/turf/open/gm/river/pool,
/area/template_noop)
"QJ" = (
/turf/open/floor/prison/darkbrown2/west,
/area/template_noop)
"QR" = (
/obj/structure/platform,
/obj/structure/platform{
	dir = 4
	},
/obj/structure/platform_decoration{
	dir = 6
	},
/turf/open/floor/prison/floor_plate,
/area/template_noop)
"Rr" = (
/obj/structure/stairs/perspective{
	dir = 8;
	icon_state = "p_stair_full"
	},
/turf/open/floor/plating/prison,
/area/template_noop)
"RB" = (
/obj/effect/decal/cleanable/blood/oil/streak,
/turf/open/floor/prison/darkbrowncorners2/east,
/area/template_noop)
"RT" = (
/obj/effect/decal/cleanable/blood,
/turf/open/floor/prison/darkbrown2/east,
/area/template_noop)
"RV" = (
/obj/structure/prop/souto_land/pole,
/turf/open/floor/prison/darkbrown2,
/area/template_noop)
"RW" = (
/obj/structure/surface/table/reinforced/prison,
/obj/item/reagent_container/food/drinks/cup{
	pixel_x = 6;
	layer = 3.2
	},
/obj/item/reagent_container/food/drinks/cup{
	pixel_x = 15;
	layer = 3.2
	},
/obj/item/reagent_container/food/drinks/cup{
	pixel_x = 11;
	pixel_y = 6;
	layer = 3.1
	},
/turf/open/floor/wood,
/area/template_noop)
"SO" = (
/obj/structure/machinery/light/double/blue{
	dir = 8;
	pixel_x = -10;
	pixel_y = 13
	},
/obj/structure/prop/souto_land/pole,
/obj/structure/prop/souto_land/streamer{
	dir = 6
	},
/obj/item/trash/cigbutt{
	pixel_x = 31;
	pixel_y = -16
	},
/turf/open/floor/wood,
/area/template_noop)
"TO" = (
/obj/structure/prop/souto_land/streamer{
	dir = 6
	},
/turf/open/floor/wood,
/area/template_noop)
"TS" = (
/obj/structure/stairs/perspective{
	dir = 8;
	icon_state = "p_stair_full"
	},
/obj/structure/platform,
/turf/open/floor/plating/prison,
/area/template_noop)
"TV" = (
/obj/item/trash/syndi_cakes{
	pixel_x = -13;
	pixel_y = -11
	},
/turf/open/floor/prison/darkbrown2/east,
/area/template_noop)
"Uh" = (
/obj/structure/prop/souto_land/streamer{
	dir = 6
	},
/obj/effect/decal/cleanable/blood/oil/streak,
/turf/open/floor/prison/darkbrown2/north,
/area/template_noop)
"Us" = (
/obj/item/toy/syndicateballoon{
	pixel_x = 14;
	pixel_y = -5
	},
/turf/open/floor/wood,
/area/template_noop)
"UP" = (
/obj/structure/platform{
	dir = 4
	},
/turf/open/floor/prison/floor_plate,
/area/template_noop)
"Va" = (
/turf/open/floor/prison/darkbrown2/northeast,
/area/template_noop)
"Vi" = (
/obj/structure/surface/table/reinforced/prison,
/obj/item/reagent_container/food/drinks/bottle/cognac{
	pixel_x = 7;
	pixel_y = 7
	},
/obj/item/reagent_container/food/drinks/drinkingglass{
	pixel_x = -3;
	pixel_y = 13;
	layer = 4
	},
/obj/item/reagent_container/food/drinks/drinkingglass{
	pixel_x = -10;
	pixel_y = 1;
	layer = 4
	},
/turf/open/floor/wood,
/area/template_noop)
"Vx" = (
/obj/structure/bed/chair/comfy{
	dir = 1
	},
/obj/item/weapon/gun/shotgun/merc{
	pixel_x = 1;
	pixel_y = 25
	},
/turf/open/floor/wood,
/area/template_noop)
"VE" = (
/obj/item/device/flashlight/lamp/tripod,
/turf/open/floor/prison/darkbrowncorners2,
/area/template_noop)
"VV" = (
/obj/structure/platform_decoration,
/turf/open/floor/prison,
/area/template_noop)
"We" = (
/obj/structure/platform_decoration{
	dir = 1
	},
/turf/open/floor/prison,
/area/template_noop)
"Wj" = (
/turf/open/floor/prison/darkbrown2,
/area/template_noop)
"WG" = (
/obj/structure/platform{
	dir = 1
	},
/obj/structure/platform{
	dir = 4
	},
/obj/structure/platform_decoration{
	dir = 9
	},
/turf/open/floor/prison/floor_plate,
/area/template_noop)
"XR" = (
/obj/structure/stairs/perspective{
	icon_state = "p_stair_sn_full_cap"
	},
/obj/structure/platform{
	dir = 8
	},
/turf/open/floor/prison/bright_clean2/southwest,
/area/template_noop)
"XS" = (
/obj/effect/landmark/corpsespawner/prisoner,
/turf/open/floor/wood,
/area/template_noop)
"Yd" = (
/obj/structure/machinery/light/double/blue,
/turf/open/floor/wood,
/area/template_noop)
"Yh" = (
/obj/structure/bed/chair/comfy{
	dir = 8
	},
/obj/structure/machinery/light/double/blue{
	dir = 4;
	pixel_x = 10;
	pixel_y = -3
	},
/turf/open/floor/wood,
/area/template_noop)
"Yr" = (
/obj/structure/surface/table/reinforced/prison,
/obj/item/trash/plate{
	pixel_x = -7
	},
/obj/item/trash/plate{
	pixel_x = -7;
	pixel_y = 4
	},
/obj/item/trash/plate{
	pixel_x = -7;
	pixel_y = 9
	},
/obj/item/trash/plate{
	pixel_x = 7
	},
/obj/item/trash/plate{
	pixel_x = 7;
	pixel_y = 4
	},
/obj/item/trash/plate{
	pixel_x = 7;
	pixel_y = 9
	},
/turf/open/floor/wood,
/area/template_noop)
"YB" = (
/turf/open/floor/plating/plating_catwalk/prison,
/area/template_noop)
"YG" = (
/obj/structure/platform,
/turf/open/floor/prison,
/area/template_noop)
"YP" = (
/obj/structure/stairs/perspective{
	icon_state = "p_stair_ew_full_cap"
	},
/obj/structure/platform/stair_cut/alt,
/turf/open/floor/plating/prison,
/area/template_noop)
"Zr" = (
/obj/structure/bed/chair/comfy,
/turf/open/floor/wood,
/area/template_noop)

(1,1,1) = {"
Wj
Qn
DW
Qn
rp
fX
fX
fX
fX
tX
Cw
hP
hP
ly
Qn
Qn
Qn
Aj
Qn
tX
Wj
Fy
"}
(2,1,1) = {"
Wj
Qn
JQ
Qn
VV
UP
fX
ni
ni
YP
TS
ni
ni
BZ
sW
cT
hP
hP
ly
tX
Wj
so
"}
(3,1,1) = {"
Wj
Qn
VV
UP
QR
ni
aj
ni
SO
Uh
RV
hY
ni
YP
Rr
TS
ni
ni
BZ
tX
Wj
sr
"}
(4,1,1) = {"
Wj
Qn
CR
ni
aj
ni
nf
nf
nf
DL
Wj
nf
BK
TO
HP
nS
eh
aj
BZ
tX
Wj
mu
"}
(5,1,1) = {"
Wj
VV
QR
aj
jt
az
sr
kJ
QJ
RB
fI
QJ
wv
IO
nf
IU
nf
aj
BZ
tX
mu
fX
"}
(6,1,1) = {"
Wj
CR
ni
ni
XS
nf
ls
VE
ut
ut
gA
ut
gH
hW
lh
nf
Cx
aj
BZ
Va
ut
fX
"}
(7,1,1) = {"
Cw
QR
aj
nf
tz
nf
EA
Wj
pG
Gi
Gi
qm
tX
Wj
nf
tz
nf
aj
WG
Fj
nf
fX
"}
(8,1,1) = {"
nT
ni
ni
Zr
ks
az
tX
CZ
NT
IJ
bm
sG
tX
Wj
Zr
Ci
az
ni
ni
BZ
nf
tX
"}
(9,1,1) = {"
gQ
ni
mk
nf
rW
nf
Eb
Wj
NT
qB
eN
sG
tX
Wj
nf
rW
nf
Yd
ni
hl
nf
tX
"}
(10,1,1) = {"
qi
tF
ny
kJ
kJ
fw
PC
Wj
NT
PL
CD
sG
tX
fZ
QJ
kJ
kJ
su
XR
zS
QJ
PC
"}
(11,1,1) = {"
kC
uO
hV
ut
ut
ut
fk
jr
NT
bm
cu
PD
tX
yz
RT
ut
bT
Ez
yL
hX
ut
ut
"}
(12,1,1) = {"
gQ
ni
Jw
nf
tz
nf
tX
Wj
NT
yv
Qt
sG
uv
Wj
nf
tz
nf
Yd
ni
xS
nf
nf
"}
(13,1,1) = {"
nT
ni
ni
pt
LI
Vx
tX
sI
NT
Nh
bm
sG
tX
ey
Zr
nA
az
cb
Fy
Bf
Bf
Bf
"}
(14,1,1) = {"
DG
Kp
aj
nf
rW
nf
Lr
Wj
nC
Rr
Rr
TS
tX
PS
nf
rW
nf
eJ
Fy
gV
gV
gV
"}
(15,1,1) = {"
Wj
CR
aj
nf
ij
tT
fB
NR
dD
QJ
QJ
QJ
PC
Wj
nf
tb
nf
nf
Fy
Bf
Bf
Bf
"}
(16,1,1) = {"
Wj
YG
aj
lc
ci
tT
Va
jT
in
gH
Gq
ut
TV
Jz
iY
cq
RW
nf
nf
nf
Yr
Bf
"}
(17,1,1) = {"
Wj
YG
aj
Ls
xz
Bv
or
zR
nf
EA
Wj
nf
tw
XS
KL
Jf
KO
bD
nf
nf
lS
Bf
"}
(18,1,1) = {"
Wj
YG
ni
ni
pG
Gi
qm
ni
vX
qa
Cj
Ao
Fy
nf
lh
nf
nf
nf
nf
qG
vU
Bf
"}
(19,1,1) = {"
Wj
We
ty
ty
NE
sW
CR
ni
ni
pG
Mf
ni
Fy
Zr
Vi
az
Fy
Bf
Bf
Bf
Bf
Bf
"}
(20,1,1) = {"
Jz
Qn
Qn
Qn
Aj
Qn
We
nv
nv
kl
ji
nv
Fy
nf
Yh
Us
Fy
gV
gV
oL
gV
gV
"}
(21,1,1) = {"
NY
YB
YB
NY
YB
YB
NY
YB
YB
NY
NY
YB
Fy
Fy
Fy
Fy
Fy
gV
gV
oL
gV
gV
"}
