//MAP CONVERTED BY dmm2tgm.py THIS HEADER COMMENT PREVENTS RECONVERSION, DO NOT REMOVE
"aj" = (
/obj/structure/window/framed/prison,
/turf/open/floor/plating/prison,
/area/template_noop)
"az" = (
/obj/structure/bed/chair/comfy{
	dir = 1
	},
/turf/open/floor/wood,
/area/template_noop)
"aN" = (
/obj/item/trash/syndi_cakes{
	pixel_x = -13;
	pixel_y = -11
	},
/turf/open/floor/prison/darkbrown2/east,
/area/template_noop)
"aO" = (
/obj/effect/decal/cleanable/blood,
/turf/open/floor/prison/darkbrowncorners2/north,
/area/template_noop)
"bl" = (
/obj/item/toy/beach_ball/holoball{
	pixel_x = -10;
	pixel_y = -7
	},
/turf/open/floor/prison/darkbrown2/west,
/area/template_noop)
"by" = (
/obj/structure/platform{
	dir = 4
	},
/turf/open/floor/prison/floor_plate,
/area/template_noop)
"bD" = (
/obj/effect/decal/cleanable/blood,
/turf/open/floor/wood,
/area/template_noop)
"bI" = (
/obj/structure/platform_decoration{
	dir = 8
	},
/turf/open/floor/prison/darkbrown2/east,
/area/template_noop)
"bU" = (
/obj/structure/platform{
	dir = 1
	},
/obj/structure/machinery/light/double/blue{
	dir = 1;
	pixel_y = 21
	},
/turf/open/floor/prison/floor_plate,
/area/template_noop)
"bW" = (
/obj/item/storage/belt/shotgun/full/quackers{
	layer = 3.1
	},
/obj/item/trash/crushed_cup{
	pixel_y = 6;
	pixel_x = -30
	},
/obj/item/reagent_container/food/drinks/cans/beer{
	pixel_y = 4;
	pixel_x = 1
	},
/turf/open/gm/river/pool,
/area/template_noop)
"cb" = (
/obj/item/trash/barcardine{
	pixel_y = -9;
	pixel_x = -15
	},
/turf/open/floor/wood,
/area/template_noop)
"cc" = (
/obj/structure/platform,
/turf/open/floor/prison/floor_plate,
/area/template_noop)
"ci" = (
/obj/item/toy/gun,
/turf/open/floor/wood,
/area/template_noop)
"co" = (
/obj/structure/grille,
/obj/item/reagent_container/food/snacks/carpmeat{
	pixel_x = -5;
	pixel_y = 13
	},
/obj/item/reagent_container/food/snacks/carpmeat{
	pixel_x = 4;
	pixel_y = 6
	},
/obj/structure/prop/invuln/fire{
	layer = 2.9
	},
/turf/open/floor/prison/darkbrowncorners2/west,
/area/template_noop)
"cq" = (
/obj/structure/surface/table/reinforced/prison,
/obj/item/clothing/head/cueball{
	pixel_x = 32;
	pixel_y = -2
	},
/obj/item/reagent_container/food/drinks/bottle/beer/craft/tuxedo{
	pixel_x = -9;
	pixel_y = 9
	},
/turf/open/floor/wood,
/area/template_noop)
"cF" = (
/obj/structure/platform,
/obj/structure/platform{
	dir = 4
	},
/obj/structure/platform_decoration{
	dir = 6
	},
/turf/open/floor/prison/floor_plate,
/area/template_noop)
"cW" = (
/obj/structure/platform_decoration{
	dir = 4
	},
/turf/open/floor/prison/darkbrown2/west,
/area/template_noop)
"ea" = (
/obj/structure/platform{
	dir = 1
	},
/obj/structure/platform{
	dir = 4
	},
/obj/structure/platform_decoration{
	dir = 9
	},
/turf/open/floor/prison/floor_plate,
/area/template_noop)
"et" = (
/obj/structure/stairs/perspective{
	dir = 1;
	icon_state = "p_stair_sn_full_cap"
	},
/obj/structure/platform{
	dir = 8
	},
/obj/structure/prop/souto_land/pole,
/obj/structure/prop/souto_land/pole{
	dir = 4;
	pixel_y = 24
	},
/obj/item/toy/plush/barricade{
	pixel_x = 1;
	pixel_y = -9
	},
/turf/open/floor/prison/darkbrown2/west,
/area/template_noop)
"eG" = (
/obj/structure/platform,
/obj/item/trash/crushed_cup{
	pixel_y = 13;
	pixel_x = 45
	},
/turf/open/gm/river/pool,
/area/template_noop)
"fX" = (
/turf/closed/wall/mineral/bone_resin,
/area/template_noop)
"gi" = (
/obj/structure/prop/souto_land/streamer{
	dir = 6
	},
/obj/effect/decal/cleanable/blood/oil/streak,
/turf/open/floor/prison/darkbrown2/north,
/area/template_noop)
"gm" = (
/obj/item/trash/semki{
	pixel_x = 15
	},
/turf/open/floor/prison/darkbrown2/north,
/area/template_noop)
"gB" = (
/obj/item/trash/crushed_cup{
	pixel_y = -7;
	pixel_x = -1
	},
/turf/open/floor/prison/darkbrown2,
/area/template_noop)
"gV" = (
/turf/open/space,
/area/template_noop)
"ht" = (
/obj/structure/prop/souto_land/streamer{
	dir = 9
	},
/turf/open/floor/prison/darkbrown2/north,
/area/template_noop)
"hP" = (
/obj/structure/platform{
	dir = 4
	},
/turf/open/floor/prison,
/area/template_noop)
"hY" = (
/obj/structure/machinery/light/double/blue{
	dir = 8;
	pixel_x = -10;
	pixel_y = -3
	},
/turf/open/floor/wood,
/area/template_noop)
"ij" = (
/obj/item/toy/crossbow_ammo{
	pixel_y = 18;
	pixel_x = 24;
	layer = 2.5
	},
/turf/open/floor/wood,
/area/template_noop)
"iR" = (
/obj/effect/decal/cleanable/blood/oil,
/turf/open/floor/prison/darkbrown2/east,
/area/template_noop)
"iS" = (
/turf/open/floor/prison/darkbrowncorners2/north,
/area/template_noop)
"iY" = (
/obj/structure/surface/table/reinforced/prison,
/obj/item/reagent_container/food/drinks/cup{
	pixel_x = 6;
	pixel_y = 5
	},
/obj/item/reagent_container/food/drinks/cup{
	pixel_x = 15;
	pixel_y = 5
	},
/turf/open/floor/wood,
/area/template_noop)
"jm" = (
/obj/item/reagent_container/food/drinks/cans/beer,
/turf/open/floor/prison/darkbrown2,
/area/template_noop)
"jq" = (
/obj/item/trash/crushed_cup{
	pixel_x = -20
	},
/turf/open/gm/river/pool,
/area/template_noop)
"jt" = (
/obj/structure/surface/table/reinforced/prison,
/turf/open/floor/wood,
/area/template_noop)
"jx" = (
/obj/structure/stairs/perspective{
	dir = 4;
	icon_state = "p_stair_full"
	},
/obj/structure/platform,
/turf/open/floor/prison/darkbrown2,
/area/template_noop)
"jy" = (
/obj/effect/landmark/survivor_spawner,
/turf/open/floor/prison/darkbrown2,
/area/template_noop)
"kO" = (
/obj/structure/platform,
/obj/structure/platform{
	dir = 8
	},
/obj/structure/platform_decoration{
	dir = 10
	},
/turf/open/floor/prison/floor_plate,
/area/template_noop)
"lc" = (
/obj/structure/surface/table/reinforced/prison,
/obj/item/toy/deck,
/obj/item/toy/dice{
	pixel_x = 11;
	pixel_y = 7
	},
/turf/open/floor/wood,
/area/template_noop)
"lh" = (
/obj/item/trash/cigbutt{
	pixel_x = 31;
	pixel_y = -16
	},
/turf/open/floor/wood,
/area/template_noop)
"ly" = (
/obj/structure/platform_decoration{
	dir = 8
	},
/turf/open/floor/prison,
/area/template_noop)
"lS" = (
/obj/structure/surface/table/reinforced/prison,
/obj/item/reagent_container/food/snacks/cheeseburger{
	pixel_x = -6;
	pixel_y = 12
	},
/obj/item/reagent_container/food/snacks/cheeseburger{
	pixel_x = 9;
	pixel_y = 12
	},
/obj/item/reagent_container/food/snacks/cheeseburger{
	pixel_x = 9;
	pixel_y = 1
	},
/obj/item/reagent_container/food/snacks/cheeseburger{
	pixel_x = -6;
	pixel_y = 2
	},
/turf/open/floor/wood,
/area/template_noop)
"mk" = (
/obj/structure/machinery/light/double/blue{
	dir = 1;
	pixel_y = 21
	},
/obj/item/trash/crushed_cup{
	pixel_y = -7;
	pixel_x = 7
	},
/turf/open/floor/wood,
/area/template_noop)
"mu" = (
/turf/open/floor/plating/prison,
/area/template_noop)
"mU" = (
/obj/item/trash/cigbutt{
	pixel_x = 31;
	pixel_y = -16
	},
/turf/open/floor/prison/darkbrown2/west,
/area/template_noop)
"nf" = (
/turf/open/floor/wood,
/area/template_noop)
"nh" = (
/obj/effect/decal/cleanable/blood/oil/streak,
/turf/open/floor/prison/darkbrowncorners2/east,
/area/template_noop)
"ni" = (
/turf/closed/wall/prison,
/area/template_noop)
"nm" = (
/obj/structure/grille,
/obj/item/reagent_container/food/snacks/bearmeat{
	pixel_x = 6;
	pixel_y = 13
	},
/obj/item/reagent_container/food/snacks/meat/human{
	pixel_x = -7;
	pixel_y = 3
	},
/obj/structure/prop/invuln/fire{
	layer = 2.9
	},
/turf/open/floor/prison/darkbrowncorners2,
/area/template_noop)
"nv" = (
/obj/item/trash/crushed_cup{
	pixel_x = -13;
	pixel_y = 48
	},
/turf/open/gm/river/pool,
/area/template_noop)
"nC" = (
/obj/structure/stairs/perspective{
	icon_state = "p_stair_ew_full_cap"
	},
/obj/structure/platform{
	dir = 1
	},
/turf/open/floor/plating/prison,
/area/template_noop)
"nS" = (
/obj/structure/prop/souto_land/pole,
/turf/open/floor/wood,
/area/template_noop)
"nV" = (
/obj/structure/platform_decoration{
	dir = 4
	},
/turf/open/floor/prison/floor_plate,
/area/template_noop)
"or" = (
/obj/structure/prop/souto_land/pole{
	dir = 1
	},
/turf/open/floor/wood,
/area/template_noop)
"oL" = (
/obj/structure/lattice,
/turf/open/space,
/area/template_noop)
"pt" = (
/obj/structure/bed/chair/comfy{
	layer = 2.9
	},
/turf/open/floor/wood,
/area/template_noop)
"pG" = (
/obj/structure/stairs/perspective{
	dir = 8;
	icon_state = "p_stair_ew_full_cap"
	},
/obj/structure/platform/stair_cut,
/turf/open/floor/plating/prison,
/area/template_noop)
"qm" = (
/obj/structure/stairs/perspective{
	dir = 4;
	icon_state = "p_stair_full"
	},
/obj/structure/platform,
/turf/open/floor/plating/prison,
/area/template_noop)
"qB" = (
/obj/structure/platform_decoration{
	dir = 1
	},
/turf/open/floor/prison/darkbrown2/southeast,
/area/template_noop)
"qG" = (
/obj/item/trash/crushed_cup{
	pixel_y = 16
	},
/obj/item/trash/hotdog{
	pixel_x = 7;
	pixel_y = -8
	},
/obj/item/trash/hotdog{
	pixel_x = -4;
	pixel_y = -11
	},
/obj/item/trash/hotdog{
	pixel_x = 2;
	pixel_y = -2
	},
/turf/open/floor/wood,
/area/template_noop)
"rp" = (
/obj/item/reagent_container/glass/bucket/janibucket,
/turf/open/floor/prison,
/area/template_noop)
"rW" = (
/obj/structure/bed/chair/comfy{
	dir = 8
	},
/turf/open/floor/wood,
/area/template_noop)
"so" = (
/obj/item/device/flashlight/lamp/tripod,
/turf/open/floor/wood,
/area/template_noop)
"sE" = (
/obj/item/trash/crushed_cup{
	pixel_y = -65;
	pixel_x = 29
	},
/turf/open/gm/river/pool,
/area/template_noop)
"sU" = (
/obj/effect/decal/cleanable/blood,
/turf/open/floor/prison/darkbrown2/west,
/area/template_noop)
"sX" = (
/obj/structure/prop/souto_land/pole{
	dir = 1
	},
/turf/open/floor/prison/darkbrown2,
/area/template_noop)
"sZ" = (
/obj/item/trash/crushed_cup{
	pixel_y = -2;
	pixel_x = -12
	},
/turf/open/floor/prison/darkbrown2/east,
/area/template_noop)
"tb" = (
/obj/item/trash/wy_chips_pepper{
	pixel_x = 18;
	layer = 2.5
	},
/turf/open/floor/wood,
/area/template_noop)
"tu" = (
/obj/effect/decal/cleanable/blood/oil/streak,
/turf/open/floor/prison/darkbrown2/west,
/area/template_noop)
"tw" = (
/obj/item/toy/crossbow_ammo{
	pixel_x = -7;
	pixel_y = -11
	},
/turf/open/floor/wood,
/area/template_noop)
"ty" = (
/obj/structure/platform{
	dir = 8
	},
/turf/open/floor/prison,
/area/template_noop)
"tz" = (
/obj/structure/bed/chair/comfy{
	dir = 4
	},
/turf/open/floor/wood,
/area/template_noop)
"tK" = (
/obj/item/toy/crossbow_ammo{
	pixel_x = -17;
	pixel_y = 41
	},
/turf/open/floor/prison/darkbrown2/north,
/area/template_noop)
"tT" = (
/obj/effect/decal/cleanable/blood/oil/streak,
/turf/open/floor/wood,
/area/template_noop)
"tY" = (
/turf/open/floor/prison/floor_plate,
/area/template_noop)
"uE" = (
/turf/open/floor/prison/darkbrowncorners2/east,
/area/template_noop)
"uJ" = (
/obj/structure/surface/table/reinforced/prison,
/obj/item/trash/plate{
	pixel_x = -7
	},
/obj/item/trash/plate{
	pixel_x = -7;
	pixel_y = 4
	},
/obj/item/trash/plate{
	pixel_x = -7;
	pixel_y = 9
	},
/obj/item/trash/plate{
	pixel_x = 7
	},
/obj/item/trash/plate{
	pixel_x = 7;
	pixel_y = 4
	},
/obj/item/trash/plate{
	pixel_x = 7;
	pixel_y = 9
	},
/turf/open/floor/wood,
/area/template_noop)
"vx" = (
/obj/structure/platform,
/turf/open/gm/river/pool,
/area/template_noop)
"vJ" = (
/obj/effect/decal/cleanable/blood,
/turf/open/floor/prison/darkbrown2/east,
/area/template_noop)
"vU" = (
/obj/structure/surface/table/reinforced/prison,
/obj/item/reagent_container/food/snacks/hotdog{
	pixel_x = 6;
	pixel_y = 16
	},
/obj/item/reagent_container/food/snacks/hotdog{
	pixel_x = -7;
	pixel_y = 16
	},
/obj/item/reagent_container/food/snacks/hotdog{
	pixel_x = 6;
	pixel_y = 12
	},
/obj/item/reagent_container/food/snacks/hotdog{
	pixel_x = -7;
	pixel_y = 12
	},
/obj/item/reagent_container/food/snacks/hotdog{
	pixel_x = -7;
	pixel_y = 7
	},
/obj/item/reagent_container/food/snacks/hotdog{
	pixel_x = 6;
	pixel_y = 7
	},
/obj/item/reagent_container/food/snacks/hotdog{
	pixel_x = -7;
	pixel_y = 2
	},
/obj/item/reagent_container/food/snacks/hotdog{
	pixel_x = 6;
	pixel_y = 2
	},
/turf/open/floor/wood,
/area/template_noop)
"vX" = (
/obj/structure/surface/table/reinforced/prison,
/obj/structure/machinery/light/double/blue{
	dir = 4;
	pixel_x = 10;
	pixel_y = 13
	},
/obj/structure/prop/souto_land/pole{
	dir = 1
	},
/obj/structure/prop/souto_land/streamer{
	dir = 9
	},
/obj/item/tool/hand_labeler{
	pixel_x = -5;
	pixel_y = 7
	},
/turf/open/floor/wood,
/area/template_noop)
"wn" = (
/obj/structure/prop/souto_land/pole,
/turf/open/floor/prison/darkbrown2,
/area/template_noop)
"wt" = (
/obj/item/toy/crossbow_ammo{
	pixel_x = -16
	},
/turf/open/floor/prison/darkbrowncorners2/west,
/area/template_noop)
"wW" = (
/obj/item/toy/bikehorn/rubberducky{
	pixel_x = -2;
	pixel_y = -15
	},
/turf/open/gm/river/pool,
/area/template_noop)
"xc" = (
/obj/structure/platform_decoration,
/turf/open/floor/prison/darkbrowncorners2,
/area/template_noop)
"xn" = (
/obj/structure/platform,
/obj/structure/machinery/light/double/blue,
/turf/open/floor/prison/darkbrown2,
/area/template_noop)
"xz" = (
/obj/structure/prop/souto_land/streamer{
	dir = 9
	},
/turf/open/floor/wood,
/area/template_noop)
"xL" = (
/obj/structure/platform{
	dir = 8
	},
/turf/open/floor/prison/floor_plate,
/area/template_noop)
"xS" = (
/obj/structure/platform{
	dir = 1
	},
/obj/structure/machinery/light/double/blue{
	dir = 1;
	pixel_y = 21
	},
/turf/open/floor/wood,
/area/template_noop)
"yc" = (
/obj/structure/prop/souto_land/pole,
/obj/structure/prop/souto_land/pole{
	dir = 4;
	pixel_y = 24
	},
/obj/item/toy/plush/barricade{
	pixel_x = 1;
	pixel_y = -9
	},
/obj/effect/decal/cleanable/blood/oil/streak,
/turf/open/floor/prison/darkbrown2/west,
/area/template_noop)
"yd" = (
/turf/open/floor/prison/darkbrown2/northeast,
/area/template_noop)
"yf" = (
/turf/open/floor/prison/darkbrown2/east,
/area/template_noop)
"yL" = (
/obj/structure/stairs/perspective{
	dir = 4;
	icon_state = "p_stair_sn_full_cap"
	},
/obj/structure/platform{
	dir = 4
	},
/turf/open/floor/plating/prison,
/area/template_noop)
"zK" = (
/obj/item/trash/crushed_cup{
	pixel_y = 6;
	pixel_x = 6
	},
/turf/open/floor/prison/darkbrown2/east,
/area/template_noop)
"zR" = (
/obj/item/trash/cigbutt{
	pixel_x = 10;
	pixel_y = -11
	},
/turf/open/floor/wood,
/area/template_noop)
"Aj" = (
/obj/item/device/flashlight/lamp/tripod,
/turf/open/floor/prison,
/area/template_noop)
"Ao" = (
/obj/structure/surface/table/reinforced/prison,
/obj/structure/machinery/light/double/blue{
	dir = 4;
	pixel_x = 10;
	pixel_y = -3
	},
/turf/open/floor/wood,
/area/template_noop)
"Bf" = (
/obj/structure/window/framed/prison/reinforced/hull,
/turf/open/floor/plating/prison,
/area/template_noop)
"Bv" = (
/obj/structure/prop/souto_land/streamer{
	dir = 9
	},
/obj/item/toy/gun_ammo{
	pixel_y = 66
	},
/turf/open/floor/wood,
/area/template_noop)
"BK" = (
/obj/structure/prop/souto_land/pole,
/obj/structure/prop/souto_land/streamer{
	dir = 6
	},
/turf/open/floor/wood,
/area/template_noop)
"BQ" = (
/obj/structure/platform,
/turf/open/floor/prison/darkbrown2,
/area/template_noop)
"BY" = (
/obj/structure/surface/table/reinforced/prison,
/obj/item/reagent_container/food/drinks/bottle/beer/craft/mono{
	pixel_x = 6;
	pixel_y = 5;
	layer = 3.1
	},
/obj/item/toy/plush/farwa{
	pixel_x = -5;
	pixel_y = 4
	},
/obj/item/trash/cigbutt{
	pixel_x = -6;
	pixel_y = 11
	},
/turf/open/floor/wood,
/area/template_noop)
"Ci" = (
/obj/structure/surface/table/reinforced/prison,
/obj/item/storage/beer_pack{
	pixel_y = 5;
	layer = 4
	},
/turf/open/floor/wood,
/area/template_noop)
"Cx" = (
/obj/item/weapon/baseballbat/metal,
/turf/open/floor/wood,
/area/template_noop)
"CF" = (
/turf/open/floor/prison/darkbrown2/northwest,
/area/template_noop)
"Dl" = (
/obj/item/trash/crushed_cup{
	pixel_y = 5;
	pixel_x = 11
	},
/turf/open/gm/river/pool,
/area/template_noop)
"Dn" = (
/obj/item/toy/crossbow_ammo{
	pixel_y = -14;
	pixel_x = -15
	},
/turf/open/floor/prison/darkbrown2/north,
/area/template_noop)
"DC" = (
/obj/structure/platform_decoration,
/turf/open/floor/prison/floor_plate,
/area/template_noop)
"Ep" = (
/obj/effect/decal/cleanable/blood,
/turf/open/floor/prison/darkbrown2/southwest,
/area/template_noop)
"Ez" = (
/obj/item/trash/crushed_cup{
	pixel_x = -2;
	pixel_y = 36
	},
/turf/open/gm/river/pool,
/area/template_noop)
"Fj" = (
/obj/structure/platform_decoration{
	dir = 8
	},
/turf/open/floor/wood,
/area/template_noop)
"Fs" = (
/obj/effect/landmark/corpsespawner/ua_riot/burst,
/turf/open/floor/prison/darkbrown2/north,
/area/template_noop)
"Fy" = (
/turf/closed/wall/r_wall/prison_unmeltable,
/area/template_noop)
"FD" = (
/obj/structure/surface/table/reinforced/prison,
/obj/item/toy/plush/therapy/blue{
	pixel_y = 4
	},
/obj/item/reagent_container/food/drinks/bottle/whiskey{
	pixel_x = 10;
	pixel_y = 4
	},
/obj/item/clothing/head/bowlerhat{
	pixel_y = 16;
	layer = 3.1
	},
/turf/open/floor/wood,
/area/template_noop)
"Gi" = (
/obj/structure/stairs/perspective{
	dir = 4;
	icon_state = "p_stair_full"
	},
/turf/open/floor/plating/prison,
/area/template_noop)
"HP" = (
/obj/structure/prop/souto_land/streamer{
	dir = 6
	},
/obj/item/trash/crushed_cup{
	pixel_y = 3;
	pixel_x = -4
	},
/turf/open/floor/wood,
/area/template_noop)
"Im" = (
/turf/open/floor/prison/darkbrown2/north,
/area/template_noop)
"IB" = (
/obj/item/toy/beach_ball,
/turf/open/gm/river/pool,
/area/template_noop)
"IU" = (
/obj/effect/decal/cleanable/blood/oil,
/turf/open/floor/wood,
/area/template_noop)
"Jf" = (
/obj/structure/surface/table/reinforced/prison,
/obj/item/reagent_container/food/drinks/cup{
	pixel_x = -17;
	pixel_y = -21
	},
/obj/item/reagent_container/food/drinks/bottle/beer/craft/tazhushka{
	pixel_x = 10;
	pixel_y = 20
	},
/turf/open/floor/wood,
/area/template_noop)
"Ji" = (
/obj/structure/prop/souto_land/pole{
	dir = 1
	},
/obj/structure/prop/souto_land/pole{
	dir = 8;
	pixel_y = 24
	},
/obj/item/toy/plush/barricade{
	pixel_x = -3;
	pixel_y = -9
	},
/turf/open/floor/prison/darkbrown2/east,
/area/template_noop)
"Jw" = (
/obj/structure/machinery/light/double/blue{
	dir = 1;
	pixel_y = 21
	},
/turf/open/floor/wood,
/area/template_noop)
"JQ" = (
/obj/item/clipboard,
/turf/open/floor/prison,
/area/template_noop)
"Kf" = (
/obj/structure/closet/crate/trashcart,
/obj/item/storage/pill_bottle/kelotane/skillless,
/turf/open/floor/prison,
/area/template_noop)
"KL" = (
/obj/structure/surface/table/reinforced/prison,
/obj/item/reagent_container/food/drinks/cup{
	pixel_x = -8;
	pixel_y = 5
	},
/obj/item/reagent_container/food/drinks/cup{
	pixel_x = -12;
	pixel_y = -1
	},
/obj/item/reagent_container/food/drinks/cup{
	pixel_x = -21;
	pixel_y = -1
	},
/obj/item/reagent_container/food/drinks/cup{
	pixel_x = -16;
	pixel_y = -6
	},
/turf/open/floor/wood,
/area/template_noop)
"KO" = (
/obj/structure/surface/table/reinforced/prison,
/obj/item/reagent_container/food/drinks/cup{
	pixel_x = -8;
	layer = 3.2
	},
/obj/item/reagent_container/food/drinks/cup{
	pixel_x = -13;
	pixel_y = 6;
	layer = 3.1
	},
/turf/open/floor/wood,
/area/template_noop)
"Ln" = (
/obj/structure/platform_decoration{
	dir = 1
	},
/turf/open/floor/prison/darkbrown2,
/area/template_noop)
"Ls" = (
/obj/structure/surface/table/reinforced/prison,
/obj/structure/prop/souto_land/pole{
	dir = 1
	},
/obj/structure/prop/souto_land/streamer{
	dir = 9
	},
/turf/open/floor/wood,
/area/template_noop)
"LI" = (
/obj/structure/surface/table/reinforced/prison,
/obj/item/reagent_container/food/drinks/cans/beer{
	pixel_y = 11;
	pixel_x = 9
	},
/obj/item/reagent_container/food/drinks/cans/beer{
	pixel_y = 11;
	pixel_x = 1
	},
/obj/item/reagent_container/food/drinks/cans/beer{
	pixel_y = 11;
	pixel_x = -7
	},
/obj/item/reagent_container/food/drinks/cans/beer{
	pixel_y = 4;
	pixel_x = 9
	},
/obj/item/reagent_container/food/drinks/cans/beer{
	pixel_y = 4;
	pixel_x = 1
	},
/obj/item/reagent_container/food/drinks/cans/beer{
	pixel_y = 4;
	pixel_x = -7
	},
/turf/open/floor/wood,
/area/template_noop)
"Mc" = (
/obj/structure/stairs/perspective{
	icon_state = "p_stair_sn_full_cap"
	},
/obj/structure/platform{
	dir = 8
	},
/turf/open/floor/prison/bright_clean2/southwest,
/area/template_noop)
"Mg" = (
/obj/structure/platform{
	dir = 1
	},
/turf/open/gm/river/pool,
/area/template_noop)
"Mp" = (
/obj/item/trash/kepler{
	pixel_x = 13
	},
/turf/open/floor/prison/darkbrown2/west,
/area/template_noop)
"ME" = (
/turf/open/gm/river/pool,
/area/template_noop)
"Ob" = (
/obj/structure/stairs/perspective{
	dir = 8;
	icon_state = "p_stair_sn_full_cap"
	},
/obj/structure/platform{
	dir = 4
	},
/obj/structure/prop/souto_land/pole{
	dir = 1
	},
/obj/structure/prop/souto_land/pole{
	dir = 8;
	pixel_y = 24
	},
/obj/item/toy/plush/barricade{
	pixel_x = -1;
	pixel_y = -9
	},
/turf/open/floor/prison/darkbrown2/east,
/area/template_noop)
"Os" = (
/obj/structure/machinery/power/apc/power/south,
/turf/open/floor/wood,
/area/template_noop)
"OH" = (
/obj/item/device/flashlight/lamp/tripod,
/turf/open/floor/prison/darkbrowncorners2,
/area/template_noop)
"Px" = (
/turf/open/floor/prison/cell_stripe/east,
/area/template_noop)
"PM" = (
/obj/structure/platform_decoration{
	dir = 1
	},
/turf/open/floor/prison/darkbrowncorners2/west,
/area/template_noop)
"Qg" = (
/turf/open/floor/prison/darkbrown2/west,
/area/template_noop)
"Qn" = (
/turf/open/floor/prison,
/area/template_noop)
"Qr" = (
/obj/item/tool/mop{
	pixel_x = 11;
	layer = 2.9;
	pixel_y = 3
	},
/obj/item/reagent_container/glass/bucket/mopbucket{
	pixel_x = 9;
	pixel_y = -5
	},
/turf/open/floor/prison/darkbrown2/east,
/area/template_noop)
"Qw" = (
/obj/effect/decal/cleanable/blood/oil,
/turf/open/floor/prison/darkbrown2,
/area/template_noop)
"Rr" = (
/obj/structure/stairs/perspective{
	dir = 8;
	icon_state = "p_stair_full"
	},
/turf/open/floor/plating/prison,
/area/template_noop)
"Ru" = (
/obj/item/toy/crossbow_ammo{
	pixel_x = 19;
	pixel_y = 9
	},
/turf/open/floor/prison/darkbrown2,
/area/template_noop)
"RJ" = (
/obj/item/trash/sosjerky{
	pixel_x = -14;
	pixel_y = -20
	},
/obj/effect/decal/cleanable/blood/oil/streak,
/turf/open/floor/prison/darkbrown2/north,
/area/template_noop)
"RW" = (
/obj/structure/surface/table/reinforced/prison,
/obj/item/reagent_container/food/drinks/cup{
	pixel_x = 6;
	layer = 3.2
	},
/obj/item/reagent_container/food/drinks/cup{
	pixel_x = 15;
	layer = 3.2
	},
/obj/item/reagent_container/food/drinks/cup{
	pixel_x = 11;
	pixel_y = 6;
	layer = 3.1
	},
/turf/open/floor/wood,
/area/template_noop)
"RY" = (
/obj/item/storage/belt/marine/quackers,
/turf/open/gm/river/pool,
/area/template_noop)
"Sh" = (
/obj/effect/decal/cleanable/blood/oil,
/turf/open/floor/prison/darkbrown2/north,
/area/template_noop)
"SO" = (
/obj/structure/machinery/light/double/blue{
	dir = 8;
	pixel_x = -10;
	pixel_y = 13
	},
/obj/structure/prop/souto_land/pole,
/obj/structure/prop/souto_land/streamer{
	dir = 6
	},
/obj/item/trash/cigbutt{
	pixel_x = 31;
	pixel_y = -16
	},
/turf/open/floor/wood,
/area/template_noop)
"SS" = (
/obj/structure/platform_decoration,
/turf/open/floor/prison/darkbrown2,
/area/template_noop)
"SX" = (
/obj/item/trash/plate{
	pixel_x = -9
	},
/turf/open/floor/prison/darkbrowncorners2,
/area/template_noop)
"TG" = (
/obj/item/toy/crossbow{
	pixel_x = 11;
	pixel_y = -8
	},
/turf/open/floor/prison/darkbrown2,
/area/template_noop)
"TO" = (
/obj/structure/prop/souto_land/streamer{
	dir = 6
	},
/turf/open/floor/wood,
/area/template_noop)
"TS" = (
/obj/structure/stairs/perspective{
	dir = 8;
	icon_state = "p_stair_full"
	},
/obj/structure/platform,
/turf/open/floor/plating/prison,
/area/template_noop)
"Uf" = (
/turf/open/floor/prison/darkbrown2,
/area/template_noop)
"Us" = (
/obj/item/toy/syndicateballoon{
	pixel_x = 14;
	pixel_y = -5
	},
/turf/open/floor/wood,
/area/template_noop)
"Vi" = (
/obj/structure/surface/table/reinforced/prison,
/obj/item/reagent_container/food/drinks/bottle/cognac{
	pixel_x = 7;
	pixel_y = 7
	},
/obj/item/reagent_container/food/drinks/drinkingglass{
	pixel_x = -3;
	pixel_y = 13;
	layer = 4
	},
/obj/item/reagent_container/food/drinks/drinkingglass{
	pixel_x = -10;
	pixel_y = 1;
	layer = 4
	},
/turf/open/floor/wood,
/area/template_noop)
"Vl" = (
/obj/effect/decal/cleanable/blood/oil/streak,
/turf/open/floor/prison/darkbrown2/north,
/area/template_noop)
"Vx" = (
/obj/structure/bed/chair/comfy{
	dir = 1
	},
/obj/item/weapon/gun/shotgun/merc{
	pixel_x = 1;
	pixel_y = 25
	},
/turf/open/floor/wood,
/area/template_noop)
"VV" = (
/obj/structure/platform_decoration,
/turf/open/floor/prison,
/area/template_noop)
"Wa" = (
/obj/structure/closet/basketball{
	pixel_x = -8;
	pixel_y = -2
	},
/obj/item/weapon/gun/pistol/heavy,
/obj/item/weapon/gun/revolver/cmb,
/turf/open/floor/wood,
/area/template_noop)
"We" = (
/obj/structure/platform_decoration{
	dir = 1
	},
/turf/open/floor/prison,
/area/template_noop)
"Wy" = (
/turf/open/floor/prison/darkbrown2/southeast,
/area/template_noop)
"WB" = (
/obj/structure/platform_decoration{
	dir = 4
	},
/turf/open/floor/prison/darkbrown2/northeast,
/area/template_noop)
"Xd" = (
/turf/open/floor/prison/darkbrowncorners2/west,
/area/template_noop)
"Xv" = (
/obj/structure/platform{
	dir = 1
	},
/turf/open/floor/prison/floor_plate,
/area/template_noop)
"XS" = (
/obj/effect/landmark/corpsespawner/prisoner,
/turf/open/floor/wood,
/area/template_noop)
"Yd" = (
/obj/structure/machinery/light/double/blue,
/turf/open/floor/wood,
/area/template_noop)
"Yh" = (
/obj/structure/bed/chair/comfy{
	dir = 8
	},
/obj/structure/machinery/light/double/blue{
	dir = 4;
	pixel_x = 10;
	pixel_y = -3
	},
/turf/open/floor/wood,
/area/template_noop)
"Yi" = (
/obj/item/trash/crushed_cup{
	pixel_y = -6;
	pixel_x = -8
	},
/turf/open/floor/prison/darkbrown2/east,
/area/template_noop)
"YB" = (
/turf/open/floor/plating/plating_catwalk/prison,
/area/template_noop)
"YG" = (
/obj/structure/platform,
/turf/open/floor/prison,
/area/template_noop)
"YP" = (
/obj/structure/stairs/perspective{
	icon_state = "p_stair_ew_full_cap"
	},
/obj/structure/platform/stair_cut/alt,
/turf/open/floor/plating/prison,
/area/template_noop)
"Zr" = (
/obj/structure/bed/chair/comfy,
/turf/open/floor/wood,
/area/template_noop)

(1,1,1) = {"
Uf
Qn
Kf
Qn
rp
fX
fX
fX
fX
Im
SS
hP
hP
ly
Qn
Qn
Qn
Aj
Qn
Im
Uf
Fy
"}
(2,1,1) = {"
Uf
Qn
JQ
Qn
VV
by
fX
ni
ni
YP
TS
ni
ni
Xv
tY
DC
hP
hP
ly
Im
Uf
so
"}
(3,1,1) = {"
Uf
Qn
VV
by
cF
ni
aj
ni
SO
gi
wn
hY
ni
YP
Rr
TS
ni
ni
Xv
Im
Uf
CF
"}
(4,1,1) = {"
Uf
Qn
cc
ni
aj
ni
nf
nf
nf
RJ
Uf
nf
BK
TO
HP
nS
Wa
aj
Xv
Im
Uf
mu
"}
(5,1,1) = {"
Uf
VV
cF
aj
jt
az
CF
tu
Qg
nh
Xd
Qg
bl
Ep
nf
IU
nf
aj
Xv
Im
mu
fX
"}
(6,1,1) = {"
Uf
cc
ni
ni
XS
nf
Dn
OH
yf
yf
zK
yf
iS
Ru
lh
nf
Cx
aj
Xv
yd
yf
fX
"}
(7,1,1) = {"
SS
cF
aj
nf
tz
nf
Sh
Uf
pG
Gi
Gi
qm
Im
Uf
nf
tz
nf
aj
ea
Fj
nf
fX
"}
(8,1,1) = {"
BQ
ni
ni
Zr
FD
az
Im
jm
Mg
sE
ME
vx
Im
Uf
Zr
Ci
az
ni
ni
Xv
nf
Im
"}
(9,1,1) = {"
xn
ni
mk
nf
rW
nf
tK
Uf
Mg
jq
IB
vx
Im
Uf
nf
rW
nf
Yd
ni
bU
nf
Im
"}
(10,1,1) = {"
PM
et
mU
tu
tu
Mp
uE
Uf
Mg
RY
Ez
vx
Im
co
Qg
tu
tu
yc
Mc
cW
Qg
uE
"}
(11,1,1) = {"
xc
Ob
iR
yf
yf
yf
aO
jy
Mg
ME
nv
eG
Im
nm
vJ
yf
sZ
Ji
yL
bI
yf
yf
"}
(12,1,1) = {"
xn
ni
Jw
nf
tz
nf
Im
Uf
Mg
Dl
bW
vx
Fs
Uf
nf
tz
nf
Yd
ni
xS
nf
nf
"}
(13,1,1) = {"
BQ
ni
ni
pt
LI
Vx
Im
TG
Mg
wW
ME
vx
Im
gB
Zr
BY
az
cb
Fy
Bf
Bf
Bf
"}
(14,1,1) = {"
Ln
kO
aj
nf
rW
nf
gm
Uf
nC
Rr
Rr
TS
Im
Qw
nf
rW
nf
Os
Fy
gV
gV
gV
"}
(15,1,1) = {"
Uf
cc
aj
nf
ij
tT
Vl
wt
sU
Qg
Qg
Qg
uE
Uf
nf
tb
nf
nf
Fy
Bf
Bf
Bf
"}
(16,1,1) = {"
Uf
YG
aj
lc
ci
tT
yd
Qr
Yi
iS
SX
yf
aN
Wy
iY
cq
RW
nf
nf
nf
uJ
Bf
"}
(17,1,1) = {"
Uf
YG
aj
Ls
xz
Bv
or
zR
nf
Sh
Uf
nf
tw
XS
KL
Jf
KO
bD
nf
nf
lS
Bf
"}
(18,1,1) = {"
Uf
YG
ni
ni
pG
Gi
qm
ni
vX
ht
sX
Ao
Fy
nf
lh
nf
nf
nf
nf
qG
vU
Bf
"}
(19,1,1) = {"
Uf
We
ty
ty
nV
tY
cc
ni
ni
pG
jx
ni
Fy
Zr
Vi
az
Fy
Bf
Bf
Bf
Bf
Bf
"}
(20,1,1) = {"
Wy
Qn
Qn
Qn
Aj
Qn
We
xL
xL
WB
qB
xL
Fy
nf
Yh
Us
Fy
gV
gV
oL
gV
gV
"}
(21,1,1) = {"
Px
YB
YB
Px
YB
YB
Px
YB
YB
Px
Px
YB
Fy
Fy
Fy
Fy
Fy
gV
gV
oL
gV
gV
"}
