//MAP CONVERTED BY dmm2tgm.py THIS HEADER COMMENT PREVENTS RECONVERSION, DO NOT REMOVE
"am" = (
/obj/effect/decal/cleanable/blood/splatter,
/turf/open/floor/prison/whitepurple/north,
/area/template_noop)
"aB" = (
/obj/effect/decal/cleanable/blood/gibs/xeno/core,
/turf/open/floor/prison/darkpurplefull2,
/area/template_noop)
"aC" = (
/obj/structure/surface/table/reinforced/prison,
/obj/item/ammo_magazine/shotgun/buckshot,
/turf/open/floor/prison/darkpurplefull2,
/area/template_noop)
"aU" = (
/obj/structure/sign/poster{
	icon_state = "poster12";
	pixel_x = 6;
	pixel_y = 8
	},
/turf/open/space/basic,
/area/template_noop)
"bc" = (
/turf/open/floor/prison/platingdmg2,
/area/template_noop)
"bq" = (
/obj/structure/machinery/vending/sovietsoda,
/turf/open/floor/prison/darkpurplefull2,
/area/template_noop)
"bz" = (
/turf/closed/wall/r_wall/prison_unmeltable,
/area/template_noop)
"bY" = (
/obj/item/device/flashlight/lamp/tripod,
/obj/structure/machinery/light/double/blue,
/turf/open/floor/prison/whitepurple,
/area/template_noop)
"cc" = (
/obj/structure/machinery/light/double/blue,
/turf/open/floor/prison/whitepurple,
/area/template_noop)
"cB" = (
/turf/open/floor/prison/whitepurple/east,
/area/template_noop)
"dg" = (
/turf/open/floor/prison/platingdmg1,
/area/template_noop)
"dX" = (
/obj/effect/decal/cleanable/spiderling_remains,
/turf/open/floor/prison/whitepurple/southeast,
/area/template_noop)
"el" = (
/turf/open/floor/prison/whitepurple/west,
/area/template_noop)
"fk" = (
/obj/item/explosive/grenade/incendiary/molotov{
	pixel_x = 8;
	pixel_y = 7
	},
/turf/open/space/basic,
/area/template_noop)
"fu" = (
/obj/structure/barricade/metal/wired,
/turf/open/floor/prison/sterile_white/southwest,
/area/template_noop)
"fZ" = (
/obj/structure/machinery/vending/snack/packaged,
/turf/open/floor/prison/darkpurplefull2,
/area/template_noop)
"gK" = (
/obj/effect/decal/cleanable/blood/gibs/xeno/body,
/turf/open/floor/prison/whitepurple/southeast,
/area/template_noop)
"gR" = (
/obj/structure/extinguisher_cabinet{
	pixel_y = 29
	},
/obj/structure/machinery/door/airlock/prison/horizontal{
	dir = 4
	},
/turf/open/floor/plating/prison,
/area/template_noop)
"hq" = (
/obj/structure/machinery/door/airlock/prison/horizontal{
	dir = 4;
	icon_state = "door_open"
	},
/turf/open/floor/plating/prison,
/area/template_noop)
"jb" = (
/obj/structure/grille,
/turf/open/floor/prison/sterile_white/southwest,
/area/template_noop)
"jr" = (
/obj/effect/decal/cleanable/blood/splatter,
/turf/open/floor/prison/whitepurple/east,
/area/template_noop)
"jE" = (
/obj/structure/barricade/metal/wired{
	dir = 4;
	health = 200
	},
/turf/open/floor/prison/sterile_white/southwest,
/area/template_noop)
"kO" = (
/obj/structure/bed{
	icon_state = "abed"
	},
/obj/item/toy/deck,
/turf/open/floor/prison/whitepurple/southeast,
/area/template_noop)
"lA" = (
/turf/open/floor/prison/floorscorched1,
/area/template_noop)
"mh" = (
/obj/structure/bookcase/manuals/research_and_development{
	pixel_y = 10
	},
/turf/open/floor/prison/whitepurple/north,
/area/template_noop)
"mz" = (
/obj/item/tool/kitchen/utensil/pspoon,
/turf/open/space/basic,
/area/template_noop)
"mU" = (
/turf/open/floor/prison/whitepurple/north,
/area/template_noop)
"ob" = (
/obj/structure/sink{
	dir = 4;
	pixel_x = 12
	},
/turf/open/floor/prison/whitepurple/southeast,
/area/template_noop)
"oc" = (
/turf/open/floor/prison/whitepurple/northeast,
/area/template_noop)
"oT" = (
/obj/structure/sink{
	dir = 8;
	pixel_x = -12
	},
/turf/open/floor/prison/whitepurple/southwest,
/area/template_noop)
"pD" = (
/obj/effect/decal/cleanable/blood/gibs,
/turf/open/floor/prison/damaged1/southwest,
/area/template_noop)
"qQ" = (
/obj/structure/bed/chair{
	dir = 8
	},
/turf/open/floor/prison/darkpurplefull2,
/area/template_noop)
"rK" = (
/obj/structure/barricade/metal/wired{
	dir = 4;
	health = 50
	},
/obj/item/stack/sheet/metal{
	pixel_y = 4;
	pixel_x = -10
	},
/turf/open/floor/prison/darkpurplefull2,
/area/template_noop)
"sj" = (
/obj/structure/barricade/metal/wired{
	dir = 1;
	health = 150
	},
/turf/open/floor/prison/darkpurplefull2,
/area/template_noop)
"sq" = (
/turf/open/floor/prison/whitepurplecorner/west,
/area/template_noop)
"sT" = (
/obj/structure/bed{
	icon_state = "abed"
	},
/obj/item/card/id/visa,
/turf/open/floor/prison/whitepurple/northwest,
/area/template_noop)
"uu" = (
/obj/structure/bed{
	icon_state = "abed"
	},
/obj/item/reagent_container/food/snacks/wrapped/barcardine,
/turf/open/floor/prison/whitepurple/southeast,
/area/template_noop)
"uw" = (
/obj/structure/machinery/door/airlock/prison/horizontal,
/turf/open/floor/prison/sterile_white/southwest,
/area/template_noop)
"uU" = (
/turf/open/floor/prison/floorscorched2,
/area/template_noop)
"vc" = (
/obj/effect/decal/cleanable/blood/tracks/footprints,
/turf/open/floor/prison/whitepurple/east,
/area/template_noop)
"wh" = (
/obj/structure/sink{
	dir = 4;
	pixel_x = 12
	},
/obj/effect/decal/cleanable/blood,
/obj/effect/decal/cleanable/blood/gibs,
/obj/effect/landmark/corpsespawner/prisoner,
/turf/open/floor/prison/whitepurple/southeast,
/area/template_noop)
"wQ" = (
/obj/structure/barricade/metal/wired{
	dir = 8;
	health = 200
	},
/turf/open/floor/prison/whitepurple/northwest,
/area/template_noop)
"xA" = (
/obj/item/device/flashlight/lamp/tripod,
/turf/open/floor/prison/darkpurplefull2,
/area/template_noop)
"xW" = (
/obj/effect/decal/cleanable/blood,
/turf/open/floor/prison/whitepurple/northwest,
/area/template_noop)
"yH" = (
/obj/effect/landmark/survivor_spawner,
/turf/open/floor/prison/darkpurplefull2,
/area/template_noop)
"zt" = (
/turf/open/floor/prison/whitepurple/southeast,
/area/template_noop)
"zX" = (
/obj/effect/decal/cleanable/blood/gibs/limb,
/turf/open/floor/prison/whitepurple/northeast,
/area/template_noop)
"zY" = (
/obj/effect/landmark/corpsespawner/prisoner,
/turf/open/floor/prison/floorscorched1,
/area/template_noop)
"AZ" = (
/obj/effect/decal/cleanable/blood/tracks/footprints,
/turf/open/floor/prison/whitepurple/north,
/area/template_noop)
"Bd" = (
/obj/effect/decal/cleanable/blood/splatter,
/turf/open/floor/prison/whitepurple/west,
/area/template_noop)
"Bg" = (
/obj/structure/closet/secure_closet/guncabinet{
	req_access = null
	},
/obj/item/prop/helmetgarb/riot_shield,
/obj/item/prop/helmetgarb/riot_shield,
/obj/item/clothing/under/marine/ua_riot,
/obj/item/clothing/head/helmet/marine/veteran/ua_riot,
/obj/item/clothing/suit/storage/marine/veteran/ua_riot,
/obj/item/clothing/suit/storage/marine/veteran/ua_riot,
/turf/open/floor/prison/darkpurplefull2,
/area/template_noop)
"Bp" = (
/turf/open/floor/prison/platingdmg3,
/area/template_noop)
"Br" = (
/obj/structure/machinery/light/double/blue,
/obj/effect/decal/cleanable/blood/gibs,
/turf/open/floor/prison/whitepurple,
/area/template_noop)
"BP" = (
/obj/structure/machinery/door/airlock/multi_tile/almayer/generic/autoname{
	icon = 'icons/obj/structures/doors/2x1prepdoor_charlie.dmi'
	},
/turf/open/floor/prison/sterile_white/southwest,
/area/template_noop)
"BZ" = (
/obj/structure/sink{
	dir = 8;
	pixel_x = -12
	},
/obj/effect/spawner/random/pills/lowchance,
/turf/open/floor/prison/whitepurple/southwest,
/area/template_noop)
"CG" = (
/obj/structure/surface/table/reinforced/prison,
/obj/item/implant/loyalty{
	pixel_x = -8;
	pixel_y = 8
	},
/obj/item/implant/loyalty{
	pixel_x = 4;
	pixel_y = 8
	},
/obj/item/implanter{
	pixel_x = -4
	},
/turf/open/floor/prison/darkpurplefull2,
/area/template_noop)
"CH" = (
/obj/structure/bed{
	icon_state = "abed"
	},
/obj/effect/spawner/random/goggles/lowchance,
/turf/open/floor/prison/whitepurple/southeast,
/area/template_noop)
"CJ" = (
/obj/effect/decal/cleanable/blood/gibs/core,
/turf/open/floor/prison/whitepurple/east,
/area/template_noop)
"Du" = (
/obj/structure/barricade/metal/wired{
	dir = 4;
	health = 55
	},
/turf/open/floor/prison/sterile_white/southwest,
/area/template_noop)
"Ed" = (
/turf/open/floor/prison/sterile_white/southwest,
/area/template_noop)
"EL" = (
/obj/structure/toilet{
	dir = 8;
	pixel_y = 8
	},
/obj/effect/decal/cleanable/blood/writing{
	dir = 6
	},
/obj/effect/landmark/corpsespawner/prisoner,
/turf/open/floor/prison/whitepurple/northeast,
/area/template_noop)
"EX" = (
/obj/structure/bed{
	icon_state = "abed"
	},
/obj/item/storage/fancy/cigar/tarbacks,
/turf/open/floor/prison/whitepurple/southeast,
/area/template_noop)
"EZ" = (
/obj/structure/bed{
	icon_state = "abed"
	},
/turf/open/floor/prison/whitepurple/southeast,
/area/template_noop)
"FA" = (
/turf/open/floor/prison/whitepurple,
/area/template_noop)
"FZ" = (
/obj/structure/machinery/vending/cigarette/colony,
/turf/open/floor/prison/darkpurplefull2,
/area/template_noop)
"Gk" = (
/obj/structure/barricade/metal/wired{
	dir = 8;
	health = 55
	},
/turf/open/floor/prison/whitepurple,
/area/template_noop)
"GM" = (
/obj/structure/machinery/light/double/blue{
	dir = 1;
	pixel_y = 21
	},
/turf/open/floor/prison/darkpurplefull2,
/area/template_noop)
"GR" = (
/turf/closed/wall/r_wall/prison_unmeltable{
	desc = "A huge chunk of metal used to seperate rooms.";
	name = "metal wall"
	},
/area/template_noop)
"GX" = (
/obj/structure/bed{
	icon_state = "abed"
	},
/turf/open/floor/prison/whitepurple/southwest,
/area/template_noop)
"Hj" = (
/obj/effect/decal/cleanable/blood/tracks/footprints,
/turf/open/floor/prison/darkpurplefull2,
/area/template_noop)
"HB" = (
/obj/effect/decal/prints{
	pixel_y = 3;
	pixel_x = -10
	},
/turf/open/floor/prison/whitepurple/west,
/area/template_noop)
"IJ" = (
/obj/effect/landmark/corpsespawner/ua_riot,
/turf/open/floor/prison/floorscorched2,
/area/template_noop)
"IL" = (
/obj/structure/bed{
	icon_state = "abed"
	},
/obj/effect/spawner/random/pills/lowchance,
/turf/open/floor/prison/whitepurple/southwest,
/area/template_noop)
"IP" = (
/obj/structure/machinery/light/double/blue{
	pixel_y = -1
	},
/turf/open/floor/prison/sterile_white/southwest,
/area/template_noop)
"Je" = (
/obj/structure/barricade/metal/wired,
/turf/open/floor/prison/darkpurplefull2,
/area/template_noop)
"JI" = (
/obj/item/stack/sheet/metal{
	pixel_y = -9;
	pixel_x = 8
	},
/turf/open/floor/prison/whitepurple/southwest,
/area/template_noop)
"Kr" = (
/turf/open/floor/prison/panelscorched,
/area/template_noop)
"LM" = (
/turf/closed/wall/prison,
/area/template_noop)
"LQ" = (
/obj/structure/machinery/door/airlock/prison/horizontal{
	dir = 4
	},
/turf/open/floor/plating/prison,
/area/template_noop)
"Ml" = (
/obj/structure/bed{
	icon_state = "abed"
	},
/obj/effect/decal/cleanable/blood,
/turf/open/floor/prison/whitepurple/southwest,
/area/template_noop)
"Mo" = (
/obj/structure/window/framed/prison/cell,
/turf/open/floor/plating/prison,
/area/template_noop)
"MV" = (
/obj/effect/landmark/corpsespawner/ua_riot,
/turf/open/floor/prison/darkpurplefull2,
/area/template_noop)
"MY" = (
/obj/structure/machinery/vending/coffee,
/turf/open/floor/prison/darkpurplefull2,
/area/template_noop)
"Oh" = (
/obj/structure/bed{
	icon_state = "abed"
	},
/obj/item/toy/beach_ball/holoball,
/turf/open/floor/prison/whitepurple/southeast,
/area/template_noop)
"Oo" = (
/obj/effect/spawner/gibspawner/human,
/turf/open/space/basic,
/area/template_noop)
"Ot" = (
/turf/open/floor/prison/darkpurplefull2,
/area/template_noop)
"PI" = (
/obj/structure/toilet{
	dir = 8;
	pixel_y = 8
	},
/turf/open/floor/prison/whitepurple/northeast,
/area/template_noop)
"PL" = (
/obj/structure/bed{
	icon_state = "abed"
	},
/obj/item/storage/fancy/crayons,
/turf/open/floor/prison/whitepurple/southeast,
/area/template_noop)
"Qy" = (
/turf/open/floor/prison/damaged2,
/area/template_noop)
"Rd" = (
/obj/effect/decal/cleanable/blood/gibs/xeno,
/turf/open/floor/prison/sterile_white/southwest,
/area/template_noop)
"Rm" = (
/turf/open/floor/prison/damaged3,
/area/template_noop)
"RH" = (
/obj/effect/decal/cleanable/blood/gibs/xeno,
/turf/open/floor/prison/whitepurple/west,
/area/template_noop)
"RK" = (
/obj/structure/barricade/metal/wired{
	dir = 1;
	health = 55
	},
/turf/open/floor/prison/whitepurple/southwest,
/area/template_noop)
"RO" = (
/obj/structure/surface/table/reinforced/prison,
/obj/structure/machinery/light/double/blue{
	dir = 1;
	pixel_y = 21
	},
/obj/item/restraint/handcuffs{
	pixel_x = -3;
	pixel_y = 10
	},
/obj/item/restraint/handcuffs{
	pixel_x = 4
	},
/turf/open/floor/prison/darkpurplefull2,
/area/template_noop)
"RY" = (
/obj/effect/decal/cleanable/blood/tracks/footprints,
/turf/open/floor/prison/whitepurple,
/area/template_noop)
"SS" = (
/obj/effect/landmark/corpsespawner/prisoner,
/turf/open/floor/prison/whitepurple/north,
/area/template_noop)
"Tj" = (
/turf/open/floor/prison/whitepurple/southwest,
/area/template_noop)
"VE" = (
/obj/structure/barricade/metal/wired{
	dir = 1;
	health = 65
	},
/turf/open/floor/prison/darkpurplefull2,
/area/template_noop)
"WO" = (
/obj/effect/decal/cleanable/blood/gibs/body,
/turf/open/floor/prison/darkpurplefull2,
/area/template_noop)
"XX" = (
/turf/open/floor/prison/damaged1/southwest,
/area/template_noop)
"Yc" = (
/obj/structure/barricade/metal/wired{
	dir = 4;
	health = 150
	},
/turf/open/floor/prison/whitepurple/north,
/area/template_noop)
"Yw" = (
/obj/structure/extinguisher_cabinet,
/turf/closed/wall/prison,
/area/template_noop)
"YB" = (
/obj/structure/machinery/light/double/blue{
	pixel_y = -1
	},
/obj/effect/decal/cleanable/blood/splatter,
/turf/open/floor/prison/darkpurplefull2,
/area/template_noop)
"Zi" = (
/turf/open/space/basic,
/area/template_noop)
"ZK" = (
/obj/structure/toilet{
	dir = 4;
	pixel_y = 8
	},
/turf/open/floor/prison/whitepurple/northwest,
/area/template_noop)
"ZS" = (
/turf/open/floor/prison/whitepurple/northwest,
/area/template_noop)
"ZX" = (
/obj/structure/machinery/light/double/blue{
	pixel_y = -1
	},
/turf/open/floor/prison/darkpurplefull2,
/area/template_noop)

(1,1,1) = {"
LM
LM
sT
Tj
uw
Rd
Ed
cc
LM
LQ
Mo
LM
LQ
Mo
LM
LQ
Mo
LM
"}
(2,1,1) = {"
Ed
LM
mh
FA
Mo
mU
IJ
Gk
LM
ZS
GX
LM
ZS
GX
LM
ZS
GX
LM
"}
(3,1,1) = {"
Ot
LM
PI
ob
Mo
Yc
jE
FA
LM
PI
ob
LM
PI
ob
LM
PI
ob
LM
"}
(4,1,1) = {"
Ot
Yw
LM
LM
LM
mU
Ed
Br
Yw
LM
LM
LM
LM
LM
LM
LM
LM
LM
"}
(5,1,1) = {"
Ot
LM
ZK
oT
LM
mU
Kr
FA
LM
ZK
oT
LM
ZK
oT
LM
ZK
oT
LM
"}
(6,1,1) = {"
Ot
LM
oc
EZ
LM
am
Ed
FA
LM
oc
EZ
LM
oc
EZ
LM
oc
CH
LM
"}
(7,1,1) = {"
ZX
LM
LQ
Mo
LM
mU
Ed
bY
LM
hq
Mo
LM
LQ
Mo
LM
LQ
Mo
LM
"}
(8,1,1) = {"
Je
BP
ZS
Bd
el
zY
Ed
sq
el
HB
Tj
Hj
Rm
el
el
Bp
Tj
sj
"}
(9,1,1) = {"
fu
Ed
pD
cB
cB
cB
cB
CJ
cB
XX
dX
Ot
oc
vc
cB
jr
zt
VE
"}
(10,1,1) = {"
IP
GR
hq
Mo
GR
gR
Mo
LM
Ot
Ot
xA
LM
hq
Mo
LM
LQ
Mo
LM
"}
(11,1,1) = {"
Ed
GR
ZS
Ml
GR
ZS
GX
LM
Ot
bc
Ot
LM
xW
IL
LM
ZS
GX
LM
"}
(12,1,1) = {"
aC
GR
PI
ob
GR
PI
ob
LM
qQ
Ot
Ot
LM
EL
ob
LM
PI
ob
LM
"}
(13,1,1) = {"
fZ
GR
GR
GR
GR
LM
LM
LM
RO
Ot
ZX
Yw
LM
LM
LM
LM
LM
LM
"}
(14,1,1) = {"
bq
GR
mz
Zi
GR
ZK
oT
LM
CG
Ot
uU
LM
ZK
oT
LM
ZK
oT
LM
"}
(15,1,1) = {"
MY
GR
Oo
Zi
GR
oc
uu
LM
Bg
yH
Ot
LM
oc
EZ
LM
oc
kO
LM
"}
(16,1,1) = {"
FZ
GR
aU
fk
GR
LQ
Mo
LM
GM
Ot
YB
LM
LQ
Mo
LM
LQ
Mo
LM
"}
(17,1,1) = {"
bz
GR
GR
GR
GR
Ot
Ot
Ot
Ot
bc
Ot
Ot
ZS
RH
el
lA
JI
MV
"}
(18,1,1) = {"
bz
LM
LM
LM
jb
dg
Ot
WO
Ot
Ot
aB
Ot
zX
bc
cB
cB
gK
rK
"}
(19,1,1) = {"
bz
LM
LM
LM
LM
Ot
Ot
Ot
LM
LQ
Mo
LM
LQ
Mo
LM
hq
Mo
LM
"}
(20,1,1) = {"
bz
LM
LM
LM
jb
wQ
el
RK
LM
ZS
GX
LM
ZS
GX
LM
ZS
GX
LM
"}
(21,1,1) = {"
bz
LM
LM
LM
LM
mU
Rd
FA
LM
PI
ob
LM
PI
ob
LM
PI
wh
LM
"}
(22,1,1) = {"
bz
LM
LM
LM
LM
AZ
Du
FA
Yw
LM
LM
LM
LM
LM
LM
LM
LM
LM
"}
(23,1,1) = {"
bz
LM
ZK
oT
LM
mU
Ed
FA
LM
ZK
oT
LM
ZK
oT
LM
ZK
BZ
LM
"}
(24,1,1) = {"
bz
LM
oc
Oh
LM
SS
Qy
RY
LM
oc
EX
LM
oc
PL
LM
oc
EZ
LM
"}
(25,1,1) = {"
bz
LM
LQ
Mo
LM
mU
Ed
FA
LM
LQ
Mo
LM
LQ
Mo
LM
LQ
Mo
LM
"}
