//MAP CONVERTED BY dmm2tgm.py THIS HEADER COMMENT PREVENTS RECONVERSION, DO NOT REMOVE
"ad" = (
/obj/structure/surface/table/reinforced/prison,
/obj/item/reagent_container/food/snacks/sliceable/pizza/meatpizza,
/obj/item/reagent_container/food/snacks/sliceable/pizza/meatpizza{
	pixel_y = 3
	},
/obj/item/reagent_container/food/snacks/sliceable/pizza/meatpizza{
	pixel_y = 6
	},
/obj/item/reagent_container/food/snacks/sliceable/pizza/meatpizza{
	pixel_y = 10
	},
/turf/open/floor/plating/prison,
/area/template_noop)
"ah" = (
/turf/open/floor/prison/floor_plate,
/area/template_noop)
"ai" = (
/turf/open/space,
/area/template_noop)
"an" = (
/obj/structure/closet/crate/freezer,
/obj/item/reagent_container/food/snacks/sliceable/pizza/margherita,
/obj/item/reagent_container/food/snacks/sliceable/pizza/margherita,
/obj/item/reagent_container/food/snacks/sliceable/pizza/margherita,
/obj/item/reagent_container/food/snacks/sliceable/pizza/margherita,
/obj/item/reagent_container/food/snacks/sliceable/pizza/margherita,
/turf/open/floor/prison/kitchen,
/area/template_noop)
"ap" = (
/obj/structure/surface/table/reinforced/prison,
/obj/item/reagent_container/food/drinks/cans/dr_gibb{
	pixel_x = 8;
	pixel_y = 7
	},
/obj/item/reagent_container/food/drinks/cans/space_mountain_wind{
	pixel_y = 7
	},
/obj/item/reagent_container/food/drinks/cans/space_up{
	pixel_x = -9;
	pixel_y = 7
	},
/obj/item/reagent_container/food/drinks/cans/classcola{
	pixel_x = 8
	},
/obj/item/reagent_container/food/drinks/cans/cola,
/obj/item/reagent_container/food/drinks/cans/starkist{
	pixel_x = -9
	},
/turf/open/floor/plating/prison,
/area/template_noop)
"as" = (
/obj/structure/machinery/door/airlock/prison_hatch/autoname,
/turf/open/floor/plating/prison,
/area/template_noop)
"av" = (
/obj/structure/window/framed/prison,
/turf/open/floor/plating/prison,
/area/template_noop)
"aw" = (
/obj/structure/window/framed/prison/reinforced/hull,
/turf/open/floor/plating/prison,
/area/template_noop)
"az" = (
/turf/closed/wall/prison,
/area/template_noop)
"aF" = (
/turf/open/floor/prison/blue/east,
/area/template_noop)
"aG" = (
/obj/structure/surface/table/reinforced/prison,
/obj/item/pizzabox/margherita,
/obj/item/pizzabox/mystery{
	pixel_y = 3
	},
/obj/item/pizzabox/vegetable{
	pixel_y = 7
	},
/obj/item/reagent_container/food/condiment/saltshaker{
	pixel_y = 13;
	pixel_x = -7
	},
/obj/item/reagent_container/food/condiment/peppermill{
	pixel_x = 6;
	pixel_y = 13
	},
/turf/open/floor/plating/prison,
/area/template_noop)
"aJ" = (
/obj/structure/closet/crate/freezer,
/obj/item/reagent_container/food/snacks/sliceable/pizza/mushroompizza,
/obj/item/reagent_container/food/snacks/sliceable/pizza/mushroompizza,
/obj/item/reagent_container/food/snacks/sliceable/pizza/vegetablepizza,
/obj/item/reagent_container/food/snacks/sliceable/pizza/vegetablepizza,
/turf/open/floor/prison/kitchen,
/area/template_noop)
"aM" = (
/obj/structure/sign/safety/fridge,
/turf/closed/wall/prison,
/area/template_noop)
"aP" = (
/obj/structure/lattice,
/turf/open/space,
/area/template_noop)
"aR" = (
/obj/structure/surface/table/reinforced/prison,
/obj/item/tool/kitchen/utensil/knife{
	pixel_x = 9
	},
/obj/item/reagent_container/food/snacks/tomatomeat{
	pixel_x = -6
	},
/obj/item/reagent_container/food/snacks/tomatomeat{
	pixel_x = -6;
	pixel_y = 3
	},
/obj/item/reagent_container/food/snacks/tomatomeat{
	pixel_x = -6;
	pixel_y = 6
	},
/turf/open/floor/prison/blue/southeast,
/area/template_noop)
"aT" = (
/turf/closed/wall/r_wall/prison_unmeltable,
/area/template_noop)
"aU" = (
/obj/structure/surface/table/reinforced/prison,
/obj/item/pizzabox/mystery/stack,
/obj/item/reagent_container/food/snacks/vegetablepizzaslice{
	pixel_x = -7;
	pixel_y = 10
	},
/obj/item/reagent_container/food/snacks/vegetablepizzaslice{
	pixel_x = 5;
	pixel_y = 7
	},
/turf/open/floor/plating/prison,
/area/template_noop)
"aV" = (
/obj/structure/closet/secure_closet/freezer/fridge/full,
/turf/open/floor/prison/blue/southwest,
/area/template_noop)
"aW" = (
/turf/open/floor/prison/blue/west,
/area/template_noop)
"aZ" = (
/obj/structure/closet/secure_closet/freezer/fridge/full,
/turf/open/floor/prison/blue,
/area/template_noop)
"cy" = (
/obj/structure/surface/table/reinforced/prison,
/obj/item/reagent_container/food/snacks/sliceable/cheesewheel{
	pixel_y = -8
	},
/obj/item/reagent_container/food/snacks/sliceable/cheesewheel{
	pixel_y = -3
	},
/obj/item/reagent_container/food/snacks/sliceable/cheesewheel{
	pixel_y = 2
	},
/obj/item/reagent_container/food/snacks/sliceable/cheesewheel{
	pixel_y = 7
	},
/turf/open/floor/prison/kitchen,
/area/template_noop)
"gN" = (
/turf/open/floor/prison/blue/northeast,
/area/template_noop)
"jt" = (
/obj/structure/surface/table/reinforced/prison,
/obj/item/reagent_container/food/snacks/sliceable/flatdough{
	pixel_y = 7
	},
/obj/item/reagent_container/food/snacks/sliceable/flatdough{
	pixel_y = -2
	},
/obj/item/tool/kitchen/rollingpin,
/turf/open/floor/prison/kitchen,
/area/template_noop)
"jQ" = (
/obj/structure/surface/table/reinforced/prison,
/obj/structure/sink{
	pixel_y = 32
	},
/obj/item/tool/kitchen/knife/butcher,
/turf/open/floor/prison/kitchen,
/area/template_noop)
"oa" = (
/obj/effect/decal/cleanable/blood/writing{
	icon_state = "u_psycopath_l";
	pixel_y = 4
	},
/obj/effect/decal/cleanable/blood/writing{
	icon_state = "u_ketchup_l";
	pixel_x = 8;
	pixel_y = 4
	},
/obj/effect/decal/cleanable/blood/writing{
	icon_state = "u_guilty_l";
	pixel_x = -12;
	pixel_y = 2
	},
/obj/effect/decal/cleanable/flour,
/turf/open/floor/prison/kitchen,
/area/template_noop)
"pR" = (
/obj/item/reagent_container/food/snacks/cheesewedge/verymature{
	pixel_y = -16;
	pixel_x = 9
	},
/turf/open/floor/prison/kitchen,
/area/template_noop)
"qe" = (
/obj/structure/machinery/gibber,
/obj/effect/decal/cleanable/egg_smudge,
/turf/open/floor/prison/kitchen,
/area/template_noop)
"va" = (
/obj/effect/decal/cleanable/flour,
/turf/open/floor/prison/blue/northwest,
/area/template_noop)
"xK" = (
/obj/structure/surface/table/reinforced/prison,
/obj/item/reagent_container/food/snacks/meat{
	pixel_x = -1;
	pixel_y = 2
	},
/obj/item/reagent_container/food/snacks/meat{
	pixel_x = -1;
	pixel_y = 4
	},
/obj/item/reagent_container/food/snacks/meat{
	pixel_x = -1;
	pixel_y = 6
	},
/turf/open/floor/prison/kitchen,
/area/template_noop)
"zk" = (
/turf/open/floor/prison/blue/north,
/area/template_noop)
"AO" = (
/turf/open/floor/prison/kitchen,
/area/template_noop)
"AP" = (
/obj/structure/machinery/reagentgrinder/industrial{
	pixel_y = 10
	},
/obj/structure/surface/table/reinforced/prison,
/turf/open/floor/prison/kitchen,
/area/template_noop)
"El" = (
/obj/structure/surface/table/reinforced/prison,
/obj/structure/machinery/chem_dispenser/soda,
/turf/open/floor/prison/floor_plate,
/area/template_noop)
"Gj" = (
/obj/effect/landmark/corpsespawner/pizza/burst,
/turf/open/floor/prison/kitchen,
/area/template_noop)
"IJ" = (
/obj/effect/decal/cleanable/flour,
/turf/open/floor/prison/blue/east,
/area/template_noop)
"JW" = (
/obj/structure/kitchenspike,
/turf/open/floor/prison/kitchen,
/area/template_noop)
"Nq" = (
/obj/item/stool,
/turf/open/floor/prison/blue/west,
/area/template_noop)
"Pd" = (
/obj/structure/closet/secure_closet/freezer/fridge/full,
/obj/item/tool/kitchen/pizzacutter,
/turf/open/floor/prison/kitchen,
/area/template_noop)
"QQ" = (
/obj/item/card/id/pizza,
/turf/open/floor/prison/blue/east,
/area/template_noop)
"RB" = (
/obj/structure/closet/secure_closet/freezer/fridge/full,
/obj/item/reagent_container/food/snacks/grown/tomato,
/obj/item/reagent_container/food/snacks/grown/tomato,
/obj/item/reagent_container/food/snacks/grown/tomato,
/obj/item/reagent_container/food/snacks/grown/tomato,
/turf/open/floor/prison/kitchen,
/area/template_noop)
"Sx" = (
/obj/structure/closet/secure_closet/freezer/kitchen,
/obj/item/reagent_container/food/condiment/enzyme,
/obj/item/reagent_container/food/condiment/enzyme,
/turf/open/floor/prison/kitchen,
/area/template_noop)
"Ws" = (
/obj/effect/decal/cleanable/egg_smudge,
/turf/open/floor/prison/kitchen,
/area/template_noop)
"YK" = (
/obj/structure/surface/table/reinforced/prison,
/obj/item/trash/plate{
	pixel_x = 1;
	pixel_y = 3
	},
/turf/open/floor/prison/kitchen,
/area/template_noop)
"ZQ" = (
/obj/structure/surface/table/reinforced/prison,
/obj/item/storage/box/cups{
	pixel_x = -3;
	pixel_y = 6
	},
/obj/item/storage/box/cups,
/obj/item/toy/deck{
	pixel_x = 12;
	pixel_y = -2
	},
/turf/open/floor/prison/floor_plate,
/area/template_noop)

(1,1,1) = {"
az
aU
ad
aG
ap
az
as
aT
aT
aT
"}
(2,1,1) = {"
av
va
Nq
aW
aW
aW
aW
aW
aV
aw
"}
(3,1,1) = {"
av
zk
ah
ah
ZQ
El
ah
ah
aZ
aw
"}
(4,1,1) = {"
av
gN
QQ
aF
aF
IJ
aF
aF
aR
aw
"}
(5,1,1) = {"
az
Sx
Ws
JW
az
aM
as
aT
aT
aT
"}
(6,1,1) = {"
az
jQ
Gj
cy
aT
RB
AO
an
aT
ai
"}
(7,1,1) = {"
az
AP
oa
xK
aT
Pd
pR
aJ
aT
ai
"}
(8,1,1) = {"
az
qe
jt
YK
aT
aw
aw
aw
aT
ai
"}
(9,1,1) = {"
aT
aT
aw
aT
aT
ai
ai
ai
aP
ai
"}
