//MAP CONVERTED BY dmm2tgm.py THIS HEADER COMMENT PREVENTS RECONVERSION, DO NOT REMOVE
"aa" = (
/obj/item/reagent_container/food/snacks/grown/mushroom/glowshroom{
	pixel_x = -10;
	pixel_y = -2;
	light_on = 1;
	light_range = 1;
	light_system = 1
	},
/turf/open/auto_turf/strata_grass/layer1,
/area/lv624/ground/caves/south_central_caves)
"ab" = (
/obj/structure/flora/bush/ausbushes/var3/ywflowers,
/turf/open/auto_turf/strata_grass/layer1,
/area/lv624/ground/caves/south_central_caves)
"ac" = (
/obj/item/reagent_container/food/snacks/grown/mushroom/glowshroom{
	pixel_x = 4;
	light_on = 1;
	light_range = 1;
	light_system = 1
	},
/turf/open/auto_turf/strata_grass/layer1,
/area/lv624/ground/caves/south_central_caves)
"ad" = (
/obj/effect/landmark/structure_spawner/setup/distress/xeno_weed_node,
/turf/open/auto_turf/strata_grass/layer1,
/area/lv624/ground/caves/south_central_caves)
"af" = (
/turf/open/gm/dirt,
/area/lv624/ground/caves/central_caves)
"ag" = (
/obj/effect/landmark/structure_spawner/setup/distress/xeno_weed_node,
/turf/open/gm/dirt,
/area/lv624/ground/caves/south_central_caves)
"ah" = (
/obj/effect/landmark/structure_spawner/setup/distress/xeno_weed_node,
/turf/open/gm/dirt,
/area/lv624/ground/caves/central_caves)
"ai" = (
/obj/item/reagent_container/food/snacks/grown/mushroom/glowshroom{
	pixel_x = 11;
	pixel_y = -2;
	light_on = 1;
	light_range = 1;
	light_system = 1
	},
/turf/open/auto_turf/strata_grass/layer1,
/area/lv624/ground/caves/south_central_caves)
"aj" = (
/obj/effect/landmark/hunter_primary,
/obj/effect/decal/grass_overlay/grass1/inner{
	dir = 10
	},
/turf/open/gm/dirt,
/area/lv624/ground/caves/south_central_caves)
"ak" = (
/turf/open/gm/dirt,
/area/lv624/ground/barrens/north_east_barrens)
"al" = (
/turf/closed/wall/rock/brown,
/area/lv624/ground/caves/south_central_caves)
"an" = (
/obj/effect/landmark/structure_spawner/xvx_hive/xeno_door,
/obj/effect/landmark/structure_spawner/setup/distress/xeno_door,
/turf/open/gm/dirt,
/area/lv624/ground/caves/south_central_caves)
"ao" = (
/obj/effect/landmark/structure_spawner/setup/distress/xeno_weed_node,
/turf/open/gm/dirt,
/area/lv624/ground/barrens/north_east_barrens)
"ap" = (
/obj/structure/flora/bush/ausbushes/lavendergrass,
/turf/open/auto_turf/strata_grass/layer1,
/area/lv624/ground/caves/south_central_caves)
"aq" = (
/obj/structure/fence,
/turf/open/floor{
	dir = 9;
	icon_state = "warning"
	},
/area/lv624/ground/barrens/containers)
"ar" = (
/obj/structure/fence,
/turf/open/floor{
	dir = 1;
	icon_state = "warning"
	},
/area/lv624/ground/barrens/containers)
"as" = (
/obj/effect/decal/grass_overlay/grass1{
	dir = 8
	},
/turf/open/gm/dirt,
/area/lv624/ground/caves/south_central_caves)
"at" = (
/obj/item/reagent_container/food/snacks/grown/mushroom/plumphelmet{
	pixel_x = 8
	},
/turf/open/auto_turf/strata_grass/layer1,
/area/lv624/ground/caves/south_central_caves)
"au" = (
/obj/effect/decal/grass_overlay/grass1,
/turf/open/gm/dirt,
/area/lv624/ground/barrens/north_east_barrens)
"av" = (
/turf/open/auto_turf/strata_grass/layer1,
/area/lv624/ground/caves/south_central_caves)
"aw" = (
/obj/effect/landmark/structure_spawner/xvx_hive/xeno_wall,
/obj/effect/landmark/structure_spawner/setup/distress/xeno_wall,
/turf/open/gm/dirt,
/area/lv624/ground/caves/south_central_caves)
"ay" = (
/turf/closed/wall/rock/brown,
/area/lv624/ground/barrens/west_barrens)
"az" = (
/obj/effect/decal/grass_overlay/grass1{
	dir = 10
	},
/turf/open/gm/dirt,
/area/lv624/ground/caves/south_central_caves)
"aA" = (
/obj/effect/decal/grass_overlay/grass1/inner{
	dir = 10
	},
/turf/open/gm/dirt,
/area/lv624/ground/caves/south_central_caves)
"aB" = (
/obj/effect/decal/grass_overlay/grass1{
	dir = 4
	},
/turf/open/gm/dirt,
/area/lv624/ground/barrens/north_east_barrens)
"aC" = (
/turf/open/gm/dirt,
/area/lv624/ground/caves/south_central_caves)
"aD" = (
/obj/effect/landmark/structure_spawner/xvx_hive/xeno_door,
/obj/effect/landmark/structure_spawner/setup/distress/xeno_door,
/obj/effect/decal/grass_overlay/grass1{
	dir = 1
	},
/turf/open/gm/dirt,
/area/lv624/ground/caves/south_central_caves)
"aE" = (
/obj/effect/landmark/structure_spawner/xvx_hive/xeno_door,
/obj/effect/landmark/structure_spawner/setup/distress/xeno_door,
/obj/effect/decal/grass_overlay/grass1{
	dir = 8
	},
/turf/open/auto_turf/strata_grass/layer1,
/area/lv624/ground/caves/south_central_caves)
"aF" = (
/obj/item/reagent_container/food/snacks/grown/mushroom/glowshroom{
	pixel_x = 4;
	light_on = 1;
	light_range = 1;
	light_system = 1
	},
/turf/open/auto_turf/strata_grass/layer1,
/area/lv624/ground/barrens/north_east_barrens)
"aG" = (
/obj/effect/landmark/hunter_primary,
/obj/effect/decal/grass_overlay/grass1/inner{
	dir = 9
	},
/turf/open/gm/dirt,
/area/lv624/ground/caves/south_central_caves)
"aH" = (
/obj/item/reagent_container/food/snacks/grown/mushroom/glowshroom{
	pixel_x = 2;
	pixel_y = 7;
	light_on = 1;
	light_range = 1;
	light_system = 1
	},
/turf/open/auto_turf/strata_grass/layer1,
/area/lv624/ground/caves/south_central_caves)
"aI" = (
/obj/effect/decal/grass_overlay/grass1{
	dir = 6
	},
/turf/open/gm/dirt,
/area/lv624/ground/caves/south_central_caves)
"aJ" = (
/turf/open/auto_turf/strata_grass/layer1,
/area/lv624/ground/barrens/north_east_barrens)
"aK" = (
/obj/effect/decal/grass_overlay/grass1{
	dir = 9
	},
/turf/open/gm/dirt,
/area/lv624/ground/caves/south_central_caves)
"aL" = (
/obj/effect/landmark/structure_spawner/xvx_hive/xeno_door,
/obj/effect/landmark/structure_spawner/setup/distress/xeno_door,
/obj/effect/decal/grass_overlay/grass1,
/turf/open/gm/dirt,
/area/lv624/ground/caves/south_central_caves)
"aM" = (
/obj/structure/flora/bush/ausbushes/var3/brflowers,
/turf/open/auto_turf/strata_grass/layer1,
/area/lv624/ground/caves/south_central_caves)
"aN" = (
/obj/item/reagent_container/food/snacks/grown/mushroom/plumphelmet{
	pixel_x = 8;
	pixel_y = 13
	},
/turf/open/auto_turf/strata_grass/layer1,
/area/lv624/ground/caves/south_central_caves)
"aQ" = (
/obj/effect/landmark/structure_spawner/xvx_hive/xeno_wall,
/obj/effect/landmark/structure_spawner/setup/distress/xeno_wall,
/obj/effect/decal/grass_overlay/grass1{
	dir = 1
	},
/turf/open/gm/dirt,
/area/lv624/ground/caves/south_central_caves)
"aR" = (
/obj/structure/flora/bush/ausbushes/var3/fullgrass,
/turf/open/auto_turf/strata_grass/layer1,
/area/lv624/ground/caves/south_central_caves)
"aS" = (
/obj/effect/decal/grass_overlay/grass1,
/turf/open/gm/dirt,
/area/lv624/ground/caves/south_central_caves)
"aT" = (
/obj/structure/flora/bush/ausbushes/var3/leafybush,
/turf/open/auto_turf/strata_grass/layer1,
/area/lv624/ground/caves/south_central_caves)
"aU" = (
/obj/structure/blocker/forcefield/multitile_vehicles,
/obj/effect/landmark/structure_spawner/xvx_hive/xeno_door,
/obj/effect/landmark/structure_spawner/setup/distress/xeno_door,
/obj/effect/decal/grass_overlay/grass1/inner{
	dir = 6
	},
/turf/open/auto_turf/strata_grass/layer1,
/area/lv624/ground/caves/south_central_caves)
"aV" = (
/obj/structure/blocker/forcefield/multitile_vehicles,
/obj/effect/landmark/structure_spawner/xvx_hive/xeno_door,
/obj/effect/landmark/structure_spawner/setup/distress/xeno_door,
/turf/open/auto_turf/strata_grass/layer1,
/area/lv624/ground/caves/south_central_caves)
"aW" = (
/obj/effect/decal/grass_overlay/grass1/inner{
	dir = 6
	},
/turf/open/gm/dirt,
/area/lv624/ground/caves/south_central_caves)
"aX" = (
/turf/closed/wall/strata_ice/jungle,
/area/lv624/ground/caves/south_central_caves)
"aY" = (
/turf/open/gm/dirt,
/area/lv624/ground/barrens/west_barrens)
"aZ" = (
/obj/structure/flora/bush/ausbushes/pointybush,
/turf/open/auto_turf/strata_grass/layer1,
/area/lv624/ground/caves/south_central_caves)
"pN" = (
/obj/effect/decal/grass_overlay/grass1{
	dir = 1
	},
/turf/open/gm/dirt,
/area/lv624/ground/caves/south_central_caves)
"yO" = (
/obj/item/reagent_container/food/snacks/grown/mushroom/amanita,
/turf/open/auto_turf/strata_grass/layer1,
/area/lv624/ground/caves/south_central_caves)
"zb" = (
/obj/structure/blocker/forcefield/multitile_vehicles,
/turf/open/auto_turf/strata_grass/layer1,
/area/lv624/ground/caves/central_caves)
"AO" = (
/obj/effect/decal/grass_overlay/grass1/inner{
	dir = 9
	},
/turf/open/gm/dirt,
/area/lv624/ground/caves/central_caves)
"Cb" = (
/obj/effect/decal/grass_overlay/grass1/inner{
	dir = 1
	},
/turf/open/gm/dirt,
/area/lv624/ground/caves/central_caves)
"Fo" = (
/turf/open/auto_turf/strata_grass/layer1,
/area/lv624/ground/caves/central_caves)
"MU" = (
/obj/effect/decal/grass_overlay/grass1/inner{
	dir = 5
	},
/turf/open/gm/dirt,
/area/lv624/ground/caves/central_caves)
"To" = (
/obj/structure/flora/bush/ausbushes/ppflowers,
/turf/open/auto_turf/strata_grass/layer1,
/area/lv624/ground/caves/central_caves)

(1,1,1) = {"
af
an
aK
as
aG
av
av
aA
az
an
aC
ag
aC
aC
al
al
al
al
al
al
al
"}
(2,1,1) = {"
af
an
pN
ad
av
aH
av
av
aS
an
aC
aC
aC
aC
aC
al
al
al
al
ay
aY
"}
(3,1,1) = {"
af
an
pN
av
av
aX
aX
al
aS
an
aC
aC
aC
aC
aC
aC
al
al
al
aY
aY
"}
(4,1,1) = {"
af
aw
al
al
aX
aX
al
al
al
al
al
aC
aC
aC
aC
aC
al
al
al
aY
aY
"}
(5,1,1) = {"
al
al
al
al
al
al
al
al
al
al
al
aC
aC
aC
aC
aC
aC
al
al
ay
aY
"}
(6,1,1) = {"
al
al
al
al
al
al
al
al
al
al
al
al
al
aC
aC
aC
aC
aC
al
ay
aY
"}
(7,1,1) = {"
al
al
al
al
al
al
al
al
al
al
al
al
al
al
aE
aL
an
an
al
al
ay
"}
(8,1,1) = {"
al
al
al
al
al
al
al
al
al
al
al
al
al
al
av
aA
az
aC
aC
al
al
"}
(9,1,1) = {"
al
al
al
al
al
al
al
al
al
al
al
al
al
av
aZ
av
aS
aC
aC
al
al
"}
(10,1,1) = {"
al
al
al
al
al
al
al
al
al
al
al
al
aX
av
av
av
aS
aC
aC
al
al
"}
(11,1,1) = {"
al
al
al
al
al
al
al
al
al
al
al
aX
aX
aH
av
aW
aI
aC
aC
al
al
"}
(12,1,1) = {"
al
al
al
al
al
al
al
al
al
al
aX
aX
aX
av
av
aS
ag
aC
aC
al
al
"}
(13,1,1) = {"
al
al
al
al
al
al
al
al
al
al
aX
av
av
ad
av
aj
az
aC
aC
al
al
"}
(14,1,1) = {"
al
al
al
al
al
al
al
al
al
al
al
aX
av
av
av
av
aS
aC
aC
al
al
"}
(15,1,1) = {"
al
al
al
al
al
al
aC
aC
al
al
al
ab
at
av
av
av
aS
aC
aC
al
al
"}
(16,1,1) = {"
al
al
al
al
al
aC
aC
aC
aC
al
al
al
aX
aX
av
ai
aS
aC
al
al
al
"}
(17,1,1) = {"
al
al
al
aC
aC
aC
aC
aC
aC
aC
al
al
al
aX
av
av
aS
aC
al
al
al
"}
(18,1,1) = {"
al
al
al
aC
aC
ag
aC
aC
aC
ag
aC
aC
al
aX
av
aM
aS
aC
al
al
al
"}
(19,1,1) = {"
al
al
aC
aC
aC
aC
aC
aC
aC
aC
aC
aC
aD
av
av
av
aA
az
aC
al
al
"}
(20,1,1) = {"
al
aC
aC
aC
aC
aC
al
al
aC
aC
aC
aC
aD
av
av
aa
ad
aS
aC
al
al
"}
(21,1,1) = {"
af
aC
aC
aC
aC
aC
al
al
aC
aC
aC
ag
aQ
av
av
av
av
aS
aC
al
al
"}
(22,1,1) = {"
af
aC
ag
aC
aC
al
al
al
al
aC
aC
aC
aD
av
ad
av
ap
aS
aC
al
al
"}
(23,1,1) = {"
af
af
aC
aC
al
al
al
al
al
al
aC
aC
aD
av
aT
av
aW
aI
aC
al
al
"}
(24,1,1) = {"
af
af
aC
aC
al
al
al
al
al
al
al
al
al
aN
av
av
aS
aC
al
al
al
"}
(25,1,1) = {"
af
af
aC
al
al
al
al
al
al
al
aX
aX
av
av
av
ad
aS
aC
al
al
al
"}
(26,1,1) = {"
af
af
aC
al
al
al
al
al
al
al
aX
av
av
av
ac
av
aS
al
al
al
al
"}
(27,1,1) = {"
af
af
al
al
al
al
al
al
al
al
aX
aX
av
av
av
av
aS
al
al
al
aq
"}
(28,1,1) = {"
af
ah
al
al
al
al
al
al
al
al
al
al
al
av
av
av
al
al
al
al
ar
"}
(29,1,1) = {"
af
Cb
al
al
al
al
al
al
al
al
al
aX
aX
aV
aV
aU
al
al
al
al
ar
"}
(30,1,1) = {"
af
Cb
yO
al
al
al
al
al
al
al
al
al
al
aB
aB
aB
al
al
ak
ak
ar
"}
(31,1,1) = {"
af
AO
To
aX
al
al
al
al
al
al
al
al
ak
ak
ak
ak
ak
ak
ak
ak
ar
"}
(32,1,1) = {"
Cb
Fo
aX
aX
al
al
al
al
aX
aX
al
al
al
ak
ak
ak
ak
ak
ao
ak
ar
"}
(33,1,1) = {"
af
MU
zb
aJ
aJ
aJ
aR
aX
aX
aF
au
al
ak
ak
ak
ak
ak
ak
ak
ak
ar
"}
