//MAP CONVERTED BY dmm2tgm.py THIS HEADER COMMENT PREVENTS RECONVERSION, DO NOT REMOVE
"aO" = (
/obj/structure/girder/displaced,
/obj/effect/decal/cleanable/blood/oil,
/turf/open/gm/dirt,
/area/lv624/lazarus/crashed_ship_containers)
"aY" = (
/obj/structure/girder,
/turf/open/gm/dirt,
/area/lv624/lazarus/crashed_ship_containers)
"bQ" = (
/turf/open/shuttle/bright_red,
/area/lv624/ground/barrens/north_east_barrens)
"bT" = (
/obj/structure/shuttle/engine/propulsion,
/obj/effect/decal/cleanable/blood/oil,
/turf/open/gm/dirt,
/area/lv624/ground/barrens/north_east_barrens)
"cZ" = (
/obj/item/storage/toolbox/mechanical,
/obj/effect/decal/cleanable/blood,
/turf/open/gm/dirt,
/area/lv624/lazarus/crashed_ship_containers)
"eE" = (
/obj/structure/girder,
/obj/effect/decal/cleanable/blood/oil,
/turf/open/gm/dirt,
/area/lv624/lazarus/crashed_ship_containers)
"fH" = (
/obj/structure/foamed_metal,
/turf/open/shuttle/bright_red,
/area/lv624/lazarus/crashed_ship_containers)
"iw" = (
/obj/structure/xenoautopsy/tank/hugger,
/turf/open/shuttle/bright_red,
/area/lv624/lazarus/crashed_ship_containers)
"jo" = (
/obj/item/tool/shovel/spade,
/turf/open/gm/dirt,
/area/lv624/ground/barrens/north_east_barrens)
"jB" = (
/obj/item/clothing/shoes/veteran/pmc,
/obj/structure/foamed_metal,
/turf/open/shuttle/bright_red,
/area/lv624/lazarus/crashed_ship_containers)
"ke" = (
/obj/effect/decal/cleanable/blood,
/turf/open/shuttle/bright_red,
/area/lv624/lazarus/crashed_ship_containers)
"kP" = (
/obj/structure/girder/displaced,
/obj/structure/foamed_metal,
/turf/open/gm/dirt,
/area/lv624/lazarus/crashed_ship_containers)
"nt" = (
/obj/effect/landmark/crap_item,
/turf/open/gm/dirt,
/area/lv624/lazarus/crashed_ship_containers)
"nv" = (
/obj/structure/girder/displaced,
/turf/open/gm/dirt,
/area/lv624/lazarus/crashed_ship_containers)
"oT" = (
/obj/effect/spawner/random/toolbox,
/turf/open/gm/dirt,
/area/lv624/lazarus/crashed_ship_containers)
"pp" = (
/obj/structure/girder,
/turf/open/gm/dirt,
/area/lv624/ground/barrens/north_east_barrens)
"pZ" = (
/obj/structure/girder/displaced,
/obj/structure/shuttle/engine/propulsion,
/turf/open/gm/dirt,
/area/lv624/lazarus/crashed_ship_containers)
"qf" = (
/obj/structure/bed/chair/dropship/pilot,
/obj/item/clothing/head/helmet/marine/veteran/pmc/leader,
/turf/open/shuttle/bright_red,
/area/lv624/lazarus/crashed_ship_containers)
"ql" = (
/obj/structure/xenoautopsy/tank/broken,
/turf/open/shuttle/bright_red,
/area/lv624/lazarus/crashed_ship_containers)
"re" = (
/obj/structure/bed/chair{
	dir = 8
	},
/turf/open/shuttle/bright_red,
/area/lv624/lazarus/crashed_ship_containers)
"tf" = (
/obj/structure/machinery/constructable_frame{
	icon_state = "box_1"
	},
/obj/structure/foamed_metal,
/turf/open/gm/dirt,
/area/lv624/lazarus/crashed_ship_containers)
"uw" = (
/obj/structure/bed/chair{
	dir = 8
	},
/turf/open/gm/dirt,
/area/lv624/lazarus/crashed_ship_containers)
"vD" = (
/obj/structure/surface/rack,
/obj/item/ammo_magazine/shotgun/buckshot,
/obj/item/ammo_magazine/shotgun/buckshot,
/obj/item/weapon/gun/shotgun/pump/dual_tube/cmb{
	pixel_y = 7
	},
/obj/item/weapon/gun/shotgun/pump/dual_tube/cmb,
/turf/open/gm/dirt,
/area/lv624/lazarus/crashed_ship_containers)
"xt" = (
/obj/item/ammo_magazine/rifle/m16,
/obj/item/ammo_magazine/rifle/m16,
/turf/open/gm/dirt,
/area/lv624/lazarus/crashed_ship_containers)
"xD" = (
/obj/structure/girder/displaced,
/obj/effect/decal/cleanable/blood/oil,
/obj/structure/shuttle/engine/propulsion,
/turf/open/gm/dirt,
/area/lv624/lazarus/crashed_ship_containers)
"yJ" = (
/obj/structure/machinery/constructable_frame{
	icon_state = "box_1"
	},
/turf/open/gm/dirt,
/area/lv624/lazarus/crashed_ship_containers)
"yV" = (
/turf/open/gm/dirt,
/area/lv624/lazarus/crashed_ship_containers)
"zH" = (
/obj/structure/foamed_metal,
/turf/open/gm/dirt,
/area/lv624/lazarus/crashed_ship_containers)
"AA" = (
/turf/closed/wall/rock/brown,
/area/lv624/ground/caves/central_caves)
"AE" = (
/obj/structure/bed/chair/dropship/pilot,
/turf/open/shuttle/bright_red,
/area/lv624/lazarus/crashed_ship_containers)
"Ch" = (
/turf/open/shuttle/bright_red,
/area/lv624/lazarus/crashed_ship_containers)
"Dw" = (
/obj/item/tool/shovel/spade,
/turf/open/gm/dirt,
/area/lv624/lazarus/crashed_ship_containers)
"DD" = (
/turf/closed/shuttle{
	icon_state = "wall3"
	},
/area/lv624/lazarus/crashed_ship_containers)
"Fg" = (
/obj/item/tool/warning_cone,
/turf/open/gm/dirt,
/area/lv624/lazarus/crashed_ship_containers)
"Fk" = (
/obj/effect/alien/weeds/node,
/turf/open/gm/dirt,
/area/lv624/ground/barrens/north_east_barrens)
"Gs" = (
/obj/structure/girder,
/turf/closed/shuttle{
	icon_state = "wall3"
	},
/area/lv624/lazarus/crashed_ship_containers)
"Gt" = (
/obj/effect/decal/cleanable/blood/oil,
/turf/open/gm/dirt,
/area/lv624/ground/barrens/north_east_barrens)
"HK" = (
/obj/structure/xenoautopsy/tank/broken,
/turf/open/gm/dirt,
/area/lv624/lazarus/crashed_ship_containers)
"Ie" = (
/obj/structure/surface/rack,
/obj/item/ammo_magazine/rifle/m16,
/obj/item/ammo_magazine/rifle/m16,
/obj/item/weapon/gun/rifle/m16,
/turf/open/gm/dirt,
/area/lv624/lazarus/crashed_ship_containers)
"IP" = (
/obj/effect/decal/remains/human,
/turf/open/gm/dirt,
/area/lv624/lazarus/crashed_ship_containers)
"Ku" = (
/obj/item/storage/toolbox/electrical,
/turf/open/shuttle/bright_red,
/area/lv624/lazarus/crashed_ship_containers)
"LK" = (
/obj/item/tool/crowbar,
/turf/open/shuttle/bright_red,
/area/lv624/lazarus/crashed_ship_containers)
"LQ" = (
/obj/effect/landmark/corpsespawner/security,
/obj/effect/decal/cleanable/blood,
/turf/open/gm/dirt,
/area/lv624/lazarus/crashed_ship_containers)
"OV" = (
/obj/structure/girder,
/obj/structure/foamed_metal,
/turf/open/gm/dirt,
/area/lv624/lazarus/crashed_ship_containers)
"PE" = (
/turf/open/gm/dirt,
/area/lv624/ground/barrens/north_east_barrens)
"PS" = (
/turf/closed/wall/sulaco,
/area/lv624/ground/barrens/north_east_barrens)
"Ro" = (
/obj/effect/landmark/crap_item,
/turf/open/gm/dirt,
/area/lv624/ground/barrens/north_east_barrens)
"SB" = (
/obj/effect/landmark/crap_item,
/turf/open/shuttle/bright_red,
/area/lv624/lazarus/crashed_ship_containers)
"SJ" = (
/turf/template_noop,
/area/lv624/ground/caves/central_caves)
"SX" = (
/obj/effect/decal/cleanable/blood,
/turf/open/gm/dirt,
/area/lv624/lazarus/crashed_ship_containers)
"UG" = (
/obj/item/clothing/suit/storage/hazardvest,
/obj/effect/decal/cleanable/blood,
/turf/open/gm/dirt,
/area/lv624/lazarus/crashed_ship_containers)
"Vm" = (
/obj/item/stack/cable_coil/random,
/obj/item/explosive/grenade/high_explosive,
/obj/item/explosive/grenade/high_explosive,
/obj/structure/foamed_metal,
/turf/open/shuttle/bright_red,
/area/lv624/lazarus/crashed_ship_containers)
"Wq" = (
/obj/effect/landmark/crap_item,
/turf/open/floor/airless/asteroidfloor/northeast,
/area/lv624/ground/barrens/north_east_barrens)
"Wu" = (
/obj/effect/decal/remains/human,
/turf/open/gm/dirt,
/area/lv624/ground/barrens/north_east_barrens)
"WF" = (
/obj/structure/girder/displaced,
/turf/closed/shuttle{
	icon_state = "wall3"
	},
/area/lv624/lazarus/crashed_ship_containers)
"WG" = (
/obj/item/explosive/grenade/high_explosive/pmc,
/obj/structure/foamed_metal,
/turf/open/shuttle/bright_red,
/area/lv624/lazarus/crashed_ship_containers)
"WL" = (
/turf/open/floor/airless/asteroidfloor/northeast,
/area/lv624/ground/barrens/north_east_barrens)
"WP" = (
/turf/closed/wall/rock/brown,
/area/lv624/ground/caves/south_east_caves)
"Xk" = (
/turf/closed/wall/sulaco,
/area/lv624/lazarus/crashed_ship_containers)
"Xy" = (
/obj/item/tool/pickaxe,
/turf/open/gm/dirt,
/area/lv624/lazarus/crashed_ship_containers)

(1,1,1) = {"
AA
AA
Xk
Xk
aY
Xk
nv
eE
Xk
Xk
Gs
pZ
Gt
PE
Fk
PE
PE
PE
PE
PE
PE
"}
(2,1,1) = {"
AA
Xk
tf
qf
yJ
Ch
cZ
yV
Ch
Xk
Xk
Xk
WF
PE
PE
PS
PE
PE
PE
PE
PE
"}
(3,1,1) = {"
AA
Xk
Vm
yV
Ch
LQ
nt
Ch
Dw
yV
Ku
Xk
zH
PE
Wu
PE
PE
Wq
bQ
Fk
PE
"}
(4,1,1) = {"
AA
Xk
Ch
oT
Ch
Xy
HK
ql
vD
Ch
nt
SX
Fg
PE
PE
PE
PE
PE
PS
PE
pp
"}
(5,1,1) = {"
AA
kP
yJ
yV
IP
re
iw
ql
jB
Ch
Ch
Fg
yV
PE
PE
PE
PE
PE
PE
PE
PE
"}
(6,1,1) = {"
AA
Xk
xt
Xy
yV
zH
LK
fH
fH
zH
IP
nt
Fg
jo
PS
PE
Fk
Wu
PE
PE
PE
"}
(7,1,1) = {"
AA
OV
Ie
SB
zH
WG
fH
LQ
ke
UG
Ch
Xk
Xk
PE
PE
WL
PE
pp
bT
WL
bQ
"}
(8,1,1) = {"
AA
kP
Xk
AE
Ch
zH
re
uw
re
Xk
Gs
Xk
DD
PE
WL
bQ
PE
PE
PE
PE
PS
"}
(9,1,1) = {"
AA
AA
Xk
Xk
nv
Xk
nv
Gs
Gs
Xk
Gs
xD
aO
PE
Fk
PS
PE
PE
PE
Fk
PE
"}
(10,1,1) = {"
SJ
AA
WP
WP
WP
WP
WP
WP
WP
WP
WP
WP
PE
PE
PE
PE
PE
PE
Ro
PE
PE
"}
