//MAP CONVERTED BY dmm2tgm.py THIS HEADER COMMENT PREVENTS RECONVERSION, DO NOT REMOVE
"aO" = (
/obj/structure/girder/displaced,
/obj/effect/decal/cleanable/blood/oil,
/turf/open/gm/dirt,
/area/lv624/lazarus/crashed_ship_containers)
"aY" = (
/obj/structure/girder,
/turf/open/gm/dirt,
/area/lv624/lazarus/crashed_ship_containers)
"bT" = (
/obj/structure/shuttle/engine/propulsion,
/obj/effect/decal/cleanable/blood/oil,
/turf/open/gm/dirt,
/area/lv624/ground/barrens/north_east_barrens)
"cZ" = (
/obj/item/storage/toolbox/mechanical,
/obj/effect/decal/cleanable/blood,
/turf/open/gm/dirt,
/area/lv624/lazarus/crashed_ship_containers)
"eE" = (
/obj/structure/girder,
/obj/effect/decal/cleanable/blood/oil,
/turf/open/gm/dirt,
/area/lv624/lazarus/crashed_ship_containers)
"hd" = (
/obj/effect/decal/cleanable/blood,
/turf/open/shuttle/bright_red,
/area/lv624/lazarus/crashed_ship_containers)
"jo" = (
/obj/item/tool/shovel/spade,
/turf/open/gm/dirt,
/area/lv624/ground/barrens/north_east_barrens)
"kP" = (
/obj/structure/girder/displaced,
/obj/structure/foamed_metal,
/turf/open/gm/dirt,
/area/lv624/lazarus/crashed_ship_containers)
"nt" = (
/obj/effect/landmark/crap_item,
/turf/open/gm/dirt,
/area/lv624/lazarus/crashed_ship_containers)
"nv" = (
/obj/structure/girder/displaced,
/turf/open/gm/dirt,
/area/lv624/lazarus/crashed_ship_containers)
"or" = (
/obj/effect/landmark/crap_item,
/turf/open/floor/airless/asteroidfloor/northeast,
/area/lv624/ground/barrens/north_east_barrens)
"oT" = (
/obj/effect/spawner/random/toolbox,
/turf/open/gm/dirt,
/area/lv624/lazarus/crashed_ship_containers)
"pp" = (
/obj/structure/girder,
/turf/open/gm/dirt,
/area/lv624/ground/barrens/north_east_barrens)
"pZ" = (
/obj/structure/girder/displaced,
/obj/structure/shuttle/engine/propulsion,
/turf/open/gm/dirt,
/area/lv624/lazarus/crashed_ship_containers)
"so" = (
/obj/effect/landmark/crap_item,
/turf/open/shuttle/bright_red,
/area/lv624/lazarus/crashed_ship_containers)
"tf" = (
/obj/structure/machinery/constructable_frame{
	icon_state = "box_1"
	},
/obj/structure/foamed_metal,
/turf/open/gm/dirt,
/area/lv624/lazarus/crashed_ship_containers)
"uw" = (
/obj/structure/bed/chair{
	dir = 8
	},
/turf/open/gm/dirt,
/area/lv624/lazarus/crashed_ship_containers)
"vD" = (
/obj/structure/surface/rack,
/obj/item/ammo_magazine/shotgun/buckshot,
/obj/item/ammo_magazine/shotgun/buckshot,
/obj/item/weapon/gun/shotgun/pump/dual_tube/cmb{
	pixel_y = 7
	},
/obj/item/weapon/gun/shotgun/pump/dual_tube/cmb,
/turf/open/gm/dirt,
/area/lv624/lazarus/crashed_ship_containers)
"wF" = (
/obj/structure/xenoautopsy/tank/broken,
/turf/open/shuttle/bright_red,
/area/lv624/lazarus/crashed_ship_containers)
"xt" = (
/obj/item/ammo_magazine/rifle/m16,
/obj/item/ammo_magazine/rifle/m16,
/turf/open/gm/dirt,
/area/lv624/lazarus/crashed_ship_containers)
"xD" = (
/obj/structure/girder/displaced,
/obj/effect/decal/cleanable/blood/oil,
/obj/structure/shuttle/engine/propulsion,
/turf/open/gm/dirt,
/area/lv624/lazarus/crashed_ship_containers)
"yw" = (
/obj/item/explosive/grenade/high_explosive/pmc,
/obj/structure/foamed_metal,
/turf/open/shuttle/bright_red,
/area/lv624/lazarus/crashed_ship_containers)
"yI" = (
/turf/open/shuttle/bright_red,
/area/lv624/ground/barrens/north_east_barrens)
"yJ" = (
/obj/structure/machinery/constructable_frame{
	icon_state = "box_1"
	},
/turf/open/gm/dirt,
/area/lv624/lazarus/crashed_ship_containers)
"yV" = (
/turf/open/gm/dirt,
/area/lv624/lazarus/crashed_ship_containers)
"zH" = (
/obj/structure/foamed_metal,
/turf/open/gm/dirt,
/area/lv624/lazarus/crashed_ship_containers)
"AA" = (
/turf/closed/wall/rock/brown,
/area/lv624/ground/caves/central_caves)
"Dw" = (
/obj/item/tool/shovel/spade,
/turf/open/gm/dirt,
/area/lv624/lazarus/crashed_ship_containers)
"DD" = (
/turf/closed/shuttle{
	icon_state = "wall3"
	},
/area/lv624/lazarus/crashed_ship_containers)
"Fg" = (
/obj/item/tool/warning_cone,
/turf/open/gm/dirt,
/area/lv624/lazarus/crashed_ship_containers)
"Fk" = (
/obj/effect/alien/weeds/node,
/turf/open/gm/dirt,
/area/lv624/ground/barrens/north_east_barrens)
"Gm" = (
/obj/item/storage/toolbox/electrical,
/turf/open/shuttle/bright_red,
/area/lv624/lazarus/crashed_ship_containers)
"Gs" = (
/obj/structure/girder,
/turf/closed/shuttle{
	icon_state = "wall3"
	},
/area/lv624/lazarus/crashed_ship_containers)
"Gt" = (
/obj/effect/decal/cleanable/blood/oil,
/turf/open/gm/dirt,
/area/lv624/ground/barrens/north_east_barrens)
"HK" = (
/obj/structure/xenoautopsy/tank/broken,
/turf/open/gm/dirt,
/area/lv624/lazarus/crashed_ship_containers)
"Ie" = (
/obj/structure/surface/rack,
/obj/item/ammo_magazine/rifle/m16,
/obj/item/ammo_magazine/rifle/m16,
/obj/item/weapon/gun/rifle/m16,
/turf/open/gm/dirt,
/area/lv624/lazarus/crashed_ship_containers)
"IP" = (
/obj/effect/decal/remains/human,
/turf/open/gm/dirt,
/area/lv624/lazarus/crashed_ship_containers)
"MI" = (
/obj/structure/bed/chair/dropship/pilot,
/turf/open/shuttle/bright_red,
/area/lv624/lazarus/crashed_ship_containers)
"MM" = (
/obj/structure/xenoautopsy/tank/hugger,
/turf/open/shuttle/bright_red,
/area/lv624/lazarus/crashed_ship_containers)
"NR" = (
/obj/item/clothing/shoes/marine/civilian,
/obj/structure/foamed_metal,
/turf/open/shuttle/bright_red,
/area/lv624/lazarus/crashed_ship_containers)
"OV" = (
/obj/structure/girder,
/obj/structure/foamed_metal,
/turf/open/gm/dirt,
/area/lv624/lazarus/crashed_ship_containers)
"PE" = (
/turf/open/gm/dirt,
/area/lv624/ground/barrens/north_east_barrens)
"PS" = (
/turf/closed/wall/sulaco,
/area/lv624/ground/barrens/north_east_barrens)
"Rc" = (
/obj/structure/bed/chair{
	dir = 8
	},
/turf/open/shuttle/bright_red,
/area/lv624/lazarus/crashed_ship_containers)
"Ri" = (
/obj/item/stack/cable_coil/random,
/obj/item/explosive/grenade/high_explosive,
/obj/item/explosive/grenade/high_explosive,
/obj/structure/foamed_metal,
/turf/open/shuttle/bright_red,
/area/lv624/lazarus/crashed_ship_containers)
"Ro" = (
/obj/effect/landmark/crap_item,
/turf/open/gm/dirt,
/area/lv624/ground/barrens/north_east_barrens)
"Sg" = (
/obj/item/tool/crowbar,
/turf/open/shuttle/bright_red,
/area/lv624/lazarus/crashed_ship_containers)
"SJ" = (
/turf/template_noop,
/area/lv624/ground/caves/central_caves)
"SX" = (
/obj/effect/decal/cleanable/blood,
/turf/open/gm/dirt,
/area/lv624/lazarus/crashed_ship_containers)
"TS" = (
/turf/open/floor/airless/asteroidfloor/northeast,
/area/lv624/ground/barrens/north_east_barrens)
"Uy" = (
/turf/open/shuttle/bright_red,
/area/lv624/lazarus/crashed_ship_containers)
"UG" = (
/obj/item/clothing/suit/storage/hazardvest,
/obj/effect/decal/cleanable/blood,
/turf/open/gm/dirt,
/area/lv624/lazarus/crashed_ship_containers)
"Wb" = (
/obj/structure/foamed_metal,
/turf/open/shuttle/bright_red,
/area/lv624/lazarus/crashed_ship_containers)
"Wu" = (
/obj/effect/decal/remains/human,
/turf/open/gm/dirt,
/area/lv624/ground/barrens/north_east_barrens)
"WF" = (
/obj/structure/girder/displaced,
/turf/closed/shuttle{
	icon_state = "wall3"
	},
/area/lv624/lazarus/crashed_ship_containers)
"WP" = (
/turf/closed/wall/rock/brown,
/area/lv624/ground/caves/south_east_caves)
"Xk" = (
/turf/closed/wall/sulaco,
/area/lv624/lazarus/crashed_ship_containers)
"Xy" = (
/obj/item/tool/pickaxe,
/turf/open/gm/dirt,
/area/lv624/lazarus/crashed_ship_containers)
"Yf" = (
/obj/structure/bed/chair/dropship/pilot,
/obj/item/clothing/head/helmet/marine/veteran/pmc,
/turf/open/shuttle/bright_red,
/area/lv624/lazarus/crashed_ship_containers)

(1,1,1) = {"
AA
AA
Xk
Xk
aY
Xk
nv
eE
Xk
Xk
Gs
pZ
Gt
PE
Fk
PE
PE
PE
PE
PE
PE
"}
(2,1,1) = {"
AA
Xk
tf
Yf
yJ
Uy
cZ
yV
Uy
Xk
Xk
Xk
WF
PE
PE
PS
PE
PE
PE
PE
PE
"}
(3,1,1) = {"
AA
Xk
Ri
yV
Uy
SX
nt
Uy
Dw
yV
Gm
Xk
zH
PE
Wu
PE
PE
or
yI
Fk
PE
"}
(4,1,1) = {"
AA
Xk
Uy
oT
Uy
Xy
HK
wF
vD
Uy
nt
SX
Fg
PE
PE
PE
PE
PE
PS
PE
pp
"}
(5,1,1) = {"
AA
kP
yJ
yV
IP
Rc
MM
wF
NR
Uy
Uy
Fg
yV
PE
PE
PE
PE
PE
PE
PE
PE
"}
(6,1,1) = {"
AA
Xk
xt
Xy
yV
zH
Sg
Wb
Wb
zH
IP
nt
Fg
jo
PS
PE
Fk
Wu
PE
PE
PE
"}
(7,1,1) = {"
AA
OV
Ie
so
zH
yw
Wb
SX
hd
UG
Uy
Xk
Xk
PE
PE
TS
PE
pp
bT
TS
yI
"}
(8,1,1) = {"
AA
kP
Xk
MI
Uy
zH
Rc
uw
Rc
Xk
Gs
Xk
DD
PE
TS
yI
PE
PE
PE
PE
PS
"}
(9,1,1) = {"
AA
AA
Xk
Xk
nv
Xk
nv
Gs
Gs
Xk
Gs
xD
aO
PE
Fk
PS
PE
PE
PE
Fk
PE
"}
(10,1,1) = {"
SJ
AA
WP
WP
WP
WP
WP
WP
WP
WP
WP
WP
PE
PE
PE
PE
PE
PE
Ro
PE
PE
"}
