"a" = (/turf/open/space/basic,/area/space)
"b" = (/obj/item/tool/warning_cone{pixel_x = 4; pixel_y = 16},/obj/item/stool,/turf/open/floor/plating/plating_catwalk,/area/golden_arrow/synthcloset)
"c" = (/obj/structure/pipes/standard/simple/hidden/supply{dir = 4},/obj/effect/decal/cleanable/dirt,/obj/effect/decal/warning_stripes{icon_state = "N"; pixel_y = 2},/obj/effect/decal/warning_stripes{icon_state = "S"},/turf/open/floor/almayer,/area/golden_arrow/synthcloset)
"g" = (/obj/structure/machinery/recharge_station,/turf/open/floor/almayer{icon_state = "cargo"},/area/golden_arrow/synthcloset)
"h" = (/obj/effect/decal/cleanable/dirt,/obj/structure/closet/secure_closet/surgical{pixel_x = -30},/obj/structure/surface/table/almayer,/turf/open/floor/almayer{icon_state = "plate"},/area/golden_arrow/synthcloset)
"i" = (/obj/effect/decal/cleanable/dirt,/obj/structure/machinery/cm_vending/clothing/synth{density = 0; pixel_x = -30},/turf/open/floor/almayer{icon_state = "test_floor5"},/area/golden_arrow/synthcloset)
"l" = (/turf/open/floor/almayer,/area/golden_arrow/prep_hallway)
"o" = (/turf/closed/wall/almayer/outer,/area/golden_arrow/prep_hallway)
"q" = (/obj/structure/machinery/telecomms/relay/preset/tower,/turf/open/floor/almayer,/area/golden_arrow/engineering)
"r" = (/obj/docking_port/stationary/marine_dropship/golden_arrow_hangar_ru{name = "Space"},/turf/open/space/basic,/area/space)
"t" = (/obj/effect/landmark/start/reserve,/turf/open/floor/almayer,/area/golden_arrow/prep_hallway)
"u" = (/obj/effect/decal/warning_stripes{icon_state = "W"; pixel_x = -1; pixel_y = 1},/obj/effect/decal/cleanable/dirt,/obj/effect/decal/warning_stripes{icon_state = "E"; pixel_x = 1},/turf/open/floor/almayer,/area/golden_arrow/synthcloset)
"w" = (/obj/structure/pipes/standard/simple/hidden/supply{dir = 4},/obj/structure/machinery/door/airlock/almayer/maint/reinforced{access_modified = 1; dir = 8; name = "\improper Synthetic Preperations"; req_one_access = list(36)},/obj/structure/machinery/door/poddoor/almayer/closed{dir = 4; indestructible = 1},/turf/open/floor/almayer{icon_state = "test_floor4"},/area/golden_arrow/synthcloset)
"x" = (/obj/structure/machinery/light{dir = 8},/turf/open/floor/almayer,/area/golden_arrow/prep_hallway)
"A" = (/obj/effect/decal/warning_stripes{icon_state = "W"; pixel_x = -1; pixel_y = 1},/obj/effect/decal/warning_stripes{icon_state = "E"; pixel_x = 1},/obj/effect/decal/cleanable/dirt,/obj/structure/machinery/light/small,/turf/open/floor/almayer,/area/golden_arrow/synthcloset)
"C" = (/obj/effect/decal/warning_stripes{icon_state = "W"; pixel_x = -1; pixel_y = 1},/obj/effect/decal/warning_stripes{icon_state = "SE-out"; pixel_x = 1},/obj/effect/decal/warning_stripes{icon_state = "NE-out"; pixel_x = 1; pixel_y = 2},/obj/structure/pipes/standard/simple/hidden/supply{dir = 5},/turf/open/floor/almayer,/area/golden_arrow/synthcloset)
"D" = (/obj/structure/machinery/light{dir = 1},/turf/open/floor/almayer,/area/golden_arrow/prep_hallway)
"E" = (/turf/closed/wall/almayer/outer,/area/golden_arrow/synthcloset)
"H" = (/obj/effect/decal/cleanable/cobweb{dir = 8},/obj/item/notepad,/obj/item/maintenance_jack,/obj/structure/closet,/obj/item/tool/pen{pixel_x = -5; pixel_y = 4},/obj/item/device/camera,/obj/item/device/camera_film,/obj/item/storage/photo_album,/turf/open/floor/almayer{icon_state = "plate"},/area/golden_arrow/synthcloset)
"I" = (/obj/structure/closet/fireaxecabinet{pixel_x = -32},/obj/item/book/manual/robotics_cyborgs{pixel_y = 8},/obj/item/tool/wirecutters,/obj/item/tool/weldingtool/hugetank,/obj/structure/surface/rack,/obj/structure/machinery/light/small{dir = 1},/turf/open/floor/almayer{icon_state = "plate"},/area/golden_arrow/synthcloset)
"J" = (/obj/structure/machinery/light,/turf/open/floor/almayer,/area/golden_arrow/prep_hallway)
"O" = (/obj/structure/pipes/vents/pump{dir = 8},/obj/structure/machinery/power/apc/almayer{dir = 1},/obj/effect/decal/warning_stripes{icon_state = "W"; pixel_x = -1; pixel_y = 1},/obj/effect/decal/warning_stripes{icon_state = "E"; pixel_x = 1},/obj/effect/decal/cleanable/dirt,/turf/open/floor/almayer,/area/golden_arrow/synthcloset)
"P" = (/obj/structure/machinery/power/fusion_engine{name = "\improper S-52 fusion reactor 17"},/turf/open/floor/almayer,/area/golden_arrow/engineering)
"Q" = (/obj/effect/decal/cleanable/dirt,/obj/effect/decal/warning_stripes{icon_state = "W"; pixel_x = -1; pixel_y = 1},/obj/effect/decal/warning_stripes{icon_state = "E"; pixel_x = 1},/turf/open/floor/almayer,/area/golden_arrow/synthcloset)
"T" = (/obj/structure/machinery/cm_vending/gear/synth{density = 0; pixel_x = -30},/turf/open/floor/almayer{icon_state = "test_floor5"},/area/golden_arrow/synthcloset)
"X" = (/obj/structure/machinery/light{dir = 4},/turf/open/floor/almayer,/area/golden_arrow/prep_hallway)
"Y" = (/obj/structure/machinery/cm_vending/clothing/synth/snowflake{density = 0; pixel_x = -30},/turf/open/floor/almayer{icon_state = "test_floor5"},/area/golden_arrow/synthcloset)
"Z" = (/obj/effect/decal/cleanable/blood/oil,/obj/structure/machinery/computer/station_alert{dir = 8; pixel_x = 15; pixel_y = 2},/turf/open/floor/plating/plating_catwalk,/area/golden_arrow/synthcloset)

(1,1,1) = {"
aaaaaaaaaaaaaaaaaaaaaaaaaaaaaaaEEEEEooooooaaaaaaaa
aaaaaaaaaaaaaaaaaaaaaaaaaaaaaaaEIOgEllDlloaPPPaaaa
aaaaaaaaaaaaaaaaaaaaaaaaaaaaaaaETCcwltttloaPqPaaaa
aaaaaaaaaaaaaaaaaaaaaaaaaaaaaaaEiubExtttXoaPPPaaaa
aaaaaaaaaaaaaaaaaaaaaaaaaaaaaaaEYQZEltttloaPPPaaaa
aaaaaaaaaaaaaaaaaaaaaaaaaaaaaaaEhAHEllJlloaPPPaaaa
aaaaaaaaaaaaaaaaaaaaaaaaaaaaaaaEEEEEooooooaaaaaaaa
aaaaaaaaaaaaaaaaaaaaaaaaaaaaaaaaaaaaaaaaaaaaaaaaaa
aaaaaaaaaaaaaaaaaaaaaaaaaaaaaaaaaaaaaaaaaaaaaaaaaa
aaaaaaaaaaaaaaaaaaaaaaaaaaaaaaaaaaaaaaaaaaaaaaaaaa
aaaaaaaaaaaaaaaaaaaaaaaaaaaaaaaaaaaaaaaaaaaaaaaaaa
aaaaaaaaaaaaaaaaaaaaaaaaaaaaaaaaaaaaaaaaaaaaaaaaaa
aaaaaaaaaaaaaaaaaaaaaaaaaaaaaaaaaaaaaaaaaaaaaaaaaa
aaaaaaaaaaaaaaaaaaaaaaaaaaaaaaaaaaaaaaaaaaaaaaaaaa
aaaaaaaaaaaaaaaaaaaaaaaaaaaaaaaaaaaaaaaaaaaaaaaaaa
aaaaaaaaaaaaaaaaaaaaaaaaaaaaaaaaaaaaaaaaaaaaaaaaaa
aaaaaaaaaaaaaaaaaaaaaaaaaaaaaaaaaaaaaaaaaaaaaaaaaa
aaaaaaaaaaaaaaaaaaaaaaaaaaaaaaaaaaaaaaaaaaaaaaaaaa
aaaaaaaaaaaaaaaaaaaaaaaaaaaaaaaaaaaaaaaaaaaaaaaaaa
aaaaaaaaaaaaaaaaaaaaaaaaaaaaaaaaaaaaaaaaaaaaaaaaaa
aaaaaaaaaaaaaaaaaaaaaaaaaaaaaaaaaaaaaaaaaaaaaaaaaa
aaaaaaaaaaaaaaaaaaaaaaaaaaaaaaaaaaaaaaaaaaaaaaaaaa
aaaaaaaaaaaaaaaaaaaaaaaaaaaaaaaaaaaaaaaaaaaaaaaaaa
aaaaaaaaaaaaaaaaaaaaaaaaaaaaaaaaaaaaaaaaaaaaaaaaaa
aaaaaaaaaaaaaaaaaaaaaaaaaaaaaaaaaaaaaaaaaaaaaaaaaa
aaaaaaaaaaaaaaaaaaaaaaaaaaaaaaaaaaaaaaaaaaaaaaaaaa
aaaaaaaaaaaaaaaaaaaaaaaaaaaaaaaaaaaaaaaaaaaaaaaaaa
aaaaaaaaaaaaaaaaaaaaaaaaaaaaaaaaaaaaaaaaaaaaaaaaaa
aaaaaaaaaaaaaaaaaaaaaaaaaaaaaaaaaaaaaaaaaaaaaaaaaa
aaaaaaaaaaaaaaaaaaaaraaaaaaaaaaaaaaaaaaaaaaaaaaaaa
aaaaaaaaaaaaaaaaaaaaaaaaaaaaaaaaaaaaaaaaaaaaaaaaaa
aaaaaaaaaaaaaaaaaaaaaaaaaaaaaaaaaaaaaaaaaaaaaaaaaa
aaaaaaaaaaaaaaaaaaaaaaaaaaaaaaaaaaaaaaaaaaaaaaaaaa
aaaaaaaaaaaaaaaaaaaaaaaaaaaaaaaaaaaaaaaaaaaaaaaaaa
aaaaaaaaaaaaaaaaaaaaaaaaaaaaaaaaaaaaaaaaaaaaaaaaaa
aaaaaaaaaaaaaaaaaaaaaaaaaaaaaaaaaaaaaaaaaaaaaaaaaa
aaaaaaaaaaaaaaaaaaaaaaaaaaaaaaaaaaaaaaaaaaaaaaaaaa
aaaaaaaaaaaaaaaaaaaaaaaaaaaaaaaaaaaaaaaaaaaaaaaaaa
aaaaaaaaaaaaaaaaaaaaaaaaaaaaaaaaaaaaaaaaaaaaaaaaaa
aaaaaaaaaaaaaaaaaaaaaaaaaaaaaaaaaaaaaaaaaaaaaaaaaa
aaaaaaaaaaaaaaaaaaaaaaaaaaaaaaaaaaaaaaaaaaaaaaaaaa
aaaaaaaaaaaaaaaaaaaaaaaaaaaaaaaaaaaaaaaaaaaaaaaaaa
aaaaaaaaaaaaaaaaaaaaaaaaaaaaaaaaaaaaaaaaaaaaaaaaaa
aaaaaaaaaaaaaaaaaaaaaaaaaaaaaaaaaaaaaaaaaaaaaaaaaa
aaaaaaaaaaaaaaaaaaaaaaaaaaaaaaaaaaaaaaaaaaaaaaaaaa
aaaaaaaaaaaaaaaaaaaaaaaaaaaaaaaaaaaaaaaaaaaaaaaaaa
aaaaaaaaaaaaaaaaaaaaaaaaaaaaaaaaaaaaaaaaaaaaaaaaaa
aaaaaaaaaaaaaaaaaaaaaaaaaaaaaaaaaaaaaaaaaaaaaaaaaa
aaaaaaaaaaaaaaaaaaaaaaaaaaaaaaaaaaaaaaaaaaaaaaaaaa
aaaaaaaaaaaaaaaaaaaaaaaaaaaaaaaaaaaaaaaaaaaaaaaaaa
"}
