//MAP CONVERTED BY dmm2tgm.py THIS HEADER COMMENT PREVENTS RECONVERSION, DO NOT REMOVE
"e" = (
/obj/structure/surface/rack,
/obj/item/clothing/accessory/storage/black_vest/brown_vest,
/obj/item/clothing/accessory/storage/black_vest/brown_vest,
/turf/open/floor/vault2/west,
/area/lv624/lazarus/quartstorage)
"h" = (
/obj/structure/surface/rack,
/obj/item/tool/shovel/etool{
	pixel_x = 6
	},
/obj/item/tool/shovel/etool{
	pixel_x = -6
	},
/obj/item/tool/shovel/etool,
/turf/open/floor/dark,
/area/lv624/lazarus/quartstorage)
"p" = (
/obj/structure/surface/rack,
/obj/effect/landmark/wo_supplies/storage/webbing,
/obj/effect/landmark/wo_supplies/storage/webbing,
/obj/effect/landmark/wo_supplies/storage/webbing,
/obj/item/poster,
/obj/item/clothing/glasses/sunglasses,
/turf/open/floor/vault2/west,
/area/lv624/lazarus/quartstorage)
"w" = (
/obj/structure/surface/rack,
/obj/item/stack/folding_barricade,
/obj/item/stack/folding_barricade,
/obj/item/explosive/grenade/high_explosive/frag,
/obj/item/explosive/grenade/high_explosive/frag{
	pixel_x = 6
	},
/turf/open/floor/dark,
/area/lv624/lazarus/quartstorage)
"D" = (
/obj/structure/surface/rack,
/obj/item/stack/sheet/metal{
	amount = 50
	},
/obj/item/stack/sheet/metal{
	amount = 30;
	pixel_x = 4;
	pixel_y = 4
	},
/turf/open/floor/dark,
/area/lv624/lazarus/quartstorage)
"E" = (
/turf/open/floor/vault,
/area/lv624/lazarus/quartstorage)
"K" = (
/obj/structure/surface/rack,
/obj/item/clothing/shoes/veteran/pmc,
/obj/item/clothing/shoes/veteran/pmc{
	pixel_x = -3;
	pixel_y = 4
	},
/obj/item/clothing/shoes/veteran/pmc{
	pixel_x = 4;
	pixel_y = 3
	},
/obj/item/poster,
/obj/item/clothing/glasses/sunglasses,
/turf/open/floor/vault2/west,
/area/lv624/lazarus/quartstorage)
"U" = (
/obj/structure/surface/rack,
/turf/open/floor/vault2/west,
/area/lv624/lazarus/quartstorage)
"Y" = (
/obj/structure/surface/rack,
/obj/item/stack/folding_barricade,
/obj/item/facepaint/skull,
/turf/open/floor/dark,
/area/lv624/lazarus/quartstorage)

(1,1,1) = {"
p
E
U
"}
(2,1,1) = {"
e
E
K
"}
(3,1,1) = {"
D
E
h
"}
(4,1,1) = {"
w
E
Y
"}
